Time stamp,AC-power 1,AC-power 2,AC-power 3,Sum, 24 kW PV plant
2016-01-01 08:10:00,0,0,0,0,0
2016-01-01 08:20:00,0,0,0,0,0
2016-01-01 08:30:00,0,0,0,0,0
2016-01-01 08:40:00,0,0,0,0,0
2016-01-01 08:50:00,0,0,0,0,0
2016-01-01 09:00:00,3,0,4,7,42
2016-01-01 09:10:00,11,0,13,24,144
2016-01-01 09:20:00,16,6,25,47,282
2016-01-01 09:30:00,14,23,46,83,498
2016-01-01 09:40:00,37,36,71,144,864
2016-01-01 09:50:00,33,100,105,238,1428
2016-01-01 10:00:00,41,138,153,332,1992
2016-01-01 10:10:00,26,83,92,201,1206
2016-01-01 10:20:00,36,44,64,144,864
2016-01-01 10:30:00,30,43,67,140,840
2016-01-01 10:40:00,43,84,96,223,1338
2016-01-01 10:50:00,32,83,100,215,1290
2016-01-01 11:00:00,227,216,238,681,4086
2016-01-01 11:10:00,118,59,263,440,2640
2016-01-01 11:20:00,118,52,222,392,2352
2016-01-01 11:30:00,90,124,143,357,2142
2016-01-01 11:40:00,214,165,183,562,3372
2016-01-01 11:50:00,98,116,135,349,2094
2016-01-01 12:00:00,0,141,153,294,1764
2016-01-01 12:10:00,23,122,125,270,1620
2016-01-01 12:20:00,50,63,87,200,1200
2016-01-01 12:30:00,24,48,73,145,870
2016-01-01 12:40:00,15,6,19,40,240
2016-01-01 12:50:00,4,2,5,11,66
2016-01-01 13:00:00,4,2,6,12,72
2016-01-01 13:10:00,6,3,5,14,84
2016-01-01 13:20:00,5,8,12,25,150
2016-01-01 13:30:00,13,12,31,56,336
2016-01-01 13:40:00,18,14,40,72,432
2016-01-01 13:50:00,22,16,48,86,516
2016-01-01 14:00:00,49,35,79,163,978
2016-01-01 14:10:00,31,50,86,167,1002
2016-01-01 14:20:00,30,53,66,149,894
2016-01-01 14:30:00,26,14,52,92,552
2016-01-01 14:40:00,14,15,37,66,396
2016-01-01 14:50:00,11,12,29,52,312
2016-01-01 15:00:00,27,10,41,78,468
2016-01-01 15:10:00,11,2,15,28,168
2016-01-01 15:20:00,4,1,7,12,72
2016-01-01 15:30:00,2,0,3,5,30
2016-01-01 15:40:00,0,0,0,0,0
2016-01-01 15:50:00,0,0,0,0,0
2016-01-01 16:00:00,0,0,0,0,0
2016-01-02 08:20:00,0,0,0,0,0
2016-01-02 08:30:00,0,0,0,0,0
2016-01-02 08:40:00,0,0,0,0,0
2016-01-02 08:50:00,0,0,0,0,0
2016-01-02 09:00:00,0,0,0,0,0
2016-01-02 09:10:00,0,0,0,0,0
2016-01-02 09:20:00,0,0,0,0,0
2016-01-02 09:30:00,0,0,0,0,0
2016-01-02 09:40:00,0,0,0,0,0
2016-01-02 09:50:00,6,0,7,13,78
2016-01-02 10:00:00,5,1,9,15,90
2016-01-02 10:10:00,15,7,23,45,270
2016-01-02 10:20:00,12,4,17,33,198
2016-01-02 10:30:00,11,0,12,23,138
2016-01-02 10:40:00,10,1,13,24,144
2016-01-02 10:50:00,12,2,17,31,186
2016-01-02 11:00:00,9,4,9,22,132
2016-01-02 11:10:00,11,4,14,29,174
2016-01-02 11:20:00,10,13,30,53,318
2016-01-02 11:30:00,8,19,37,64,384
2016-01-02 11:40:00,21,13,39,73,438
2016-01-02 11:50:00,26,3,28,57,342
2016-01-02 12:00:00,31,2,33,66,396
2016-01-02 12:10:00,17,4,23,44,264
2016-01-02 12:20:00,13,7,23,43,258
2016-01-02 12:30:00,19,5,25,49,294
2016-01-02 12:40:00,23,5,34,62,372
2016-01-02 12:50:00,49,18,62,129,774
2016-01-02 13:00:00,38,30,64,132,792
2016-01-02 13:10:00,33,36,69,138,828
2016-01-02 13:20:00,29,21,50,100,600
2016-01-02 13:30:00,19,31,52,102,612
2016-01-02 13:40:00,20,31,46,97,582
2016-01-02 13:50:00,12,13,32,57,342
2016-01-02 14:00:00,17,9,28,54,324
2016-01-02 14:10:00,14,7,24,45,270
2016-01-02 14:20:00,18,4,23,45,270
2016-01-02 14:30:00,15,2,21,38,228
2016-01-02 14:40:00,10,0,12,22,132
2016-01-02 14:50:00,10,0,11,21,126
2016-01-02 15:00:00,7,0,7,14,84
2016-01-02 15:10:00,4,0,5,9,54
2016-01-02 15:20:00,0,0,0,0,0
2016-01-02 15:30:00,0,0,0,0,0
2016-01-02 15:40:00,0,0,0,0,0
2016-01-02 15:50:00,0,0,0,0,0
2016-01-02 16:00:00,0,0,0,0,0
2016-01-02 16:10:00,0,0,0,0,0
2016-01-03 08:10:00,0,0,0,0,0
2016-01-03 08:20:00,0,0,0,0,0
2016-01-03 08:30:00,0,0,0,0,0
2016-01-03 08:40:00,0,0,0,0,0
2016-01-03 08:50:00,1,0,1,2,12
2016-01-03 09:00:00,5,1,13,19,114
2016-01-03 09:10:00,14,2,24,40,240
2016-01-03 09:20:00,26,5,34,65,390
2016-01-03 09:30:00,38,8,45,91,546
2016-01-03 09:40:00,41,19,56,116,696
2016-01-03 09:50:00,47,38,76,161,966
2016-01-03 10:00:00,152,115,176,443,2658
2016-01-03 10:10:00,254,222,242,718,4308
2016-01-03 10:20:00,358,326,347,1031,6186
2016-01-03 10:30:00,225,198,212,635,3810
2016-01-03 10:40:00,354,320,343,1017,6102
2016-01-03 10:50:00,356,317,341,1014,6084
2016-01-03 11:00:00,324,290,312,926,5556
2016-01-03 11:10:00,282,251,272,805,4830
2016-01-03 11:20:00,242,214,232,688,4128
2016-01-03 11:30:00,226,198,218,642,3852
2016-01-03 11:40:00,208,180,199,587,3522
2016-01-03 11:50:00,215,187,206,608,3648
2016-01-03 12:00:00,233,205,223,661,3966
2016-01-03 12:10:00,237,210,228,675,4050
2016-01-03 12:20:00,238,209,227,674,4044
2016-01-03 12:30:00,269,243,261,773,4638
2016-01-03 12:40:00,413,386,410,1209,7254
2016-01-03 12:50:00,476,445,472,1393,8358
2016-01-03 13:00:00,573,531,558,1662,9972
2016-01-03 13:10:00,533,497,520,1550,9300
2016-01-03 13:20:00,471,437,459,1367,8202
2016-01-03 13:30:00,450,421,446,1317,7902
2016-01-03 13:40:00,391,360,381,1132,6792
2016-01-03 13:50:00,339,309,330,978,5868
2016-01-03 14:00:00,286,258,279,823,4938
2016-01-03 14:10:00,225,197,216,638,3828
2016-01-03 14:20:00,165,139,156,460,2760
2016-01-03 14:30:00,123,96,113,332,1992
2016-01-03 14:40:00,73,51,75,199,1194
2016-01-03 14:50:00,29,6,38,73,438
2016-01-03 15:00:00,27,5,34,66,396
2016-01-03 15:10:00,17,2,22,41,246
2016-01-03 15:20:00,8,1,11,20,120
2016-01-03 15:30:00,4,0,5,9,54
2016-01-03 15:40:00,0,0,0,0,0
2016-01-03 15:50:00,0,0,0,0,0
2016-01-03 16:00:00,0,0,0,0,0
2016-01-03 16:10:00,0,0,0,0,0
2016-01-03 16:20:00,0,0,0,0,0
2016-01-04 08:10:00,0,0,0,0,0
2016-01-04 08:20:00,0,0,0,0,0
2016-01-04 08:30:00,0,0,0,0,0
2016-01-04 08:40:00,0,0,0,0,0
2016-01-04 08:50:00,7,0,7,14,84
2016-01-04 09:00:00,12,0,17,29,174
2016-01-04 09:10:00,21,0,22,43,258
2016-01-04 09:20:00,35,3,38,76,456
2016-01-04 09:30:00,57,22,71,150,900
2016-01-04 09:40:00,59,36,90,185,1110
2016-01-04 09:50:00,49,96,111,256,1536
2016-01-04 10:00:00,110,135,156,401,2406
2016-01-04 10:10:00,210,181,197,588,3528
2016-01-04 10:20:00,297,264,283,844,5064
2016-01-04 10:30:00,278,247,265,790,4740
2016-01-04 10:40:00,378,344,367,1089,6534
2016-01-04 10:50:00,348,316,339,1003,6018
2016-01-04 11:00:00,302,270,290,862,5172
2016-01-04 11:10:00,281,250,270,801,4806
2016-01-04 11:20:00,259,229,248,736,4416
2016-01-04 11:30:00,233,206,224,663,3978
2016-01-04 11:40:00,234,203,221,658,3948
2016-01-04 11:50:00,232,205,223,660,3960
2016-01-04 12:00:00,233,208,225,666,3996
2016-01-04 12:10:00,232,207,224,663,3978
2016-01-04 12:20:00,240,216,231,687,4122
2016-01-04 12:30:00,256,231,246,733,4398
2016-01-04 12:40:00,394,363,383,1140,6840
2016-01-04 12:50:00,520,489,508,1517,9102
2016-01-04 13:00:00,569,532,553,1654,9924
2016-01-04 13:10:00,546,505,534,1585,9510
2016-01-04 13:20:00,388,356,378,1122,6732
2016-01-04 13:30:00,330,299,321,950,5700
2016-01-04 13:40:00,324,291,313,928,5568
2016-01-04 13:50:00,300,268,289,857,5142
2016-01-04 14:00:00,283,251,272,806,4836
2016-01-04 14:10:00,232,203,220,655,3930
2016-01-04 14:20:00,178,152,165,495,2970
2016-01-04 14:30:00,133,109,117,359,2154
2016-01-04 14:40:00,40,94,113,247,1482
2016-01-04 14:50:00,47,26,71,144,864
2016-01-04 15:00:00,35,14,64,113,678
2016-01-04 15:10:00,29,14,47,90,540
2016-01-04 15:20:00,22,6,31,59,354
2016-01-04 15:30:00,8,1,12,21,126
2016-01-04 15:40:00,3,0,4,7,42
2016-01-04 15:50:00,0,0,0,0,0
2016-01-04 16:00:00,0,0,0,0,0
2016-01-04 16:10:00,0,0,0,0,0
2016-01-04 16:20:00,0,0,0,0,0
2016-01-05 08:10:00,0,0,0,0,0
2016-01-05 08:20:00,0,0,0,0,0
2016-01-05 08:30:00,0,0,0,0,0
2016-01-05 08:40:00,0,0,0,0,0
2016-01-05 08:50:00,0,0,0,0,0
2016-01-05 09:00:00,0,0,0,0,0
2016-01-05 09:10:00,0,0,0,0,0
2016-01-05 09:20:00,0,0,0,0,0
2016-01-05 09:30:00,0,0,0,0,0
2016-01-05 09:40:00,0,0,0,0,0
2016-01-05 09:50:00,0,0,1,1,6
2016-01-05 10:00:00,3,0,5,8,48
2016-01-05 10:10:00,10,2,12,24,144
2016-01-05 10:20:00,16,4,20,40,240
2016-01-05 10:30:00,26,6,33,65,390
2016-01-05 10:40:00,25,3,29,57,342
2016-01-05 10:50:00,22,5,29,56,336
2016-01-05 11:00:00,32,11,42,85,510
2016-01-05 11:10:00,30,9,44,83,498
2016-01-05 11:20:00,49,54,75,178,1068
2016-01-05 11:30:00,25,114,120,259,1554
2016-01-05 11:40:00,15,127,143,285,1710
2016-01-05 11:50:00,103,95,190,388,2328
2016-01-05 12:00:00,164,105,161,430,2580
2016-01-05 12:10:00,87,84,125,296,1776
2016-01-05 12:20:00,74,120,152,346,2076
2016-01-05 12:30:00,59,124,172,355,2130
2016-01-05 12:40:00,25,142,172,339,2034
2016-01-05 12:50:00,10,141,159,310,1860
2016-01-05 13:00:00,74,114,142,330,1980
2016-01-05 13:10:00,61,96,122,279,1674
2016-01-05 13:20:00,336,306,326,968,5808
2016-01-05 13:30:00,462,433,455,1350,8100
2016-01-05 13:40:00,194,169,186,549,3294
2016-01-05 13:50:00,61,57,95,213,1278
2016-01-05 14:00:00,76,65,115,256,1536
2016-01-05 14:10:00,145,125,157,427,2562
2016-01-05 14:20:00,170,145,161,476,2856
2016-01-05 14:30:00,131,111,124,366,2196
2016-01-05 14:40:00,98,76,90,264,1584
2016-01-05 14:50:00,62,36,50,148,888
2016-01-05 15:00:00,16,23,45,84,504
2016-01-05 15:10:00,9,22,42,73,438
2016-01-05 15:20:00,8,16,34,58,348
2016-01-05 15:30:00,11,6,18,35,210
2016-01-05 15:40:00,5,3,7,15,90
2016-01-05 15:50:00,0,0,0,0,0
2016-01-05 16:00:00,0,0,0,0,0
2016-01-05 16:10:00,0,0,0,0,0
2016-01-05 16:20:00,0,0,0,0,0
2016-01-06 08:10:00,0,0,0,0,0
2016-01-06 08:20:00,0,0,0,0,0
2016-01-06 08:30:00,0,0,0,0,0
2016-01-06 08:40:00,0,0,0,0,0
2016-01-06 08:50:00,0,0,0,0,0
2016-01-06 09:00:00,1,0,2,3,18
2016-01-06 09:10:00,9,1,12,22,132
2016-01-06 09:20:00,9,9,25,43,258
2016-01-06 09:30:00,19,12,35,66,396
2016-01-06 09:40:00,26,24,62,112,672
2016-01-06 09:50:00,28,40,75,143,858
2016-01-06 10:00:00,29,32,69,130,780
2016-01-06 10:10:00,23,28,71,122,732
2016-01-06 10:20:00,30,38,71,139,834
2016-01-06 10:30:00,33,50,75,158,948
2016-01-06 10:40:00,16,56,77,149,894
2016-01-06 10:50:00,24,73,84,181,1086
2016-01-06 11:00:00,50,66,88,204,1224
2016-01-06 11:10:00,73,128,145,346,2076
2016-01-06 11:20:00,297,268,288,853,5118
2016-01-06 11:30:00,187,162,180,529,3174
2016-01-06 11:40:00,123,98,114,335,2010
2016-01-06 11:50:00,279,253,268,800,4800
2016-01-06 12:00:00,245,219,237,701,4206
2016-01-06 12:10:00,223,198,218,639,3834
2016-01-06 12:20:00,247,221,240,708,4248
2016-01-06 12:30:00,224,197,217,638,3828
2016-01-06 12:40:00,347,319,340,1006,6036
2016-01-06 12:50:00,146,182,201,529,3174
2016-01-06 13:00:00,75,129,154,358,2148
2016-01-06 13:10:00,49,119,130,298,1788
2016-01-06 13:20:00,46,88,113,247,1482
2016-01-06 13:30:00,87,143,157,387,2322
2016-01-06 13:40:00,33,138,160,331,1986
2016-01-06 13:50:00,40,120,141,301,1806
2016-01-06 14:00:00,31,73,99,203,1218
2016-01-06 14:10:00,22,39,78,139,834
2016-01-06 14:20:00,16,30,50,96,576
2016-01-06 14:30:00,10,19,39,68,408
2016-01-06 14:40:00,14,9,24,47,282
2016-01-06 14:50:00,12,7,22,41,246
2016-01-06 15:00:00,12,3,15,30,180
2016-01-06 15:10:00,9,2,12,23,138
2016-01-06 15:20:00,4,2,5,11,66
2016-01-06 15:30:00,0,0,0,0,0
2016-01-06 15:40:00,0,0,0,0,0
2016-01-06 15:50:00,0,0,0,0,0
2016-01-06 16:00:00,0,0,0,0,0
2016-01-06 16:10:00,0,0,0,0,0
2016-01-06 16:20:00,0,0,0,0,0
2016-01-07 08:20:00,0,0,0,0,0
2016-01-07 08:30:00,0,0,0,0,0
2016-01-07 08:40:00,0,0,0,0,0
2016-01-07 08:50:00,0,0,0,0,0
2016-01-07 09:00:00,0,0,0,0,0
2016-01-07 09:10:00,0,0,0,0,0
2016-01-07 09:20:00,2,0,2,4,24
2016-01-07 09:30:00,6,1,7,14,84
2016-01-07 09:40:00,19,3,20,42,252
2016-01-07 09:50:00,30,5,35,70,420
2016-01-07 10:00:00,31,13,45,89,534
2016-01-07 10:10:00,36,23,55,114,684
2016-01-07 10:20:00,78,66,102,246,1476
2016-01-07 10:30:00,124,113,137,374,2244
2016-01-07 10:40:00,121,112,136,369,2214
2016-01-07 10:50:00,247,220,235,702,4212
2016-01-07 11:00:00,349,321,341,1011,6066
2016-01-07 11:10:00,268,245,263,776,4656
2016-01-07 11:20:00,208,184,201,593,3558
2016-01-07 11:30:00,237,211,230,678,4068
2016-01-07 11:40:00,128,129,156,413,2478
2016-01-07 11:50:00,125,131,149,405,2430
2016-01-07 12:00:00,125,97,109,331,1986
2016-01-07 12:10:00,120,96,108,324,1944
2016-01-07 12:20:00,74,36,85,195,1170
2016-01-07 12:30:00,52,44,83,179,1074
2016-01-07 12:40:00,36,21,58,115,690
2016-01-07 12:50:00,114,94,109,317,1902
2016-01-07 13:00:00,281,252,268,801,4806
2016-01-07 13:10:00,51,46,81,178,1068
2016-01-07 13:20:00,59,31,80,170,1020
2016-01-07 13:30:00,39,24,62,125,750
2016-01-07 13:40:00,34,45,55,134,804
2016-01-07 13:50:00,33,23,57,113,678
2016-01-07 14:00:00,22,17,45,84,504
2016-01-07 14:10:00,31,5,23,59,354
2016-01-07 14:20:00,19,16,39,74,444
2016-01-07 14:30:00,19,7,30,56,336
2016-01-07 14:40:00,22,3,25,50,300
2016-01-07 14:50:00,10,3,11,24,144
2016-01-07 15:00:00,0,0,0,0,0
2016-01-07 15:10:00,0,0,0,0,0
2016-01-07 15:20:00,0,0,0,0,0
2016-01-07 15:30:00,0,0,0,0,0
2016-01-07 15:40:00,0,0,0,0,0
2016-01-07 15:50:00,0,0,0,0,0
2016-01-07 16:00:00,0,0,0,0,0
2016-01-07 16:10:00,0,0,0,0,0
2016-01-08 08:50:00,0,0,0,0,0
2016-01-08 09:00:00,0,0,0,0,0
2016-01-08 09:10:00,0,0,0,0,0
2016-01-08 09:20:00,0,0,0,0,0
2016-01-08 09:30:00,0,0,0,0,0
2016-01-08 09:40:00,0,0,0,0,0
2016-01-08 09:50:00,0,0,0,0,0
2016-01-08 10:00:00,0,0,0,0,0
2016-01-08 10:10:00,0,0,0,0,0
2016-01-08 10:20:00,0,0,0,0,0
2016-01-08 10:30:00,0,0,0,0,0
2016-01-08 10:40:00,0,0,0,0,0
2016-01-08 10:50:00,0,0,0,0,0
2016-01-08 11:00:00,0,0,0,0,0
2016-01-08 11:10:00,0,0,0,0,0
2016-01-08 11:20:00,0,0,0,0,0
2016-01-08 11:30:00,0,0,0,0,0
2016-01-08 11:40:00,0,0,0,0,0
2016-01-08 11:50:00,0,0,0,0,0
2016-01-08 12:00:00,0,0,0,0,0
2016-01-08 12:10:00,0,0,0,0,0
2016-01-08 12:20:00,0,0,0,0,0
2016-01-08 12:30:00,0,0,0,0,0
2016-01-08 12:40:00,0,0,0,0,0
2016-01-08 12:50:00,0,0,0,0,0
2016-01-08 13:00:00,0,0,0,0,0
2016-01-08 13:10:00,0,0,0,0,0
2016-01-08 13:20:00,0,0,0,0,0
2016-01-08 13:30:00,0,0,0,0,0
2016-01-08 13:40:00,0,0,0,0,0
2016-01-08 13:50:00,0,0,0,0,0
2016-01-08 14:00:00,0,0,0,0,0
2016-01-08 14:10:00,0,0,0,0,0
2016-01-08 14:20:00,0,0,0,0,0
2016-01-08 14:30:00,0,0,0,0,0
2016-01-08 14:40:00,0,0,0,0,0
2016-01-08 14:50:00,0,0,0,0,0
2016-01-08 15:00:00,0,0,0,0,0
2016-01-08 15:10:00,0,0,0,0,0
2016-01-08 15:20:00,0,0,0,0,0
2016-01-08 15:30:00,0,0,0,0,0
2016-01-08 15:40:00,0,0,0,0,0
2016-01-08 15:50:00,0,0,0,0,0
2016-01-08 16:00:00,0,0,0,0,0
2016-01-08 16:10:00,0,0,0,0,0
2016-01-09 08:20:00,0,0,0,0,0
2016-01-09 08:30:00,0,0,0,0,0
2016-01-09 08:40:00,0,0,0,0,0
2016-01-09 08:50:00,0,0,0,0,0
2016-01-09 09:00:00,0,0,0,0,0
2016-01-09 09:10:00,0,0,1,1,6
2016-01-09 09:20:00,1,0,1,2,12
2016-01-09 09:30:00,6,3,8,17,102
2016-01-09 09:40:00,10,3,15,28,168
2016-01-09 09:50:00,10,3,13,26,156
2016-01-09 10:00:00,4,1,6,11,66
2016-01-09 10:10:00,8,1,9,18,108
2016-01-09 10:20:00,17,5,24,46,276
2016-01-09 10:30:00,31,5,41,77,462
2016-01-09 10:40:00,37,7,46,90,540
2016-01-09 10:50:00,17,9,33,59,354
2016-01-09 11:00:00,26,5,31,62,372
2016-01-09 11:10:00,36,11,45,92,552
2016-01-09 11:20:00,29,16,46,91,546
2016-01-09 11:30:00,16,4,25,45,270
2016-01-09 11:40:00,16,5,23,44,264
2016-01-09 11:50:00,24,4,29,57,342
2016-01-09 12:00:00,24,6,32,62,372
2016-01-09 12:10:00,14,11,32,57,342
2016-01-09 12:20:00,10,16,36,62,372
2016-01-09 12:30:00,19,4,24,47,282
2016-01-09 12:40:00,15,4,21,40,240
2016-01-09 12:50:00,19,5,24,48,288
2016-01-09 13:00:00,17,8,30,55,330
2016-01-09 13:10:00,13,7,24,44,264
2016-01-09 13:20:00,12,7,21,40,240
2016-01-09 13:30:00,16,12,36,64,384
2016-01-09 13:40:00,25,22,49,96,576
2016-01-09 13:50:00,29,19,49,97,582
2016-01-09 14:00:00,37,16,47,100,600
2016-01-09 14:10:00,41,6,45,92,552
2016-01-09 14:20:00,32,23,66,121,726
2016-01-09 14:30:00,33,9,57,99,594
2016-01-09 14:40:00,21,5,26,52,312
2016-01-09 14:50:00,19,4,24,47,282
2016-01-09 15:00:00,11,4,15,30,180
2016-01-09 15:10:00,3,1,5,9,54
2016-01-09 15:20:00,0,0,0,0,0
2016-01-09 15:30:00,0,0,0,0,0
2016-01-09 15:40:00,0,0,0,0,0
2016-01-09 15:50:00,0,0,0,0,0
2016-01-09 16:00:00,0,0,0,0,0
2016-01-09 16:10:00,0,0,0,0,0
2016-01-09 16:20:00,0,0,0,0,0
2016-01-10 08:10:00,0,0,0,0,0
2016-01-10 08:20:00,0,0,0,0,0
2016-01-10 08:30:00,0,0,0,0,0
2016-01-10 08:40:00,0,0,0,0,0
2016-01-10 08:50:00,0,0,0,0,0
2016-01-10 09:00:00,4,0,5,9,54
2016-01-10 09:10:00,13,0,14,27,162
2016-01-10 09:20:00,13,3,16,32,192
2016-01-10 09:30:00,21,5,29,55,330
2016-01-10 09:40:00,25,5,31,61,366
2016-01-10 09:50:00,16,6,16,38,228
2016-01-10 10:00:00,14,5,14,33,198
2016-01-10 10:10:00,12,2,13,27,162
2016-01-10 10:20:00,7,2,6,15,90
2016-01-10 10:30:00,5,1,6,12,72
2016-01-10 10:40:00,6,1,6,13,78
2016-01-10 10:50:00,7,0,15,22,132
2016-01-10 11:00:00,9,0,9,18,108
2016-01-10 11:10:00,11,0,11,22,132
2016-01-10 11:20:00,12,2,13,27,162
2016-01-10 11:30:00,11,5,13,29,174
2016-01-10 11:40:00,8,5,13,26,156
2016-01-10 11:50:00,8,4,11,23,138
2016-01-10 12:00:00,10,4,11,25,150
2016-01-10 12:10:00,9,3,15,27,162
2016-01-10 12:20:00,7,2,7,16,96
2016-01-10 12:30:00,4,1,4,9,54
2016-01-10 12:40:00,3,1,3,7,42
2016-01-10 12:50:00,5,1,6,12,72
2016-01-10 13:00:00,11,1,13,25,150
2016-01-10 13:10:00,4,0,5,9,54
2016-01-10 13:20:00,4,0,1,5,30
2016-01-10 13:30:00,0,0,0,0,0
2016-01-10 13:40:00,0,0,0,0,0
2016-01-10 13:50:00,0,0,0,0,0
2016-01-10 14:00:00,0,0,0,0,0
2016-01-10 14:10:00,0,0,0,0,0
2016-01-10 14:20:00,0,0,0,0,0
2016-01-10 14:30:00,0,0,0,0,0
2016-01-10 14:40:00,0,0,0,0,0
2016-01-10 14:50:00,0,0,0,0,0
2016-01-10 15:00:00,0,0,0,0,0
2016-01-10 15:10:00,0,0,0,0,0
2016-01-10 15:20:00,0,0,0,0,0
2016-01-10 15:30:00,0,0,0,0,0
2016-01-10 15:40:00,0,0,0,0,0
2016-01-10 15:50:00,0,0,0,0,0
2016-01-10 16:00:00,0,0,0,0,0
2016-01-11 08:20:00,0,0,0,0,0
2016-01-11 08:30:00,0,0,0,0,0
2016-01-11 08:40:00,0,0,0,0,0
2016-01-11 08:50:00,1,0,1,2,12
2016-01-11 09:00:00,3,0,4,7,42
2016-01-11 09:10:00,8,2,12,22,132
2016-01-11 09:20:00,13,12,29,54,324
2016-01-11 09:30:00,20,55,82,157,942
2016-01-11 09:40:00,22,35,67,124,744
2016-01-11 09:50:00,18,19,57,94,564
2016-01-11 10:00:00,20,14,42,76,456
2016-01-11 10:10:00,33,38,70,141,846
2016-01-11 10:20:00,12,124,128,264,1584
2016-01-11 10:30:00,62,45,91,198,1188
2016-01-11 10:40:00,40,43,77,160,960
2016-01-11 10:50:00,31,58,85,174,1044
2016-01-11 11:00:00,23,19,64,106,636
2016-01-11 11:10:00,54,55,88,197,1182
2016-01-11 11:20:00,40,30,69,139,834
2016-01-11 11:30:00,31,13,45,89,534
2016-01-11 11:40:00,30,18,50,98,588
2016-01-11 11:50:00,11,15,47,73,438
2016-01-11 12:00:00,10,11,34,55,330
2016-01-11 12:10:00,17,17,41,75,450
2016-01-11 12:20:00,27,10,38,75,450
2016-01-11 12:30:00,16,9,30,55,330
2016-01-11 12:40:00,27,16,48,91,546
2016-01-11 12:50:00,25,13,44,82,492
2016-01-11 13:00:00,26,20,62,108,648
2016-01-11 13:10:00,37,42,76,155,930
2016-01-11 13:20:00,37,30,77,144,864
2016-01-11 13:30:00,32,15,49,96,576
2016-01-11 13:40:00,30,15,52,97,582
2016-01-11 13:50:00,30,37,70,137,822
2016-01-11 14:00:00,27,42,73,142,852
2016-01-11 14:10:00,24,44,73,141,846
2016-01-11 14:20:00,21,10,34,65,390
2016-01-11 14:30:00,8,2,12,22,132
2016-01-11 14:40:00,0,0,1,1,6
2016-01-11 14:50:00,0,0,0,0,0
2016-01-11 15:00:00,0,0,0,0,0
2016-01-11 15:10:00,0,0,0,0,0
2016-01-11 15:20:00,0,0,0,0,0
2016-01-11 15:30:00,0,0,0,0,0
2016-01-11 15:40:00,0,0,0,0,0
2016-01-11 15:50:00,0,0,0,0,0
2016-01-11 16:00:00,0,0,0,0,0
2016-01-11 16:10:00,0,0,0,0,0
2016-01-11 16:20:00,0,0,0,0,0
2016-01-12 08:20:00,0,0,0,0,0
2016-01-12 08:30:00,0,0,0,0,0
2016-01-12 08:40:00,0,0,0,0,0
2016-01-12 08:50:00,0,0,0,0,0
2016-01-12 09:00:00,0,0,0,0,0
2016-01-12 09:10:00,0,0,0,0,0
2016-01-12 09:20:00,0,0,0,0,0
2016-01-12 09:30:00,0,0,0,0,0
2016-01-12 09:40:00,0,0,1,1,6
2016-01-12 09:50:00,3,0,5,8,48
2016-01-12 10:00:00,10,1,6,17,102
2016-01-12 10:10:00,15,1,16,32,192
2016-01-12 10:20:00,16,3,14,33,198
2016-01-12 10:30:00,13,9,22,44,264
2016-01-12 10:40:00,20,11,33,64,384
2016-01-12 10:50:00,22,9,40,71,426
2016-01-12 11:00:00,32,15,46,93,558
2016-01-12 11:10:00,26,7,34,67,402
2016-01-12 11:20:00,16,5,20,41,246
2016-01-12 11:30:00,24,5,29,58,348
2016-01-12 11:40:00,29,7,40,76,456
2016-01-12 11:50:00,28,7,38,73,438
2016-01-12 12:00:00,31,11,43,85,510
2016-01-12 12:10:00,32,5,37,74,444
2016-01-12 12:20:00,28,5,34,67,402
2016-01-12 12:30:00,28,5,31,64,384
2016-01-12 12:40:00,18,11,32,61,366
2016-01-12 12:50:00,22,10,38,70,420
2016-01-12 13:00:00,36,15,52,103,618
2016-01-12 13:10:00,46,34,72,152,912
2016-01-12 13:20:00,55,32,85,172,1032
2016-01-12 13:30:00,60,42,88,190,1140
2016-01-12 13:40:00,63,39,88,190,1140
2016-01-12 13:50:00,45,52,86,183,1098
2016-01-12 14:00:00,47,44,72,163,978
2016-01-12 14:10:00,58,39,38,135,810
2016-01-12 14:20:00,28,42,64,134,804
2016-01-12 14:30:00,22,25,52,99,594
2016-01-12 14:40:00,13,17,35,65,390
2016-01-12 14:50:00,12,9,23,44,264
2016-01-12 15:00:00,10,4,16,30,180
2016-01-12 15:10:00,4,1,6,11,66
2016-01-12 15:20:00,2,0,2,4,24
2016-01-12 15:30:00,0,0,0,0,0
2016-01-12 15:40:00,0,0,0,0,0
2016-01-12 15:50:00,0,0,0,0,0
2016-01-12 16:00:00,0,0,0,0,0
2016-01-12 16:10:00,0,0,0,0,0
2016-01-13 08:10:00,0,0,0,0,0
2016-01-13 08:20:00,0,0,0,0,0
2016-01-13 08:30:00,0,0,0,0,0
2016-01-13 08:40:00,0,0,0,0,0
2016-01-13 08:50:00,0,0,0,0,0
2016-01-13 09:00:00,4,0,6,10,60
2016-01-13 09:10:00,10,0,24,34,204
2016-01-13 09:20:00,35,4,38,77,462
2016-01-13 09:30:00,56,21,68,145,870
2016-01-13 09:40:00,69,47,100,216,1296
2016-01-13 09:50:00,43,105,118,266,1596
2016-01-13 10:00:00,59,51,95,205,1230
2016-01-13 10:10:00,54,44,85,183,1098
2016-01-13 10:20:00,45,38,75,158,948
2016-01-13 10:30:00,34,26,82,142,852
2016-01-13 10:40:00,61,34,92,187,1122
2016-01-13 10:50:00,52,83,106,241,1446
2016-01-13 11:00:00,65,30,84,179,1074
2016-01-13 11:10:00,42,33,72,147,882
2016-01-13 11:20:00,47,36,79,162,972
2016-01-13 11:30:00,39,62,100,201,1206
2016-01-13 11:40:00,25,62,86,173,1038
2016-01-13 11:50:00,49,58,71,178,1068
2016-01-13 12:00:00,40,26,60,126,756
2016-01-13 12:10:00,33,15,50,98,588
2016-01-13 12:20:00,31,19,49,99,594
2016-01-13 12:30:00,25,24,54,103,618
2016-01-13 12:40:00,23,19,42,84,504
2016-01-13 12:50:00,13,13,33,59,354
2016-01-13 13:00:00,9,17,37,63,378
2016-01-13 13:10:00,17,14,38,69,414
2016-01-13 13:20:00,19,20,65,104,624
2016-01-13 13:30:00,20,43,80,143,858
2016-01-13 13:40:00,43,64,95,202,1212
2016-01-13 13:50:00,3,120,125,248,1488
2016-01-13 14:00:00,0,122,125,247,1482
2016-01-13 14:10:00,45,83,100,228,1368
2016-01-13 14:20:00,43,57,95,195,1170
2016-01-13 14:30:00,23,63,102,188,1128
2016-01-13 14:40:00,32,62,93,187,1122
2016-01-13 14:50:00,40,34,68,142,852
2016-01-13 15:00:00,25,16,47,88,528
2016-01-13 15:10:00,14,7,22,43,258
2016-01-13 15:20:00,6,0,7,13,78
2016-01-13 15:30:00,4,0,5,9,54
2016-01-13 15:40:00,2,0,3,5,30
2016-01-13 15:50:00,0,0,0,0,0
2016-01-13 16:00:00,0,0,0,0,0
2016-01-13 16:10:00,0,0,0,0,0
2016-01-13 16:20:00,0,0,0,0,0
2016-01-14 08:10:00,0,0,0,0,0
2016-01-14 08:20:00,0,0,0,0,0
2016-01-14 08:30:00,0,0,0,0,0
2016-01-14 08:40:00,0,0,0,0,0
2016-01-14 08:50:00,0,0,0,0,0
2016-01-14 09:00:00,0,0,0,0,0
2016-01-14 09:10:00,0,0,0,0,0
2016-01-14 09:20:00,5,0,6,11,66
2016-01-14 09:30:00,6,0,8,14,84
2016-01-14 09:40:00,10,4,14,28,168
2016-01-14 09:50:00,10,3,14,27,162
2016-01-14 10:00:00,6,2,11,19,114
2016-01-14 10:10:00,10,3,15,28,168
2016-01-14 10:20:00,10,2,13,25,150
2016-01-14 10:30:00,9,3,11,23,138
2016-01-14 10:40:00,10,1,12,23,138
2016-01-14 10:50:00,15,2,19,36,216
2016-01-14 11:00:00,17,5,22,44,264
2016-01-14 11:10:00,12,4,15,31,186
2016-01-14 11:20:00,21,4,24,49,294
2016-01-14 11:30:00,22,7,31,60,360
2016-01-14 11:40:00,24,11,39,74,444
2016-01-14 11:50:00,20,27,51,98,588
2016-01-14 12:00:00,34,14,47,95,570
2016-01-14 12:10:00,28,9,37,74,444
2016-01-14 12:20:00,21,8,29,58,348
2016-01-14 12:30:00,24,13,38,75,450
2016-01-14 12:40:00,33,15,51,99,594
2016-01-14 12:50:00,35,6,44,85,510
2016-01-14 13:00:00,38,9,45,92,552
2016-01-14 13:10:00,23,8,34,65,390
2016-01-14 13:20:00,20,7,30,57,342
2016-01-14 13:30:00,21,8,31,60,360
2016-01-14 13:40:00,19,16,39,74,444
2016-01-14 13:50:00,9,18,40,67,402
2016-01-14 14:00:00,19,11,34,64,384
2016-01-14 14:10:00,13,13,34,60,360
2016-01-14 14:20:00,17,12,35,64,384
2016-01-14 14:30:00,14,11,29,54,324
2016-01-14 14:40:00,15,8,25,48,288
2016-01-14 14:50:00,11,6,20,37,222
2016-01-14 15:00:00,10,5,17,32,192
2016-01-14 15:10:00,5,1,7,13,78
2016-01-14 15:20:00,1,0,2,3,18
2016-01-14 15:30:00,2,0,3,5,30
2016-01-14 15:40:00,0,0,0,0,0
2016-01-14 15:50:00,0,0,0,0,0
2016-01-14 16:00:00,0,0,0,0,0
2016-01-14 16:10:00,0,0,0,0,0
2016-01-14 16:20:00,0,0,0,0,0
2016-01-15 08:20:00,0,0,0,0,0
2016-01-15 08:30:00,0,0,0,0,0
2016-01-15 08:40:00,0,0,0,0,0
2016-01-15 08:50:00,0,0,0,0,0
2016-01-15 09:00:00,0,0,0,0,0
2016-01-15 09:10:00,0,0,0,0,0
2016-01-15 09:20:00,5,0,7,12,72
2016-01-15 09:30:00,7,1,11,19,114
2016-01-15 09:40:00,9,16,36,61,366
2016-01-15 09:50:00,8,17,36,61,366
2016-01-15 10:00:00,10,16,35,61,366
2016-01-15 10:10:00,12,20,43,75,450
2016-01-15 10:20:00,11,22,47,80,480
2016-01-15 10:30:00,12,71,84,167,1002
2016-01-15 10:40:00,33,89,102,224,1344
2016-01-15 10:50:00,28,106,108,242,1452
2016-01-15 11:00:00,30,83,111,224,1344
2016-01-15 11:10:00,11,126,130,267,1602
2016-01-15 11:20:00,75,110,154,339,2034
2016-01-15 11:30:00,64,123,189,376,2256
2016-01-15 11:40:00,226,94,220,540,3240
2016-01-15 11:50:00,278,194,177,649,3894
2016-01-15 12:00:00,215,187,204,606,3636
2016-01-15 12:10:00,179,155,171,505,3030
2016-01-15 12:20:00,161,126,171,458,2748
2016-01-15 12:30:00,188,174,195,557,3342
2016-01-15 12:40:00,211,186,205,602,3612
2016-01-15 12:50:00,208,180,196,584,3504
2016-01-15 13:00:00,177,154,167,498,2988
2016-01-15 13:10:00,177,153,165,495,2970
2016-01-15 13:20:00,238,138,162,538,3228
2016-01-15 13:30:00,334,170,122,626,3756
2016-01-15 13:40:00,211,77,271,559,3354
2016-01-15 13:50:00,260,231,249,740,4440
2016-01-15 14:00:00,96,71,93,260,1560
2016-01-15 14:10:00,26,15,43,84,504
2016-01-15 14:20:00,26,3,31,60,360
2016-01-15 14:30:00,14,2,18,34,204
2016-01-15 14:40:00,15,3,20,38,228
2016-01-15 14:50:00,12,5,18,35,210
2016-01-15 15:00:00,7,1,11,19,114
2016-01-15 15:10:00,6,2,16,24,144
2016-01-15 15:20:00,8,2,13,23,138
2016-01-15 15:30:00,5,0,6,11,66
2016-01-15 15:40:00,0,0,0,0,0
2016-01-15 15:50:00,0,0,0,0,0
2016-01-15 16:00:00,0,0,0,0,0
2016-01-15 16:10:00,0,0,0,0,0
2016-01-15 16:20:00,0,0,0,0,0
2016-01-15 16:30:00,0,0,0,0,0
2016-01-16 08:20:00,0,0,0,0,0
2016-01-16 08:30:00,0,0,0,0,0
2016-01-16 08:40:00,0,0,0,0,0
2016-01-16 08:50:00,0,0,0,0,0
2016-01-16 09:00:00,0,0,0,0,0
2016-01-16 09:10:00,0,0,0,0,0
2016-01-16 09:20:00,0,0,0,0,0
2016-01-16 09:30:00,4,0,6,10,60
2016-01-16 09:40:00,7,2,10,19,114
2016-01-16 09:50:00,13,4,19,36,216
2016-01-16 10:00:00,9,3,14,26,156
2016-01-16 10:10:00,4,0,4,8,48
2016-01-16 10:20:00,1,0,1,2,12
2016-01-16 10:30:00,0,0,0,0,0
2016-01-16 10:40:00,2,0,3,5,30
2016-01-16 10:50:00,17,3,21,41,246
2016-01-16 11:00:00,24,5,29,58,348
2016-01-16 11:10:00,28,13,54,95,570
2016-01-16 11:20:00,30,42,61,133,798
2016-01-16 11:30:00,37,54,87,178,1068
2016-01-16 11:40:00,71,20,84,175,1050
2016-01-16 11:50:00,48,20,67,135,810
2016-01-16 12:00:00,51,30,74,155,930
2016-01-16 12:10:00,28,15,72,115,690
2016-01-16 12:20:00,26,12,58,96,576
2016-01-16 12:30:00,53,25,72,150,900
2016-01-16 12:40:00,75,37,96,208,1248
2016-01-16 12:50:00,46,90,111,247,1482
2016-01-16 13:00:00,36,90,102,228,1368
2016-01-16 13:10:00,66,30,87,183,1098
2016-01-16 13:20:00,27,58,83,168,1008
2016-01-16 13:30:00,82,26,91,199,1194
2016-01-16 13:40:00,42,23,80,145,870
2016-01-16 13:50:00,26,21,71,118,708
2016-01-16 14:00:00,17,10,95,122,732
2016-01-16 14:10:00,18,21,87,126,756
2016-01-16 14:20:00,37,34,66,137,822
2016-01-16 14:30:00,59,55,102,216,1296
2016-01-16 14:40:00,26,81,107,214,1284
2016-01-16 14:50:00,34,48,82,164,984
2016-01-16 15:00:00,54,50,97,201,1206
2016-01-16 15:10:00,8,118,128,254,1524
2016-01-16 15:20:00,5,122,129,256,1536
2016-01-16 15:30:00,27,39,77,143,858
2016-01-16 15:40:00,18,20,45,83,498
2016-01-16 15:50:00,10,7,20,37,222
2016-01-16 16:00:00,3,0,4,7,42
2016-01-16 16:10:00,0,0,0,0,0
2016-01-16 16:20:00,0,0,0,0,0
2016-01-16 16:30:00,0,0,0,0,0
2016-01-17 08:00:00,0,0,0,0,0
2016-01-17 08:10:00,0,0,0,0,0
2016-01-17 08:20:00,0,0,0,0,0
2016-01-17 08:30:00,0,0,0,0,0
2016-01-17 08:40:00,0,0,0,0,0
2016-01-17 08:50:00,1,0,3,4,24
2016-01-17 09:00:00,5,0,8,13,78
2016-01-17 09:10:00,10,2,14,26,156
2016-01-17 09:20:00,15,4,21,40,240
2016-01-17 09:30:00,21,5,26,52,312
2016-01-17 09:40:00,46,75,118,239,1434
2016-01-17 09:50:00,198,136,244,578,3468
2016-01-17 10:00:00,296,263,283,842,5052
2016-01-17 10:10:00,401,365,386,1152,6912
2016-01-17 10:20:00,501,464,489,1454,8724
2016-01-17 10:30:00,541,507,522,1570,9420
2016-01-17 10:40:00,520,493,502,1515,9090
2016-01-17 10:50:00,460,431,443,1334,8004
2016-01-17 11:00:00,362,334,346,1042,6252
2016-01-17 11:10:00,315,286,300,901,5406
2016-01-17 11:20:00,274,248,263,785,4710
2016-01-17 11:30:00,245,219,233,697,4182
2016-01-17 11:40:00,215,189,205,609,3654
2016-01-17 11:50:00,217,190,205,612,3672
2016-01-17 12:00:00,243,216,231,690,4140
2016-01-17 12:10:00,265,240,259,764,4584
2016-01-17 12:20:00,274,248,267,789,4734
2016-01-17 12:30:00,291,261,283,835,5010
2016-01-17 12:40:00,447,406,432,1285,7710
2016-01-17 12:50:00,562,517,544,1623,9738
2016-01-17 13:00:00,654,612,640,1906,11436
2016-01-17 13:10:00,655,617,643,1915,11490
2016-01-17 13:20:00,611,575,596,1782,10692
2016-01-17 13:30:00,564,527,549,1640,9840
2016-01-17 13:40:00,520,488,509,1517,9102
2016-01-17 13:50:00,448,419,436,1303,7818
2016-01-17 14:00:00,257,230,249,736,4416
2016-01-17 14:10:00,36,40,73,149,894
2016-01-17 14:20:00,70,52,111,233,1398
2016-01-17 14:30:00,46,44,89,179,1074
2016-01-17 14:40:00,34,33,76,143,858
2016-01-17 14:50:00,51,32,84,167,1002
2016-01-17 15:00:00,35,15,61,111,666
2016-01-17 15:10:00,34,7,44,85,510
2016-01-17 15:20:00,18,7,28,53,318
2016-01-17 15:30:00,12,5,20,37,222
2016-01-17 15:40:00,14,1,15,30,180
2016-01-17 15:50:00,9,0,11,20,120
2016-01-17 16:00:00,3,0,6,9,54
2016-01-17 16:10:00,0,0,0,0,0
2016-01-17 16:20:00,0,0,0,0,0
2016-01-17 16:30:00,0,0,0,0,0
2016-01-17 16:40:00,0,0,0,0,0
2016-01-18 08:00:00,0,0,0,0,0
2016-01-18 08:10:00,0,0,0,0,0
2016-01-18 08:20:00,0,0,0,0,0
2016-01-18 08:30:00,0,0,0,0,0
2016-01-18 08:40:00,2,0,3,5,30
2016-01-18 08:50:00,13,12,30,55,330
2016-01-18 09:00:00,15,15,44,74,444
2016-01-18 09:10:00,16,22,56,94,564
2016-01-18 09:20:00,23,55,80,158,948
2016-01-18 09:30:00,26,52,80,158,948
2016-01-18 09:40:00,27,22,56,105,630
2016-01-18 09:50:00,13,10,27,50,300
2016-01-18 10:00:00,11,7,19,37,222
2016-01-18 10:10:00,22,28,66,116,696
2016-01-18 10:20:00,41,51,81,173,1038
2016-01-18 10:30:00,34,84,111,229,1374
2016-01-18 10:40:00,76,137,132,345,2070
2016-01-18 10:50:00,285,254,277,816,4896
2016-01-18 11:00:00,270,239,263,772,4632
2016-01-18 11:10:00,192,165,184,541,3246
2016-01-18 11:20:00,201,175,195,571,3426
2016-01-18 11:30:00,218,190,209,617,3702
2016-01-18 11:40:00,196,168,187,551,3306
2016-01-18 11:50:00,200,171,190,561,3366
2016-01-18 12:00:00,169,142,162,473,2838
2016-01-18 12:10:00,156,130,149,435,2610
2016-01-18 12:20:00,106,125,149,380,2280
2016-01-18 12:30:00,5,147,159,311,1866
2016-01-18 12:40:00,76,109,175,360,2160
2016-01-18 12:50:00,0,150,160,310,1860
2016-01-18 13:00:00,13,147,160,320,1920
2016-01-18 13:10:00,9,155,170,334,2004
2016-01-18 13:20:00,106,98,165,369,2214
2016-01-18 13:30:00,442,364,470,1276,7656
2016-01-18 13:40:00,534,496,521,1551,9306
2016-01-18 13:50:00,483,445,470,1398,8388
2016-01-18 14:00:00,417,381,406,1204,7224
2016-01-18 14:10:00,345,311,334,990,5940
2016-01-18 14:20:00,298,268,288,854,5124
2016-01-18 14:30:00,154,130,145,429,2574
2016-01-18 14:40:00,31,33,71,135,810
2016-01-18 14:50:00,24,19,78,121,726
2016-01-18 15:00:00,35,15,51,101,606
2016-01-18 15:10:00,27,15,46,88,528
2016-01-18 15:20:00,9,12,33,54,324
2016-01-18 15:30:00,8,2,11,21,126
2016-01-18 15:40:00,4,1,7,12,72
2016-01-18 15:50:00,3,0,4,7,42
2016-01-18 16:00:00,5,0,4,9,54
2016-01-18 16:10:00,1,0,2,3,18
2016-01-18 16:20:00,0,0,0,0,0
2016-01-18 16:30:00,0,0,0,0,0
2016-01-18 16:40:00,0,0,0,0,0
2016-01-19 08:20:00,0,0,0,0,0
2016-01-19 08:30:00,0,0,0,0,0
2016-01-19 08:40:00,0,0,0,0,0
2016-01-19 08:50:00,0,0,0,0,0
2016-01-19 09:00:00,3,0,5,8,48
2016-01-19 09:10:00,11,2,14,27,162
2016-01-19 09:20:00,11,1,13,25,150
2016-01-19 09:30:00,18,7,28,53,318
2016-01-19 09:40:00,30,16,57,103,618
2016-01-19 09:50:00,187,183,208,578,3468
2016-01-19 10:00:00,288,258,276,822,4932
2016-01-19 10:10:00,25,117,137,279,1674
2016-01-19 10:20:00,241,138,197,576,3456
2016-01-19 10:30:00,141,121,127,389,2334
2016-01-19 10:40:00,475,441,462,1378,8268
2016-01-19 10:50:00,516,481,503,1500,9000
2016-01-19 11:00:00,267,241,258,766,4596
2016-01-19 11:10:00,140,117,133,390,2340
2016-01-19 11:20:00,63,108,111,282,1692
2016-01-19 11:30:00,0,135,134,269,1614
2016-01-19 11:40:00,40,130,176,346,2076
2016-01-19 11:50:00,120,106,173,399,2394
2016-01-19 12:00:00,114,126,142,382,2292
2016-01-19 12:10:00,203,176,193,572,3432
2016-01-19 12:20:00,265,235,256,756,4536
2016-01-19 12:30:00,274,247,266,787,4722
2016-01-19 12:40:00,320,290,309,919,5514
2016-01-19 12:50:00,460,427,450,1337,8022
2016-01-19 13:00:00,495,460,482,1437,8622
2016-01-19 13:10:00,637,601,625,1863,11178
2016-01-19 13:20:00,539,504,528,1571,9426
2016-01-19 13:30:00,500,470,494,1464,8784
2016-01-19 13:40:00,435,404,428,1267,7602
2016-01-19 13:50:00,414,382,406,1202,7212
2016-01-19 14:00:00,303,275,294,872,5232
2016-01-19 14:10:00,355,328,351,1034,6204
2016-01-19 14:20:00,299,273,295,867,5202
2016-01-19 14:30:00,247,222,242,711,4266
2016-01-19 14:40:00,195,169,189,553,3318
2016-01-19 14:50:00,109,140,162,411,2466
2016-01-19 15:00:00,1,141,150,292,1752
2016-01-19 15:10:00,24,61,83,168,1008
2016-01-19 15:20:00,18,20,45,83,498
2016-01-19 15:30:00,15,14,35,64,384
2016-01-19 15:40:00,14,10,28,52,312
2016-01-19 15:50:00,11,5,17,33,198
2016-01-19 16:00:00,4,1,8,13,78
2016-01-19 16:10:00,0,0,0,0,0
2016-01-19 16:20:00,0,0,0,0,0
2016-01-19 16:30:00,0,0,0,0,0
2016-01-19 16:40:00,0,0,0,0,0
2016-01-20 08:00:00,0,0,0,0,0
2016-01-20 08:10:00,0,0,0,0,0
2016-01-20 08:20:00,0,0,0,0,0
2016-01-20 08:30:00,0,0,0,0,0
2016-01-20 08:40:00,0,0,0,0,0
2016-01-20 08:50:00,0,0,0,0,0
2016-01-20 09:00:00,2,0,4,6,36
2016-01-20 09:10:00,6,1,9,16,96
2016-01-20 09:20:00,8,4,16,28,168
2016-01-20 09:30:00,13,12,23,48,288
2016-01-20 09:40:00,25,19,48,92,552
2016-01-20 09:50:00,28,32,76,136,816
2016-01-20 10:00:00,23,24,72,119,714
2016-01-20 10:10:00,28,32,68,128,768
2016-01-20 10:20:00,33,38,74,145,870
2016-01-20 10:30:00,44,58,94,196,1176
2016-01-20 10:40:00,60,43,96,199,1194
2016-01-20 10:50:00,60,40,97,197,1182
2016-01-20 11:00:00,12,108,127,247,1482
2016-01-20 11:10:00,47,73,107,227,1362
2016-01-20 11:20:00,26,119,121,266,1596
2016-01-20 11:30:00,31,132,152,315,1890
2016-01-20 11:40:00,0,133,142,275,1650
2016-01-20 11:50:00,63,145,158,366,2196
2016-01-20 12:00:00,64,132,159,355,2130
2016-01-20 12:10:00,81,153,162,396,2376
2016-01-20 12:20:00,130,129,154,413,2478
2016-01-20 12:30:00,114,76,226,416,2496
2016-01-20 12:40:00,161,86,212,459,2754
2016-01-20 12:50:00,213,184,202,599,3594
2016-01-20 13:00:00,180,150,162,492,2952
2016-01-20 13:10:00,28,145,159,332,1992
2016-01-20 13:20:00,11,131,145,287,1722
2016-01-20 13:30:00,48,127,164,339,2034
2016-01-20 13:40:00,192,44,253,489,2934
2016-01-20 13:50:00,20,143,156,319,1914
2016-01-20 14:00:00,46,113,147,306,1836
2016-01-20 14:10:00,24,91,109,224,1344
2016-01-20 14:20:00,45,36,77,158,948
2016-01-20 14:30:00,51,27,73,151,906
2016-01-20 14:40:00,34,23,76,133,798
2016-01-20 14:50:00,32,16,73,121,726
2016-01-20 15:00:00,32,34,48,114,684
2016-01-20 15:10:00,32,23,70,125,750
2016-01-20 15:20:00,35,20,58,113,678
2016-01-20 15:30:00,53,20,70,143,858
2016-01-20 15:40:00,26,4,30,60,360
2016-01-20 15:50:00,14,2,16,32,192
2016-01-20 16:00:00,5,0,11,16,96
2016-01-20 16:10:00,1,0,2,3,18
2016-01-20 16:20:00,0,0,0,0,0
2016-01-20 16:30:00,0,0,0,0,0
2016-01-20 16:40:00,0,0,0,0,0
2016-01-21 07:50:00,0,0,0,0,0
2016-01-21 08:00:00,0,0,0,0,0
2016-01-21 08:10:00,0,0,0,0,0
2016-01-21 08:20:00,0,0,0,0,0
2016-01-21 08:30:00,0,0,0,0,0
2016-01-21 08:40:00,5,0,6,11,66
2016-01-21 08:50:00,11,1,11,23,138
2016-01-21 09:00:00,14,4,19,37,222
2016-01-21 09:10:00,21,6,25,52,312
2016-01-21 09:20:00,28,6,32,66,396
2016-01-21 09:30:00,29,11,41,81,486
2016-01-21 09:40:00,237,143,186,566,3396
2016-01-21 09:50:00,309,278,295,882,5292
2016-01-21 10:00:00,421,381,405,1207,7242
2016-01-21 10:10:00,518,477,502,1497,8982
2016-01-21 10:20:00,580,535,561,1676,10056
2016-01-21 10:30:00,608,562,592,1762,10572
2016-01-21 10:40:00,583,541,569,1693,10158
2016-01-21 10:50:00,492,452,478,1422,8532
2016-01-21 11:00:00,389,351,374,1114,6684
2016-01-21 11:10:00,328,296,317,941,5646
2016-01-21 11:20:00,300,269,289,858,5148
2016-01-21 11:30:00,264,233,254,751,4506
2016-01-21 11:40:00,251,223,242,716,4296
2016-01-21 11:50:00,229,199,219,647,3882
2016-01-21 12:00:00,272,241,262,775,4650
2016-01-21 12:10:00,298,267,286,851,5106
2016-01-21 12:20:00,290,260,278,828,4968
2016-01-21 12:30:00,307,277,295,879,5274
2016-01-21 12:40:00,280,249,267,796,4776
2016-01-21 12:50:00,333,301,321,955,5730
2016-01-21 13:00:00,478,443,467,1388,8328
2016-01-21 13:10:00,148,123,136,407,2442
2016-01-21 13:20:00,154,127,143,424,2544
2016-01-21 13:30:00,143,118,134,395,2370
2016-01-21 13:40:00,129,105,119,353,2118
2016-01-21 13:50:00,76,105,115,296,1776
2016-01-21 14:00:00,34,96,111,241,1446
2016-01-21 14:10:00,47,59,88,194,1164
2016-01-21 14:20:00,77,45,92,214,1284
2016-01-21 14:30:00,68,56,107,231,1386
2016-01-21 14:40:00,49,69,101,219,1314
2016-01-21 14:50:00,169,122,207,498,2988
2016-01-21 15:00:00,29,143,162,334,2004
2016-01-21 15:10:00,51,70,80,201,1206
2016-01-21 15:20:00,26,13,42,81,486
2016-01-21 15:30:00,26,8,35,69,414
2016-01-21 15:40:00,11,2,16,29,174
2016-01-21 15:50:00,8,1,11,20,120
2016-01-21 16:00:00,4,0,5,9,54
2016-01-21 16:10:00,1,0,1,2,12
2016-01-21 16:20:00,0,0,0,0,0
2016-01-21 16:30:00,0,0,0,0,0
2016-01-21 16:40:00,0,0,0,0,0
2016-01-22 08:00:00,0,0,0,0,0
2016-01-22 08:10:00,0,0,0,0,0
2016-01-22 08:20:00,0,0,0,0,0
2016-01-22 08:30:00,0,0,0,0,0
2016-01-22 08:40:00,5,1,7,13,78
2016-01-22 08:50:00,15,6,25,46,276
2016-01-22 09:00:00,27,19,53,99,594
2016-01-22 09:10:00,21,55,77,153,918
2016-01-22 09:20:00,26,76,104,206,1236
2016-01-22 09:30:00,42,73,103,218,1308
2016-01-22 09:40:00,201,132,235,568,3408
2016-01-22 09:50:00,287,258,277,822,4932
2016-01-22 10:00:00,382,350,370,1102,6612
2016-01-22 10:10:00,466,432,454,1352,8112
2016-01-22 10:20:00,519,487,511,1517,9102
2016-01-22 10:30:00,566,537,562,1665,9990
2016-01-22 10:40:00,552,525,547,1624,9744
2016-01-22 10:50:00,492,461,483,1436,8616
2016-01-22 11:00:00,385,355,375,1115,6690
2016-01-22 11:10:00,327,296,317,940,5640
2016-01-22 11:20:00,293,263,285,841,5046
2016-01-22 11:30:00,272,245,265,782,4692
2016-01-22 11:40:00,258,230,250,738,4428
2016-01-22 11:50:00,234,207,228,669,4014
2016-01-22 12:00:00,282,255,276,813,4878
2016-01-22 12:10:00,292,266,286,844,5064
2016-01-22 12:20:00,316,286,307,909,5454
2016-01-22 12:30:00,331,300,322,953,5718
2016-01-22 12:40:00,387,355,378,1120,6720
2016-01-22 12:50:00,513,480,504,1497,8982
2016-01-22 13:00:00,605,567,592,1764,10584
2016-01-22 13:10:00,540,502,524,1566,9396
2016-01-22 13:20:00,415,383,403,1201,7206
2016-01-22 13:30:00,325,297,317,939,5634
2016-01-22 13:40:00,300,275,294,869,5214
2016-01-22 13:50:00,321,297,316,934,5604
2016-01-22 14:00:00,348,321,345,1014,6084
2016-01-22 14:10:00,290,264,287,841,5046
2016-01-22 14:20:00,200,174,193,567,3402
2016-01-22 14:30:00,229,201,221,651,3906
2016-01-22 14:40:00,234,208,226,668,4008
2016-01-22 14:50:00,214,188,205,607,3642
2016-01-22 15:00:00,169,144,160,473,2838
2016-01-22 15:10:00,77,79,110,266,1596
2016-01-22 15:20:00,65,66,91,222,1332
2016-01-22 15:30:00,35,49,80,164,984
2016-01-22 15:40:00,33,22,55,110,660
2016-01-22 15:50:00,18,9,29,56,336
2016-01-22 16:00:00,9,3,10,22,132
2016-01-22 16:10:00,1,0,1,2,12
2016-01-22 16:20:00,0,0,0,0,0
2016-01-22 16:30:00,0,0,0,0,0
2016-01-22 16:40:00,0,0,0,0,0
2016-01-23 08:30:00,0,0,0,0,0
2016-01-23 08:40:00,0,0,0,0,0
2016-01-23 08:50:00,0,0,0,0,0
2016-01-23 09:00:00,0,0,0,0,0
2016-01-23 09:10:00,0,0,0,0,0
2016-01-23 09:20:00,0,0,0,0,0
2016-01-23 09:30:00,0,0,0,0,0
2016-01-23 09:40:00,0,0,0,0,0
2016-01-23 09:50:00,0,0,0,0,0
2016-01-23 10:00:00,0,0,0,0,0
2016-01-23 10:10:00,0,0,0,0,0
2016-01-23 10:20:00,0,0,0,0,0
2016-01-23 10:30:00,0,0,0,0,0
2016-01-23 10:40:00,0,0,2,2,12
2016-01-23 10:50:00,0,0,0,0,0
2016-01-23 11:00:00,0,0,0,0,0
2016-01-23 11:10:00,0,0,1,1,6
2016-01-23 11:20:00,1,0,2,3,18
2016-01-23 11:30:00,2,0,4,6,36
2016-01-23 11:40:00,1,0,3,4,24
2016-01-23 11:50:00,0,0,2,2,12
2016-01-23 12:00:00,1,0,2,3,18
2016-01-23 12:10:00,2,0,3,5,30
2016-01-23 12:20:00,6,0,7,13,78
2016-01-23 12:30:00,6,0,7,13,78
2016-01-23 12:40:00,3,0,5,8,48
2016-01-23 12:50:00,5,0,6,11,66
2016-01-23 13:00:00,6,0,7,13,78
2016-01-23 13:10:00,1,0,2,3,18
2016-01-23 13:20:00,0,0,0,0,0
2016-01-23 13:30:00,0,0,0,0,0
2016-01-23 13:40:00,0,0,1,1,6
2016-01-23 13:50:00,0,0,0,0,0
2016-01-23 14:00:00,0,0,0,0,0
2016-01-23 14:10:00,1,0,1,2,12
2016-01-23 14:20:00,0,0,1,1,6
2016-01-23 14:30:00,0,0,0,0,0
2016-01-23 14:40:00,0,0,0,0,0
2016-01-23 14:50:00,0,0,0,0,0
2016-01-23 15:00:00,0,0,0,0,0
2016-01-23 15:10:00,0,0,0,0,0
2016-01-23 15:20:00,0,0,0,0,0
2016-01-23 15:30:00,0,0,0,0,0
2016-01-23 15:40:00,0,0,0,0,0
2016-01-23 15:50:00,0,0,0,0,0
2016-01-23 16:00:00,0,0,0,0,0
2016-01-23 16:10:00,0,0,0,0,0
2016-01-23 16:20:00,0,0,0,0,0
2016-01-23 16:30:00,0,0,0,0,0
2016-01-24 08:00:00,0,0,0,0,0
2016-01-24 08:10:00,0,0,0,0,0
2016-01-24 08:20:00,0,0,0,0,0
2016-01-24 08:30:00,0,0,0,0,0
2016-01-24 08:40:00,0,0,0,0,0
2016-01-24 08:50:00,0,0,0,0,0
2016-01-24 09:00:00,4,1,4,9,54
2016-01-24 09:10:00,8,5,13,26,156
2016-01-24 09:20:00,24,5,29,58,348
2016-01-24 09:30:00,35,6,42,83,498
2016-01-24 09:40:00,31,2,33,66,396
2016-01-24 09:50:00,30,11,41,82,492
2016-01-24 10:00:00,37,10,47,94,564
2016-01-24 10:10:00,36,10,48,94,564
2016-01-24 10:20:00,48,26,65,139,834
2016-01-24 10:30:00,59,19,75,153,918
2016-01-24 10:40:00,35,20,63,118,708
2016-01-24 10:50:00,42,18,56,116,696
2016-01-24 11:00:00,69,11,81,161,966
2016-01-24 11:10:00,38,24,70,132,792
2016-01-24 11:20:00,35,24,68,127,762
2016-01-24 11:30:00,60,28,83,171,1026
2016-01-24 11:40:00,72,20,90,182,1092
2016-01-24 11:50:00,22,70,96,188,1128
2016-01-24 12:00:00,17,110,119,246,1476
2016-01-24 12:10:00,0,134,135,269,1614
2016-01-24 12:20:00,10,129,130,269,1614
2016-01-24 12:30:00,67,64,81,212,1272
2016-01-24 12:40:00,64,69,85,218,1308
2016-01-24 12:50:00,36,61,87,184,1104
2016-01-24 13:00:00,23,62,89,174,1044
2016-01-24 13:10:00,61,28,83,172,1032
2016-01-24 13:20:00,45,66,103,214,1284
2016-01-24 13:30:00,38,61,86,185,1110
2016-01-24 13:40:00,28,44,64,136,816
2016-01-24 13:50:00,29,34,75,138,828
2016-01-24 14:00:00,43,26,67,136,816
2016-01-24 14:10:00,40,33,73,146,876
2016-01-24 14:20:00,28,23,53,104,624
2016-01-24 14:30:00,23,14,44,81,486
2016-01-24 14:40:00,29,7,38,74,444
2016-01-24 14:50:00,23,4,27,54,324
2016-01-24 15:00:00,15,3,20,38,228
2016-01-24 15:10:00,7,1,9,17,102
2016-01-24 15:20:00,4,1,5,10,60
2016-01-24 15:30:00,0,0,0,0,0
2016-01-24 15:40:00,0,0,0,0,0
2016-01-24 15:50:00,0,0,0,0,0
2016-01-24 16:00:00,0,0,0,0,0
2016-01-24 16:10:00,0,0,0,0,0
2016-01-24 16:20:00,0,0,0,0,0
2016-01-24 16:30:00,0,0,0,0,0
2016-01-25 08:00:00,0,0,0,0,0
2016-01-25 08:10:00,0,0,0,0,0
2016-01-25 08:20:00,0,0,0,0,0
2016-01-25 08:30:00,0,0,0,0,0
2016-01-25 08:40:00,0,0,0,0,0
2016-01-25 08:50:00,3,1,4,8,48
2016-01-25 09:00:00,4,0,7,11,66
2016-01-25 09:10:00,10,4,14,28,168
2016-01-25 09:20:00,11,5,16,32,192
2016-01-25 09:30:00,12,3,16,31,186
2016-01-25 09:40:00,16,2,17,35,210
2016-01-25 09:50:00,23,38,53,114,684
2016-01-25 10:00:00,25,52,64,141,846
2016-01-25 10:10:00,14,20,39,73,438
2016-01-25 10:20:00,10,14,29,53,318
2016-01-25 10:30:00,11,11,25,47,282
2016-01-25 10:40:00,12,22,35,69,414
2016-01-25 10:50:00,9,18,35,62,372
2016-01-25 11:00:00,17,8,28,53,318
2016-01-25 11:10:00,18,23,59,100,600
2016-01-25 11:20:00,22,24,74,120,720
2016-01-25 11:30:00,36,31,64,131,786
2016-01-25 11:40:00,36,35,71,142,852
2016-01-25 11:50:00,37,103,111,251,1506
2016-01-25 12:00:00,20,138,159,317,1902
2016-01-25 12:10:00,59,123,153,335,2010
2016-01-25 12:20:00,30,128,149,307,1842
2016-01-25 12:30:00,93,35,128,256,1536
2016-01-25 12:40:00,82,33,95,210,1260
2016-01-25 12:50:00,22,108,116,246,1476
2016-01-25 13:00:00,71,57,115,243,1458
2016-01-25 13:10:00,52,83,102,237,1422
2016-01-25 13:20:00,64,52,101,217,1302
2016-01-25 13:30:00,61,68,91,220,1320
2016-01-25 13:40:00,31,50,71,152,912
2016-01-25 13:50:00,32,51,78,161,966
2016-01-25 14:00:00,42,42,82,166,996
2016-01-25 14:10:00,27,52,76,155,930
2016-01-25 14:20:00,25,55,77,157,942
2016-01-25 14:30:00,46,42,82,170,1020
2016-01-25 14:40:00,31,38,68,137,822
2016-01-25 14:50:00,26,48,70,144,864
2016-01-25 15:00:00,18,70,73,161,966
2016-01-25 15:10:00,32,41,59,132,792
2016-01-25 15:20:00,23,24,64,111,666
2016-01-25 15:30:00,26,17,47,90,540
2016-01-25 15:40:00,13,20,40,73,438
2016-01-25 15:50:00,11,16,35,62,372
2016-01-25 16:00:00,7,8,19,34,204
2016-01-25 16:10:00,5,2,8,15,90
2016-01-25 16:20:00,0,0,0,0,0
2016-01-25 16:30:00,0,0,0,0,0
2016-01-25 16:40:00,0,0,0,0,0
2016-01-26 07:50:00,0,0,0,0,0
2016-01-26 08:00:00,0,0,0,0,0
2016-01-26 08:10:00,0,0,0,0,0
2016-01-26 08:20:00,0,0,0,0,0
2016-01-26 08:30:00,0,0,1,1,6
2016-01-26 08:40:00,3,1,4,8,48
2016-01-26 08:50:00,9,6,19,34,204
2016-01-26 09:00:00,18,21,36,75,450
2016-01-26 09:10:00,33,30,67,130,780
2016-01-26 09:20:00,39,35,77,151,906
2016-01-26 09:30:00,29,47,74,150,900
2016-01-26 09:40:00,49,89,109,247,1482
2016-01-26 09:50:00,240,172,159,571,3426
2016-01-26 10:00:00,321,260,262,843,5058
2016-01-26 10:10:00,360,330,351,1041,6246
2016-01-26 10:20:00,306,277,296,879,5274
2016-01-26 10:30:00,215,190,203,608,3648
2016-01-26 10:40:00,89,52,109,250,1500
2016-01-26 10:50:00,28,104,129,261,1566
2016-01-26 11:00:00,32,98,126,256,1536
2016-01-26 11:10:00,66,112,157,335,2010
2016-01-26 11:20:00,94,98,140,332,1992
2016-01-26 11:30:00,14,127,142,283,1698
2016-01-26 11:40:00,15,114,122,251,1506
2016-01-26 11:50:00,195,106,181,482,2892
2016-01-26 12:00:00,253,195,49,497,2982
2016-01-26 12:10:00,127,95,161,383,2298
2016-01-26 12:20:00,65,118,139,322,1932
2016-01-26 12:30:00,51,73,110,234,1404
2016-01-26 12:40:00,72,16,81,169,1014
2016-01-26 12:50:00,46,68,100,214,1284
2016-01-26 13:00:00,140,66,155,361,2166
2016-01-26 13:10:00,87,117,152,356,2136
2016-01-26 13:20:00,49,102,118,269,1614
2016-01-26 13:30:00,29,126,139,294,1764
2016-01-26 13:40:00,58,110,136,304,1824
2016-01-26 13:50:00,31,102,121,254,1524
2016-01-26 14:00:00,132,57,157,346,2076
2016-01-26 14:10:00,95,104,145,344,2064
2016-01-26 14:20:00,26,117,124,267,1602
2016-01-26 14:30:00,31,126,134,291,1746
2016-01-26 14:40:00,96,33,106,235,1410
2016-01-26 14:50:00,65,22,78,165,990
2016-01-26 15:00:00,40,23,61,124,744
2016-01-26 15:10:00,34,6,42,82,492
2016-01-26 15:20:00,27,4,34,65,390
2016-01-26 15:30:00,24,7,38,69,414
2016-01-26 15:40:00,17,4,19,40,240
2016-01-26 15:50:00,7,0,7,14,84
2016-01-26 16:00:00,0,0,0,0,0
2016-01-26 16:10:00,0,0,0,0,0
2016-01-26 16:20:00,0,0,0,0,0
2016-01-26 16:30:00,0,0,0,0,0
2016-01-26 16:40:00,0,0,0,0,0
2016-01-27 08:00:00,0,0,0,0,0
2016-01-27 08:10:00,0,0,0,0,0
2016-01-27 08:20:00,0,0,0,0,0
2016-01-27 08:30:00,0,0,0,0,0
2016-01-27 08:40:00,0,0,0,0,0
2016-01-27 08:50:00,0,0,0,0,0
2016-01-27 09:00:00,2,0,2,4,24
2016-01-27 09:10:00,4,3,5,12,72
2016-01-27 09:20:00,9,3,10,22,132
2016-01-27 09:30:00,13,2,15,30,180
2016-01-27 09:40:00,18,2,16,36,216
2016-01-27 09:50:00,12,2,15,29,174
2016-01-27 10:00:00,14,7,19,40,240
2016-01-27 10:10:00,13,7,21,41,246
2016-01-27 10:20:00,17,6,23,46,276
2016-01-27 10:30:00,30,22,52,104,624
2016-01-27 10:40:00,38,24,59,121,726
2016-01-27 10:50:00,42,10,51,103,618
2016-01-27 11:00:00,41,19,56,116,696
2016-01-27 11:10:00,34,10,44,88,528
2016-01-27 11:20:00,32,7,39,78,468
2016-01-27 11:30:00,26,8,35,69,414
2016-01-27 11:40:00,23,11,38,72,432
2016-01-27 11:50:00,20,15,41,76,456
2016-01-27 12:00:00,33,8,43,84,504
2016-01-27 12:10:00,39,8,46,93,558
2016-01-27 12:20:00,38,24,56,118,708
2016-01-27 12:30:00,41,17,52,110,660
2016-01-27 12:40:00,39,9,46,94,564
2016-01-27 12:50:00,30,10,44,84,504
2016-01-27 13:00:00,22,9,30,61,366
2016-01-27 13:10:00,37,43,73,153,918
2016-01-27 13:20:00,23,20,46,89,534
2016-01-27 13:30:00,21,24,50,95,570
2016-01-27 13:40:00,28,33,69,130,780
2016-01-27 13:50:00,30,17,48,95,570
2016-01-27 14:00:00,22,22,50,94,564
2016-01-27 14:10:00,12,15,20,47,282
2016-01-27 14:20:00,13,10,23,46,276
2016-01-27 14:30:00,11,6,17,34,204
2016-01-27 14:40:00,10,4,11,25,150
2016-01-27 14:50:00,11,4,14,29,174
2016-01-27 15:00:00,9,5,18,32,192
2016-01-27 15:10:00,16,4,17,37,222
2016-01-27 15:20:00,12,4,14,30,180
2016-01-27 15:30:00,13,6,15,34,204
2016-01-27 15:40:00,20,5,26,51,306
2016-01-27 15:50:00,22,9,36,67,402
2016-01-27 16:00:00,16,7,17,40,240
2016-01-27 16:10:00,3,1,4,8,48
2016-01-27 16:20:00,0,0,0,0,0
2016-01-27 16:30:00,0,0,0,0,0
2016-01-27 16:40:00,0,0,0,0,0
2016-01-28 07:50:00,0,0,0,0,0
2016-01-28 08:00:00,0,0,0,0,0
2016-01-28 08:10:00,0,0,0,0,0
2016-01-28 08:20:00,0,0,0,0,0
2016-01-28 08:30:00,7,3,6,16,96
2016-01-28 08:40:00,16,6,18,40,240
2016-01-28 08:50:00,28,7,29,64,384
2016-01-28 09:00:00,38,9,48,95,570
2016-01-28 09:10:00,34,32,58,124,744
2016-01-28 09:20:00,38,34,73,145,870
2016-01-28 09:30:00,67,31,86,184,1104
2016-01-28 09:40:00,195,99,247,541,3246
2016-01-28 09:50:00,274,248,265,787,4722
2016-01-28 10:00:00,353,324,343,1020,6120
2016-01-28 10:10:00,447,414,434,1295,7770
2016-01-28 10:20:00,503,469,491,1463,8778
2016-01-28 10:30:00,561,526,553,1640,9840
2016-01-28 10:40:00,565,535,560,1660,9960
2016-01-28 10:50:00,511,479,501,1491,8946
2016-01-28 11:00:00,405,379,394,1178,7068
2016-01-28 11:10:00,357,331,349,1037,6222
2016-01-28 11:20:00,346,319,339,1004,6024
2016-01-28 11:30:00,342,311,331,984,5904
2016-01-28 11:40:00,315,286,305,906,5436
2016-01-28 11:50:00,315,289,309,913,5478
2016-01-28 12:00:00,347,316,335,998,5988
2016-01-28 12:10:00,342,314,332,988,5928
2016-01-28 12:20:00,351,321,341,1013,6078
2016-01-28 12:30:00,373,342,362,1077,6462
2016-01-28 12:40:00,425,395,417,1237,7422
2016-01-28 12:50:00,189,167,195,551,3306
2016-01-28 13:00:00,293,280,306,879,5274
2016-01-28 13:10:00,703,671,697,2071,12426
2016-01-28 13:20:00,582,551,576,1709,10254
2016-01-28 13:30:00,309,283,303,895,5370
2016-01-28 13:40:00,42,31,57,130,780
2016-01-28 13:50:00,216,199,221,636,3816
2016-01-28 14:00:00,339,310,330,979,5874
2016-01-28 14:10:00,89,75,98,262,1572
2016-01-28 14:20:00,55,27,72,154,924
2016-01-28 14:30:00,130,75,122,327,1962
2016-01-28 14:40:00,83,14,88,185,1110
2016-01-28 14:50:00,50,61,85,196,1176
2016-01-28 15:00:00,81,116,142,339,2034
2016-01-28 15:10:00,44,35,64,143,858
2016-01-28 15:20:00,66,20,78,164,984
2016-01-28 15:30:00,76,13,82,171,1026
2016-01-28 15:40:00,71,27,78,176,1056
2016-01-28 15:50:00,56,30,73,159,954
2016-01-28 16:00:00,14,5,21,40,240
2016-01-28 16:10:00,7,4,9,20,120
2016-01-28 16:20:00,5,3,5,13,78
2016-01-28 16:30:00,0,0,0,0,0
2016-01-28 16:40:00,0,0,0,0,0
2016-01-28 16:50:00,0,0,0,0,0
2016-01-28 17:00:00,0,0,0,0,0
2016-01-29 08:00:00,0,0,0,0,0
2016-01-29 08:10:00,0,0,0,0,0
2016-01-29 08:20:00,0,0,0,0,0
2016-01-29 08:30:00,0,0,0,0,0
2016-01-29 08:40:00,0,0,0,0,0
2016-01-29 08:50:00,0,0,0,0,0
2016-01-29 09:00:00,0,0,0,0,0
2016-01-29 09:10:00,4,2,5,11,66
2016-01-29 09:20:00,10,4,14,28,168
2016-01-29 09:30:00,12,2,11,25,150
2016-01-29 09:40:00,16,4,9,29,174
2016-01-29 09:50:00,4,14,24,42,252
2016-01-29 10:00:00,9,15,26,50,300
2016-01-29 10:10:00,12,20,38,70,420
2016-01-29 10:20:00,12,19,30,61,366
2016-01-29 10:30:00,12,7,20,39,234
2016-01-29 10:40:00,22,6,29,57,342
2016-01-29 10:50:00,31,14,47,92,552
2016-01-29 11:00:00,17,4,18,39,234
2016-01-29 11:10:00,13,15,37,65,390
2016-01-29 11:20:00,15,10,32,57,342
2016-01-29 11:30:00,12,7,19,38,228
2016-01-29 11:40:00,18,5,8,31,186
2016-01-29 11:50:00,6,6,11,23,138
2016-01-29 12:00:00,4,5,11,20,120
2016-01-29 12:10:00,6,3,8,17,102
2016-01-29 12:20:00,6,4,8,18,108
2016-01-29 12:30:00,6,3,11,20,120
2016-01-29 12:40:00,8,3,9,20,120
2016-01-29 12:50:00,10,13,18,41,246
2016-01-29 13:00:00,8,10,23,41,246
2016-01-29 13:10:00,16,12,36,64,384
2016-01-29 13:20:00,28,20,54,102,612
2016-01-29 13:30:00,16,7,21,44,264
2016-01-29 13:40:00,9,5,12,26,156
2016-01-29 13:50:00,6,4,7,17,102
2016-01-29 14:00:00,5,2,5,12,72
2016-01-29 14:10:00,6,2,7,15,90
2016-01-29 14:20:00,6,1,7,14,84
2016-01-29 14:30:00,6,1,7,14,84
2016-01-29 14:40:00,8,1,9,18,108
2016-01-29 14:50:00,9,1,9,19,114
2016-01-29 15:00:00,12,2,13,27,162
2016-01-29 15:10:00,4,1,10,15,90
2016-01-29 15:20:00,5,3,9,17,102
2016-01-29 15:30:00,13,5,20,38,228
2016-01-29 15:40:00,7,1,9,17,102
2016-01-29 15:50:00,19,4,16,39,234
2016-01-29 16:00:00,5,1,7,13,78
2016-01-29 16:10:00,4,1,6,11,66
2016-01-29 16:20:00,1,0,1,2,12
2016-01-29 16:30:00,0,0,0,0,0
2016-01-29 16:40:00,0,0,0,0,0
2016-01-29 16:50:00,0,0,0,0,0
2016-01-29 17:00:00,0,0,0,0,0
2016-01-30 08:00:00,0,0,0,0,0
2016-01-30 08:10:00,0,0,0,0,0
2016-01-30 08:20:00,0,0,0,0,0
2016-01-30 08:30:00,0,0,0,0,0
2016-01-30 08:40:00,1,0,1,2,12
2016-01-30 08:50:00,3,1,3,7,42
2016-01-30 09:00:00,3,1,6,10,60
2016-01-30 09:10:00,8,8,24,40,240
2016-01-30 09:20:00,13,14,36,63,378
2016-01-30 09:30:00,16,16,44,76,456
2016-01-30 09:40:00,17,19,41,77,462
2016-01-30 09:50:00,20,26,59,105,630
2016-01-30 10:00:00,29,40,72,141,846
2016-01-30 10:10:00,29,35,69,133,798
2016-01-30 10:20:00,27,48,67,142,852
2016-01-30 10:30:00,42,63,93,198,1188
2016-01-30 10:40:00,75,53,93,221,1326
2016-01-30 10:50:00,8,137,137,282,1692
2016-01-30 11:00:00,40,83,100,223,1338
2016-01-30 11:10:00,55,115,134,304,1824
2016-01-30 11:20:00,57,27,75,159,954
2016-01-30 11:30:00,104,47,108,259,1554
2016-01-30 11:40:00,60,108,156,324,1944
2016-01-30 11:50:00,212,162,207,581,3486
2016-01-30 12:00:00,115,147,190,452,2712
2016-01-30 12:10:00,85,109,157,351,2106
2016-01-30 12:20:00,197,105,195,497,2982
2016-01-30 12:30:00,212,156,142,510,3060
2016-01-30 12:40:00,232,196,226,654,3924
2016-01-30 12:50:00,151,126,143,420,2520
2016-01-30 13:00:00,181,156,174,511,3066
2016-01-30 13:10:00,175,151,165,491,2946
2016-01-30 13:20:00,185,161,175,521,3126
2016-01-30 13:30:00,118,93,110,321,1926
2016-01-30 13:40:00,47,83,100,230,1380
2016-01-30 13:50:00,218,153,234,605,3630
2016-01-30 14:00:00,265,239,256,760,4560
2016-01-30 14:10:00,170,146,160,476,2856
2016-01-30 14:20:00,130,74,129,333,1998
2016-01-30 14:30:00,18,126,126,270,1620
2016-01-30 14:40:00,33,112,114,259,1554
2016-01-30 14:50:00,64,64,83,211,1266
2016-01-30 15:00:00,42,67,92,201,1206
2016-01-30 15:10:00,57,47,87,191,1146
2016-01-30 15:20:00,46,41,82,169,1014
2016-01-30 15:30:00,34,39,72,145,870
2016-01-30 15:40:00,22,30,57,109,654
2016-01-30 15:50:00,17,18,45,80,480
2016-01-30 16:00:00,15,3,20,38,228
2016-01-30 16:10:00,2,1,2,5,30
2016-01-30 16:20:00,0,0,0,0,0
2016-01-30 16:30:00,0,0,0,0,0
2016-01-30 16:40:00,0,0,0,0,0
2016-01-30 16:50:00,0,0,0,0,0
2016-01-31 07:50:00,0,0,0,0,0
2016-01-31 08:00:00,0,0,0,0,0
2016-01-31 08:10:00,0,0,0,0,0
2016-01-31 08:20:00,1,0,1,2,12
2016-01-31 08:30:00,6,2,7,15,90
2016-01-31 08:40:00,11,5,17,33,198
2016-01-31 08:50:00,39,13,49,101,606
2016-01-31 09:00:00,44,32,68,144,864
2016-01-31 09:10:00,57,55,83,195,1170
2016-01-31 09:20:00,59,76,92,227,1362
2016-01-31 09:30:00,16,80,93,189,1134
2016-01-31 09:40:00,50,76,94,220,1320
2016-01-31 09:50:00,126,74,140,340,2040
2016-01-31 10:00:00,18,122,138,278,1668
2016-01-31 10:10:00,52,26,74,152,912
2016-01-31 10:20:00,49,26,76,151,906
2016-01-31 10:30:00,69,37,88,194,1164
2016-01-31 10:40:00,225,198,222,645,3870
2016-01-31 10:50:00,492,459,480,1431,8586
2016-01-31 11:00:00,303,270,288,861,5166
2016-01-31 11:10:00,26,112,116,254,1524
2016-01-31 11:20:00,21,10,31,62,372
2016-01-31 11:30:00,34,14,31,79,474
2016-01-31 11:40:00,16,5,22,43,258
2016-01-31 11:50:00,62,32,69,163,978
2016-01-31 12:00:00,161,58,165,384,2304
2016-01-31 12:10:00,111,129,129,369,2214
2016-01-31 12:20:00,15,26,47,88,528
2016-01-31 12:30:00,37,39,69,145,870
2016-01-31 12:40:00,65,55,79,199,1194
2016-01-31 12:50:00,45,97,109,251,1506
2016-01-31 13:00:00,51,149,161,361,2166
2016-01-31 13:10:00,354,332,355,1041,6246
2016-01-31 13:20:00,120,145,159,424,2544
2016-01-31 13:30:00,102,104,175,381,2286
2016-01-31 13:40:00,87,96,179,362,2172
2016-01-31 13:50:00,95,112,181,388,2328
2016-01-31 14:00:00,225,171,197,593,3558
2016-01-31 14:10:00,152,128,142,422,2532
2016-01-31 14:20:00,187,108,153,448,2688
2016-01-31 14:30:00,116,89,148,353,2118
2016-01-31 14:40:00,70,22,83,175,1050
2016-01-31 14:50:00,64,17,82,163,978
2016-01-31 15:00:00,63,69,101,233,1398
2016-01-31 15:10:00,79,67,124,270,1620
2016-01-31 15:20:00,128,45,157,330,1980
2016-01-31 15:30:00,138,44,159,341,2046
2016-01-31 15:40:00,79,28,89,196,1176
2016-01-31 15:50:00,36,8,35,79,474
2016-01-31 16:00:00,22,3,25,50,300
2016-01-31 16:10:00,13,3,17,33,198
2016-01-31 16:20:00,1,0,2,3,18
2016-01-31 16:30:00,0,0,0,0,0
2016-01-31 16:40:00,0,0,0,0,0
2016-01-31 16:50:00,0,0,0,0,0
2016-01-31 17:00:00,0,0,0,0,0
2016-02-01 07:30:00,0,0,0,0,0
2016-02-01 07:40:00,0,0,0,0,0
2016-02-01 07:50:00,0,0,0,0,0
2016-02-01 08:00:00,0,0,0,0,0
2016-02-01 08:10:00,1,0,1,2,12
2016-02-01 08:20:00,4,1,5,10,60
2016-02-01 08:30:00,6,3,8,17,102
2016-02-01 08:40:00,7,3,10,20,120
2016-02-01 08:50:00,6,1,9,16,96
2016-02-01 09:00:00,6,1,9,16,96
2016-02-01 09:10:00,4,1,6,11,66
2016-02-01 09:20:00,8,1,10,19,114
2016-02-01 09:30:00,13,5,20,38,228
2016-02-01 09:40:00,18,5,23,46,276
2016-02-01 09:50:00,14,8,25,47,282
2016-02-01 10:00:00,15,13,32,60,360
2016-02-01 10:10:00,26,10,37,73,438
2016-02-01 10:20:00,20,6,26,52,312
2016-02-01 10:30:00,27,12,40,79,474
2016-02-01 10:40:00,27,18,53,98,588
2016-02-01 10:50:00,34,37,60,131,786
2016-02-01 11:00:00,24,85,105,214,1284
2016-02-01 11:10:00,23,31,70,124,744
2016-02-01 11:20:00,42,50,82,174,1044
2016-02-01 11:30:00,40,50,79,169,1014
2016-02-01 11:40:00,32,17,60,109,654
2016-02-01 11:50:00,27,34,65,126,756
2016-02-01 12:00:00,27,23,54,104,624
2016-02-01 12:10:00,19,9,32,60,360
2016-02-01 12:20:00,18,11,39,68,408
2016-02-01 12:30:00,19,14,37,70,420
2016-02-01 12:40:00,21,15,52,88,528
2016-02-01 12:50:00,19,11,31,61,366
2016-02-01 13:00:00,16,14,35,65,390
2016-02-01 13:10:00,16,8,25,49,294
2016-02-01 13:20:00,12,9,25,46,276
2016-02-01 13:30:00,9,4,13,26,156
2016-02-01 13:40:00,13,6,24,43,258
2016-02-01 13:50:00,27,5,34,66,396
2016-02-01 14:00:00,21,3,25,49,294
2016-02-01 14:10:00,17,3,19,39,234
2016-02-01 14:20:00,14,4,17,35,210
2016-02-01 14:30:00,12,1,14,27,162
2016-02-01 14:40:00,8,0,9,17,102
2016-02-01 14:50:00,12,3,13,28,168
2016-02-01 15:00:00,6,1,8,15,90
2016-02-01 15:10:00,3,0,4,7,42
2016-02-01 15:20:00,5,0,5,10,60
2016-02-01 15:30:00,0,0,1,1,6
2016-02-01 15:40:00,3,0,3,6,36
2016-02-01 15:50:00,14,1,17,32,192
2016-02-01 16:00:00,6,1,7,14,84
2016-02-01 16:10:00,0,0,0,0,0
2016-02-01 16:20:00,0,0,0,0,0
2016-02-01 16:30:00,0,0,0,0,0
2016-02-01 16:40:00,0,0,0,0,0
2016-02-01 16:50:00,0,0,0,0,0
2016-02-01 17:00:00,0,0,0,0,0
2016-02-01 17:10:00,0,0,0,0,0
2016-02-02 07:30:00,0,0,0,0,0
2016-02-02 07:40:00,0,0,0,0,0
2016-02-02 07:50:00,0,0,0,0,0
2016-02-02 08:00:00,0,0,0,0,0
2016-02-02 08:10:00,0,0,0,0,0
2016-02-02 08:20:00,0,0,0,0,0
2016-02-02 08:30:00,0,0,0,0,0
2016-02-02 08:40:00,0,0,0,0,0
2016-02-02 08:50:00,1,0,1,2,12
2016-02-02 09:00:00,8,0,11,19,114
2016-02-02 09:10:00,13,2,13,28,168
2016-02-02 09:20:00,15,5,17,37,222
2016-02-02 09:30:00,24,5,28,57,342
2016-02-02 09:40:00,26,5,33,64,384
2016-02-02 09:50:00,25,14,43,82,492
2016-02-02 10:00:00,34,9,46,89,534
2016-02-02 10:10:00,42,14,56,112,672
2016-02-02 10:20:00,54,16,65,135,810
2016-02-02 10:30:00,76,42,87,205,1230
2016-02-02 10:40:00,68,59,82,209,1254
2016-02-02 10:50:00,75,25,83,183,1098
2016-02-02 11:00:00,64,17,78,159,954
2016-02-02 11:10:00,87,35,96,218,1308
2016-02-02 11:20:00,62,64,85,211,1266
2016-02-02 11:30:00,49,60,71,180,1080
2016-02-02 11:40:00,111,117,109,337,2022
2016-02-02 11:50:00,144,123,149,416,2496
2016-02-02 12:00:00,96,120,140,356,2136
2016-02-02 12:10:00,110,107,122,339,2034
2016-02-02 12:20:00,46,90,101,237,1422
2016-02-02 12:30:00,45,47,73,165,990
2016-02-02 12:40:00,50,43,78,171,1026
2016-02-02 12:50:00,43,57,83,183,1098
2016-02-02 13:00:00,47,33,67,147,882
2016-02-02 13:10:00,36,25,59,120,720
2016-02-02 13:20:00,30,11,42,83,498
2016-02-02 13:30:00,14,4,18,36,216
2016-02-02 13:40:00,24,15,44,83,498
2016-02-02 13:50:00,26,25,61,112,672
2016-02-02 14:00:00,22,13,40,75,450
2016-02-02 14:10:00,47,20,60,127,762
2016-02-02 14:20:00,41,23,54,118,708
2016-02-02 14:30:00,35,5,39,79,474
2016-02-02 14:40:00,42,20,56,118,708
2016-02-02 14:50:00,32,29,65,126,756
2016-02-02 15:00:00,39,13,46,98,588
2016-02-02 15:10:00,35,20,50,105,630
2016-02-02 15:20:00,50,38,69,157,942
2016-02-02 15:30:00,19,3,27,49,294
2016-02-02 15:40:00,17,4,22,43,258
2016-02-02 15:50:00,9,9,20,38,228
2016-02-02 16:00:00,14,15,37,66,396
2016-02-02 16:10:00,13,7,20,40,240
2016-02-02 16:20:00,8,4,10,22,132
2016-02-02 16:30:00,1,0,2,3,18
2016-02-02 16:40:00,0,0,0,0,0
2016-02-02 16:50:00,0,0,0,0,0
2016-02-02 17:00:00,0,0,0,0,0
2016-02-02 17:10:00,0,0,0,0,0
2016-02-02 17:20:00,0,0,0,0,0
2016-02-03 07:40:00,0,0,0,0,0
2016-02-03 07:50:00,0,0,0,0,0
2016-02-03 08:00:00,0,0,0,0,0
2016-02-03 08:10:00,0,0,0,0,0
2016-02-03 08:20:00,2,0,2,4,24
2016-02-03 08:30:00,12,4,15,31,186
2016-02-03 08:40:00,28,6,19,53,318
2016-02-03 08:50:00,24,6,33,63,378
2016-02-03 09:00:00,40,11,28,79,474
2016-02-03 09:10:00,44,44,74,162,972
2016-02-03 09:20:00,56,54,83,193,1158
2016-02-03 09:30:00,60,60,85,205,1230
2016-02-03 09:40:00,47,49,87,183,1098
2016-02-03 09:50:00,40,49,74,163,978
2016-02-03 10:00:00,277,255,275,807,4842
2016-02-03 10:10:00,56,52,94,202,1212
2016-02-03 10:20:00,453,417,437,1307,7842
2016-02-03 10:30:00,536,505,520,1561,9366
2016-02-03 10:40:00,356,294,352,1002,6012
2016-02-03 10:50:00,609,576,600,1785,10710
2016-02-03 11:00:00,553,514,542,1609,9654
2016-02-03 11:10:00,493,458,487,1438,8628
2016-02-03 11:20:00,448,419,442,1309,7854
2016-02-03 11:30:00,410,385,405,1200,7200
2016-02-03 11:40:00,384,358,377,1119,6714
2016-02-03 11:50:00,378,350,369,1097,6582
2016-02-03 12:00:00,298,270,289,857,5142
2016-02-03 12:10:00,372,340,361,1073,6438
2016-02-03 12:20:00,410,382,401,1193,7158
2016-02-03 12:30:00,436,405,424,1265,7590
2016-02-03 12:40:00,527,496,517,1540,9240
2016-02-03 12:50:00,625,588,615,1828,10968
2016-02-03 13:00:00,717,674,705,2096,12576
2016-02-03 13:10:00,741,706,736,2183,13098
2016-02-03 13:20:00,575,545,573,1693,10158
2016-02-03 13:30:00,196,168,188,552,3312
2016-02-03 13:40:00,656,617,642,1915,11490
2016-02-03 13:50:00,525,496,518,1539,9234
2016-02-03 14:00:00,554,522,547,1623,9738
2016-02-03 14:10:00,380,351,372,1103,6618
2016-02-03 14:20:00,479,445,470,1394,8364
2016-02-03 14:30:00,63,66,95,224,1344
2016-02-03 14:40:00,33,53,78,164,984
2016-02-03 14:50:00,183,164,188,535,3210
2016-02-03 15:00:00,186,167,191,544,3264
2016-02-03 15:10:00,185,163,178,526,3156
2016-02-03 15:20:00,150,125,142,417,2502
2016-02-03 15:30:00,116,92,107,315,1890
2016-02-03 15:40:00,61,53,75,189,1134
2016-02-03 15:50:00,77,12,85,174,1044
2016-02-03 16:00:00,62,21,71,154,924
2016-02-03 16:10:00,24,2,25,51,306
2016-02-03 16:20:00,22,2,23,47,282
2016-02-03 16:30:00,9,2,8,19,114
2016-02-03 16:40:00,0,0,0,0,0
2016-02-03 16:50:00,0,0,0,0,0
2016-02-03 17:00:00,0,0,0,0,0
2016-02-03 17:10:00,0,0,0,0,0
2016-02-04 07:30:00,0,0,0,0,0
2016-02-04 07:40:00,0,0,0,0,0
2016-02-04 07:50:00,0,0,0,0,0
2016-02-04 08:00:00,0,0,0,0,0
2016-02-04 08:10:00,1,1,1,3,18
2016-02-04 08:20:00,8,4,9,21,126
2016-02-04 08:30:00,12,6,16,34,204
2016-02-04 08:40:00,9,14,29,52,312
2016-02-04 08:50:00,22,18,45,85,510
2016-02-04 09:00:00,18,26,67,111,666
2016-02-04 09:10:00,34,36,68,138,828
2016-02-04 09:20:00,45,79,102,226,1356
2016-02-04 09:30:00,242,188,235,665,3990
2016-02-04 09:40:00,335,305,323,963,5778
2016-02-04 09:50:00,410,380,397,1187,7122
2016-02-04 10:00:00,498,463,482,1443,8658
2016-02-04 10:10:00,569,535,553,1657,9942
2016-02-04 10:20:00,624,594,616,1834,11004
2016-02-04 10:30:00,667,644,662,1973,11838
2016-02-04 10:40:00,671,642,662,1975,11850
2016-02-04 10:50:00,636,606,623,1865,11190
2016-02-04 11:00:00,564,533,549,1646,9876
2016-02-04 11:10:00,513,483,504,1500,9000
2016-02-04 11:20:00,482,449,470,1401,8406
2016-02-04 11:30:00,402,369,389,1160,6960
2016-02-04 11:40:00,376,341,359,1076,6456
2016-02-04 11:50:00,372,338,356,1066,6396
2016-02-04 12:00:00,401,368,391,1160,6960
2016-02-04 12:10:00,430,401,424,1255,7530
2016-02-04 12:20:00,448,421,441,1310,7860
2016-02-04 12:30:00,492,458,482,1432,8592
2016-02-04 12:40:00,564,526,552,1642,9852
2016-02-04 12:50:00,642,608,633,1883,11298
2016-02-04 13:00:00,722,681,707,2110,12660
2016-02-04 13:10:00,697,656,683,2036,12216
2016-02-04 13:20:00,750,712,739,2201,13206
2016-02-04 13:30:00,700,663,691,2054,12324
2016-02-04 13:40:00,649,613,637,1899,11394
2016-02-04 13:50:00,564,533,557,1654,9924
2016-02-04 14:00:00,551,520,547,1618,9708
2016-02-04 14:10:00,508,474,499,1481,8886
2016-02-04 14:20:00,444,413,438,1295,7770
2016-02-04 14:30:00,394,363,386,1143,6858
2016-02-04 14:40:00,349,320,340,1009,6054
2016-02-04 14:50:00,299,271,288,858,5148
2016-02-04 15:00:00,242,217,235,694,4164
2016-02-04 15:10:00,196,173,188,557,3342
2016-02-04 15:20:00,158,129,148,435,2610
2016-02-04 15:30:00,106,89,148,343,2058
2016-02-04 15:40:00,55,55,79,189,1134
2016-02-04 15:50:00,18,10,35,63,378
2016-02-04 16:00:00,19,23,45,87,522
2016-02-04 16:10:00,24,10,39,73,438
2016-02-04 16:20:00,13,6,18,37,222
2016-02-04 16:30:00,9,4,14,27,162
2016-02-04 16:40:00,2,0,4,6,36
2016-02-04 16:50:00,0,0,0,0,0
2016-02-04 17:00:00,0,0,0,0,0
2016-02-04 17:10:00,0,0,0,0,0
2016-02-05 07:40:00,0,0,0,0,0
2016-02-05 07:50:00,0,0,0,0,0
2016-02-05 08:00:00,0,0,0,0,0
2016-02-05 08:10:00,0,0,0,0,0
2016-02-05 08:20:00,1,0,2,3,18
2016-02-05 08:30:00,5,0,8,13,78
2016-02-05 08:40:00,9,3,13,25,150
2016-02-05 08:50:00,11,8,22,41,246
2016-02-05 09:00:00,19,8,30,57,342
2016-02-05 09:10:00,21,14,42,77,462
2016-02-05 09:20:00,33,22,50,105,630
2016-02-05 09:30:00,30,18,49,97,582
2016-02-05 09:40:00,28,21,50,99,594
2016-02-05 09:50:00,42,6,44,92,552
2016-02-05 10:00:00,20,11,34,65,390
2016-02-05 10:10:00,31,26,62,119,714
2016-02-05 10:20:00,40,32,73,145,870
2016-02-05 10:30:00,31,20,55,106,636
2016-02-05 10:40:00,34,41,71,146,876
2016-02-05 10:50:00,43,37,71,151,906
2016-02-05 11:00:00,35,48,79,162,972
2016-02-05 11:10:00,34,35,68,137,822
2016-02-05 11:20:00,36,37,72,145,870
2016-02-05 11:30:00,43,34,72,149,894
2016-02-05 11:40:00,38,79,102,219,1314
2016-02-05 11:50:00,42,118,130,290,1740
2016-02-05 12:00:00,23,126,133,282,1692
2016-02-05 12:10:00,69,44,88,201,1206
2016-02-05 12:20:00,37,41,72,150,900
2016-02-05 12:30:00,41,36,75,152,912
2016-02-05 12:40:00,43,74,93,210,1260
2016-02-05 12:50:00,0,134,137,271,1626
2016-02-05 13:00:00,0,139,146,285,1710
2016-02-05 13:10:00,0,138,141,279,1674
2016-02-05 13:20:00,12,141,150,303,1818
2016-02-05 13:30:00,33,95,112,240,1440
2016-02-05 13:40:00,31,92,111,234,1404
2016-02-05 13:50:00,39,73,105,217,1302
2016-02-05 14:00:00,39,93,102,234,1404
2016-02-05 14:10:00,52,82,91,225,1350
2016-02-05 14:20:00,26,66,89,181,1086
2016-02-05 14:30:00,35,70,95,200,1200
2016-02-05 14:40:00,24,39,68,131,786
2016-02-05 14:50:00,29,27,62,118,708
2016-02-05 15:00:00,18,12,36,66,396
2016-02-05 15:10:00,11,6,19,36,216
2016-02-05 15:20:00,11,3,15,29,174
2016-02-05 15:30:00,10,5,17,32,192
2016-02-05 15:40:00,9,3,13,25,150
2016-02-05 15:50:00,4,1,7,12,72
2016-02-05 16:00:00,1,0,1,2,12
2016-02-05 16:10:00,0,0,0,0,0
2016-02-05 16:20:00,0,0,0,0,0
2016-02-05 16:30:00,0,0,0,0,0
2016-02-05 16:40:00,0,0,0,0,0
2016-02-05 16:50:00,0,0,0,0,0
2016-02-05 17:00:00,0,0,0,0,0
2016-02-06 07:40:00,0,0,0,0,0
2016-02-06 07:50:00,0,0,0,0,0
2016-02-06 08:00:00,0,0,0,0,0
2016-02-06 08:10:00,0,0,0,0,0
2016-02-06 08:20:00,0,0,0,0,0
2016-02-06 08:30:00,0,0,0,0,0
2016-02-06 08:40:00,1,0,2,3,18
2016-02-06 08:50:00,4,1,7,12,72
2016-02-06 09:00:00,5,11,24,40,240
2016-02-06 09:10:00,11,22,41,74,444
2016-02-06 09:20:00,5,12,24,41,246
2016-02-06 09:30:00,6,4,13,23,138
2016-02-06 09:40:00,8,4,18,30,180
2016-02-06 09:50:00,9,6,17,32,192
2016-02-06 10:00:00,7,3,15,25,150
2016-02-06 10:10:00,12,12,29,53,318
2016-02-06 10:20:00,28,6,37,71,426
2016-02-06 10:30:00,26,4,31,61,366
2016-02-06 10:40:00,31,13,51,95,570
2016-02-06 10:50:00,37,13,54,104,624
2016-02-06 11:00:00,43,11,49,103,618
2016-02-06 11:10:00,66,62,87,215,1290
2016-02-06 11:20:00,61,59,87,207,1242
2016-02-06 11:30:00,25,56,79,160,960
2016-02-06 11:40:00,27,23,75,125,750
2016-02-06 11:50:00,47,41,78,166,996
2016-02-06 12:00:00,70,62,83,215,1290
2016-02-06 12:10:00,58,92,109,259,1554
2016-02-06 12:20:00,41,57,85,183,1098
2016-02-06 12:30:00,32,25,64,121,726
2016-02-06 12:40:00,40,9,49,98,588
2016-02-06 12:50:00,31,6,41,78,468
2016-02-06 13:00:00,20,8,31,59,354
2016-02-06 13:10:00,20,11,36,67,402
2016-02-06 13:20:00,23,15,44,82,492
2016-02-06 13:30:00,24,10,37,71,426
2016-02-06 13:40:00,20,12,40,72,432
2016-02-06 13:50:00,20,9,31,60,360
2016-02-06 14:00:00,51,27,73,151,906
2016-02-06 14:10:00,88,19,98,205,1230
2016-02-06 14:20:00,64,42,86,192,1152
2016-02-06 14:30:00,45,51,84,180,1080
2016-02-06 14:40:00,33,31,63,127,762
2016-02-06 14:50:00,39,9,46,94,564
2016-02-06 15:00:00,25,22,70,117,702
2016-02-06 15:10:00,30,28,60,118,708
2016-02-06 15:20:00,16,10,29,55,330
2016-02-06 15:30:00,15,10,23,48,288
2016-02-06 15:40:00,7,7,23,37,222
2016-02-06 15:50:00,6,5,13,24,144
2016-02-06 16:00:00,7,3,12,22,132
2016-02-06 16:10:00,7,2,15,24,144
2016-02-06 16:20:00,10,2,14,26,156
2016-02-06 16:30:00,1,0,2,3,18
2016-02-06 16:40:00,0,0,0,0,0
2016-02-06 16:50:00,0,0,0,0,0
2016-02-06 17:00:00,0,0,0,0,0
2016-02-06 17:10:00,0,0,0,0,0
2016-02-07 07:30:00,0,0,0,0,0
2016-02-07 07:40:00,0,0,0,0,0
2016-02-07 07:50:00,0,0,0,0,0
2016-02-07 08:00:00,0,0,0,0,0
2016-02-07 08:10:00,4,1,4,9,54
2016-02-07 08:20:00,7,1,11,19,114
2016-02-07 08:30:00,11,11,30,52,312
2016-02-07 08:40:00,31,21,54,106,636
2016-02-07 08:50:00,39,40,72,151,906
2016-02-07 09:00:00,41,59,94,194,1164
2016-02-07 09:10:00,45,87,97,229,1374
2016-02-07 09:20:00,0,137,142,279,1674
2016-02-07 09:30:00,51,123,137,311,1866
2016-02-07 09:40:00,80,124,157,361,2166
2016-02-07 09:50:00,163,170,193,526,3156
2016-02-07 10:00:00,184,158,176,518,3108
2016-02-07 10:10:00,229,200,220,649,3894
2016-02-07 10:20:00,415,386,409,1210,7260
2016-02-07 10:30:00,179,170,188,537,3222
2016-02-07 10:40:00,27,98,120,245,1470
2016-02-07 10:50:00,51,79,163,293,1758
2016-02-07 11:00:00,43,112,168,323,1938
2016-02-07 11:10:00,228,228,261,717,4302
2016-02-07 11:20:00,297,271,293,861,5166
2016-02-07 11:30:00,243,217,239,699,4194
2016-02-07 11:40:00,155,131,150,436,2616
2016-02-07 11:50:00,138,98,187,423,2538
2016-02-07 12:00:00,26,27,51,104,624
2016-02-07 12:10:00,14,8,22,44,264
2016-02-07 12:20:00,23,23,49,95,570
2016-02-07 12:30:00,28,57,79,164,984
2016-02-07 12:40:00,42,94,105,241,1446
2016-02-07 12:50:00,49,66,89,204,1224
2016-02-07 13:00:00,28,49,69,146,876
2016-02-07 13:10:00,30,61,92,183,1098
2016-02-07 13:20:00,24,87,103,214,1284
2016-02-07 13:30:00,42,133,152,327,1962
2016-02-07 13:40:00,40,130,138,308,1848
2016-02-07 13:50:00,88,135,151,374,2244
2016-02-07 14:00:00,112,163,151,426,2556
2016-02-07 14:10:00,35,68,101,204,1224
2016-02-07 14:20:00,33,23,58,114,684
2016-02-07 14:30:00,14,4,16,34,204
2016-02-07 14:40:00,17,8,29,54,324
2016-02-07 14:50:00,33,18,54,105,630
2016-02-07 15:00:00,37,40,67,144,864
2016-02-07 15:10:00,40,52,82,174,1044
2016-02-07 15:20:00,57,65,82,204,1224
2016-02-07 15:30:00,24,122,116,262,1572
2016-02-07 15:40:00,40,76,99,215,1290
2016-02-07 15:50:00,35,41,75,151,906
2016-02-07 16:00:00,26,20,54,100,600
2016-02-07 16:10:00,12,18,33,63,378
2016-02-07 16:20:00,13,8,23,44,264
2016-02-07 16:30:00,6,2,9,17,102
2016-02-07 16:40:00,1,0,2,3,18
2016-02-07 16:50:00,0,0,0,0,0
2016-02-07 17:00:00,0,0,0,0,0
2016-02-07 17:10:00,0,0,0,0,0
2016-02-08 07:40:00,0,0,0,0,0
2016-02-08 07:50:00,0,0,0,0,0
2016-02-08 08:00:00,0,0,0,0,0
2016-02-08 08:10:00,0,0,0,0,0
2016-02-08 08:20:00,0,0,0,0,0
2016-02-08 08:30:00,0,0,0,0,0
2016-02-08 08:40:00,4,1,4,9,54
2016-02-08 08:50:00,4,1,5,10,60
2016-02-08 09:00:00,3,0,4,7,42
2016-02-08 09:10:00,17,5,24,46,276
2016-02-08 09:20:00,22,8,35,65,390
2016-02-08 09:30:00,11,6,12,29,174
2016-02-08 09:40:00,12,2,15,29,174
2016-02-08 09:50:00,22,2,23,47,282
2016-02-08 10:00:00,40,17,53,110,660
2016-02-08 10:10:00,28,3,31,62,372
2016-02-08 10:20:00,17,3,21,41,246
2016-02-08 10:30:00,35,14,45,94,564
2016-02-08 10:40:00,211,163,212,586,3516
2016-02-08 10:50:00,39,70,94,203,1218
2016-02-08 11:00:00,30,83,101,214,1284
2016-02-08 11:10:00,101,113,143,357,2142
2016-02-08 11:20:00,57,81,106,244,1464
2016-02-08 11:30:00,10,48,50,108,648
2016-02-08 11:40:00,28,29,62,119,714
2016-02-08 11:50:00,34,38,77,149,894
2016-02-08 12:00:00,40,30,69,139,834
2016-02-08 12:10:00,27,65,85,177,1062
2016-02-08 12:20:00,78,91,115,284,1704
2016-02-08 12:30:00,161,136,153,450,2700
2016-02-08 12:40:00,159,125,203,487,2922
2016-02-08 12:50:00,376,352,368,1096,6576
2016-02-08 13:00:00,612,574,600,1786,10716
2016-02-08 13:10:00,71,118,129,318,1908
2016-02-08 13:20:00,23,29,54,106,636
2016-02-08 13:30:00,37,77,97,211,1266
2016-02-08 13:40:00,315,292,319,926,5556
2016-02-08 13:50:00,132,123,137,392,2352
2016-02-08 14:00:00,46,115,123,284,1704
2016-02-08 14:10:00,30,34,55,119,714
2016-02-08 14:20:00,70,97,110,277,1662
2016-02-08 14:30:00,15,8,24,47,282
2016-02-08 14:40:00,16,5,23,44,264
2016-02-08 14:50:00,188,175,195,558,3348
2016-02-08 15:00:00,236,210,230,676,4056
2016-02-08 15:10:00,145,125,142,412,2472
2016-02-08 15:20:00,24,45,67,136,816
2016-02-08 15:30:00,139,97,171,407,2442
2016-02-08 15:40:00,50,65,85,200,1200
2016-02-08 15:50:00,22,19,41,82,492
2016-02-08 16:00:00,29,63,86,178,1068
2016-02-08 16:10:00,33,96,118,247,1482
2016-02-08 16:20:00,38,16,51,105,630
2016-02-08 16:30:00,20,6,24,50,300
2016-02-08 16:40:00,5,0,3,8,48
2016-02-08 16:50:00,0,0,0,0,0
2016-02-08 17:00:00,0,0,0,0,0
2016-02-08 17:10:00,0,0,0,0,0
2016-02-09 07:30:00,0,0,0,0,0
2016-02-09 07:40:00,0,0,0,0,0
2016-02-09 07:50:00,0,0,0,0,0
2016-02-09 08:00:00,0,0,0,0,0
2016-02-09 08:10:00,3,2,6,11,66
2016-02-09 08:20:00,3,3,9,15,90
2016-02-09 08:30:00,4,4,12,20,120
2016-02-09 08:40:00,15,25,44,84,504
2016-02-09 08:50:00,24,43,71,138,828
2016-02-09 09:00:00,32,44,78,154,924
2016-02-09 09:10:00,64,76,100,240,1440
2016-02-09 09:20:00,54,39,80,173,1038
2016-02-09 09:30:00,63,91,125,279,1674
2016-02-09 09:40:00,35,48,74,157,942
2016-02-09 09:50:00,59,70,94,223,1338
2016-02-09 10:00:00,70,112,103,285,1710
2016-02-09 10:10:00,72,111,123,306,1836
2016-02-09 10:20:00,53,87,102,242,1452
2016-02-09 10:30:00,39,35,66,140,840
2016-02-09 10:40:00,30,12,24,66,396
2016-02-09 10:50:00,32,45,69,146,876
2016-02-09 11:00:00,33,39,67,139,834
2016-02-09 11:10:00,33,68,84,185,1110
2016-02-09 11:20:00,87,111,173,371,2226
2016-02-09 11:30:00,29,66,83,178,1068
2016-02-09 11:40:00,181,171,212,564,3384
2016-02-09 11:50:00,155,142,159,456,2736
2016-02-09 12:00:00,102,118,137,357,2142
2016-02-09 12:10:00,128,114,203,445,2670
2016-02-09 12:20:00,200,180,194,574,3444
2016-02-09 12:30:00,109,116,143,368,2208
2016-02-09 12:40:00,57,107,116,280,1680
2016-02-09 12:50:00,172,128,205,505,3030
2016-02-09 13:00:00,163,130,180,473,2838
2016-02-09 13:10:00,76,90,134,300,1800
2016-02-09 13:20:00,70,75,105,250,1500
2016-02-09 13:30:00,458,441,461,1360,8160
2016-02-09 13:40:00,716,680,701,2097,12582
2016-02-09 13:50:00,636,600,620,1856,11136
2016-02-09 14:00:00,486,455,476,1417,8502
2016-02-09 14:10:00,62,120,126,308,1848
2016-02-09 14:20:00,146,175,173,494,2964
2016-02-09 14:30:00,222,183,231,636,3816
2016-02-09 14:40:00,317,291,308,916,5496
2016-02-09 14:50:00,191,168,184,543,3258
2016-02-09 15:00:00,217,192,209,618,3708
2016-02-09 15:10:00,230,204,222,656,3936
2016-02-09 15:20:00,177,156,171,504,3024
2016-02-09 15:30:00,132,109,126,367,2202
2016-02-09 15:40:00,36,118,126,280,1680
2016-02-09 15:50:00,52,27,73,152,912
2016-02-09 16:00:00,21,7,24,52,312
2016-02-09 16:10:00,13,2,15,30,180
2016-02-09 16:20:00,6,3,7,16,96
2016-02-09 16:30:00,2,1,3,6,36
2016-02-09 16:40:00,0,0,0,0,0
2016-02-09 16:50:00,0,0,0,0,0
2016-02-09 17:00:00,0,0,0,0,0
2016-02-09 17:10:00,0,0,0,0,0
2016-02-09 17:20:00,0,0,0,0,0
2016-02-10 07:30:00,0,0,0,0,0
2016-02-10 07:40:00,0,0,0,0,0
2016-02-10 07:50:00,0,0,0,0,0
2016-02-10 08:00:00,0,0,0,0,0
2016-02-10 08:10:00,0,0,0,0,0
2016-02-10 08:20:00,0,0,0,0,0
2016-02-10 08:30:00,2,1,3,6,36
2016-02-10 08:40:00,4,4,16,24,144
2016-02-10 08:50:00,5,6,24,35,210
2016-02-10 09:00:00,9,19,38,66,396
2016-02-10 09:10:00,23,14,37,74,444
2016-02-10 09:20:00,67,23,73,163,978
2016-02-10 09:30:00,89,20,86,195,1170
2016-02-10 09:40:00,48,51,58,157,942
2016-02-10 09:50:00,68,17,78,163,978
2016-02-10 10:00:00,70,110,124,304,1824
2016-02-10 10:10:00,147,22,282,451,2706
2016-02-10 10:20:00,281,227,311,819,4914
2016-02-10 10:30:00,246,221,233,700,4200
2016-02-10 10:40:00,195,142,142,479,2874
2016-02-10 10:50:00,174,126,180,480,2880
2016-02-10 11:00:00,119,117,160,396,2376
2016-02-10 11:10:00,26,73,95,194,1164
2016-02-10 11:20:00,103,110,155,368,2208
2016-02-10 11:30:00,23,96,114,233,1398
2016-02-10 11:40:00,144,130,158,432,2592
2016-02-10 11:50:00,30,49,75,154,924
2016-02-10 12:00:00,31,118,136,285,1710
2016-02-10 12:10:00,204,122,293,619,3714
2016-02-10 12:20:00,288,215,202,705,4230
2016-02-10 12:30:00,306,188,147,641,3846
2016-02-10 12:40:00,164,138,155,457,2742
2016-02-10 12:50:00,103,122,143,368,2208
2016-02-10 13:00:00,167,97,208,472,2832
2016-02-10 13:10:00,204,110,255,569,3414
2016-02-10 13:20:00,268,239,259,766,4596
2016-02-10 13:30:00,250,222,241,713,4278
2016-02-10 13:40:00,185,159,177,521,3126
2016-02-10 13:50:00,138,126,152,416,2496
2016-02-10 14:00:00,82,117,148,347,2082
2016-02-10 14:10:00,93,115,173,381,2286
2016-02-10 14:20:00,459,424,460,1343,8058
2016-02-10 14:30:00,468,434,457,1359,8154
2016-02-10 14:40:00,295,267,282,844,5064
2016-02-10 14:50:00,166,111,217,494,2964
2016-02-10 15:00:00,74,126,146,346,2076
2016-02-10 15:10:00,177,161,148,486,2916
2016-02-10 15:20:00,167,131,167,465,2790
2016-02-10 15:30:00,99,75,92,266,1596
2016-02-10 15:40:00,34,37,87,158,948
2016-02-10 15:50:00,19,21,60,100,600
2016-02-10 16:00:00,9,15,34,58,348
2016-02-10 16:10:00,7,14,31,52,312
2016-02-10 16:20:00,6,9,26,41,246
2016-02-10 16:30:00,2,0,9,11,66
2016-02-10 16:40:00,0,0,0,0,0
2016-02-10 16:50:00,0,0,0,0,0
2016-02-10 17:00:00,0,0,0,0,0
2016-02-10 17:10:00,0,0,0,0,0
2016-02-10 17:20:00,0,0,0,0,0
2016-02-11 07:30:00,0,0,0,0,0
2016-02-11 07:40:00,0,0,0,0,0
2016-02-11 07:50:00,0,0,0,0,0
2016-02-11 08:00:00,0,0,0,0,0
2016-02-11 08:10:00,3,0,5,8,48
2016-02-11 08:20:00,9,4,17,30,180
2016-02-11 08:30:00,7,13,29,49,294
2016-02-11 08:40:00,12,44,70,126,756
2016-02-11 08:50:00,15,64,81,160,960
2016-02-11 09:00:00,34,52,80,166,996
2016-02-11 09:10:00,32,59,84,175,1050
2016-02-11 09:20:00,16,68,86,170,1020
2016-02-11 09:30:00,31,68,96,195,1170
2016-02-11 09:40:00,22,108,122,252,1512
2016-02-11 09:50:00,24,129,143,296,1776
2016-02-11 10:00:00,30,109,116,255,1530
2016-02-11 10:10:00,69,111,144,324,1944
2016-02-11 10:20:00,72,134,149,355,2130
2016-02-11 10:30:00,63,139,156,358,2148
2016-02-11 10:40:00,97,123,176,396,2376
2016-02-11 10:50:00,173,21,286,480,2880
2016-02-11 11:00:00,196,67,266,529,3174
2016-02-11 11:10:00,256,182,181,619,3714
2016-02-11 11:20:00,199,197,199,595,3570
2016-02-11 11:30:00,175,176,122,473,2838
2016-02-11 11:40:00,141,164,208,513,3078
2016-02-11 11:50:00,109,156,167,432,2592
2016-02-11 12:00:00,124,172,160,456,2736
2016-02-11 12:10:00,236,196,214,646,3876
2016-02-11 12:20:00,254,228,249,731,4386
2016-02-11 12:30:00,293,266,285,844,5064
2016-02-11 12:40:00,414,383,407,1204,7224
2016-02-11 12:50:00,670,641,666,1977,11862
2016-02-11 13:00:00,470,440,462,1372,8232
2016-02-11 13:10:00,281,257,274,812,4872
2016-02-11 13:20:00,328,302,320,950,5700
2016-02-11 13:30:00,278,254,270,802,4812
2016-02-11 13:40:00,258,232,252,742,4452
2016-02-11 13:50:00,392,363,382,1137,6822
2016-02-11 14:00:00,595,567,591,1753,10518
2016-02-11 14:10:00,655,624,643,1922,11532
2016-02-11 14:20:00,435,407,430,1272,7632
2016-02-11 14:30:00,149,125,144,418,2508
2016-02-11 14:40:00,107,89,271,467,2802
2016-02-11 14:50:00,50,107,107,264,1584
2016-02-11 15:00:00,47,58,88,193,1158
2016-02-11 15:10:00,21,115,116,252,1512
2016-02-11 15:20:00,48,71,104,223,1338
2016-02-11 15:30:00,9,121,122,252,1512
2016-02-11 15:40:00,18,50,68,136,816
2016-02-11 15:50:00,19,27,67,113,678
2016-02-11 16:00:00,33,40,61,134,804
2016-02-11 16:10:00,26,32,66,124,744
2016-02-11 16:20:00,14,25,49,88,528
2016-02-11 16:30:00,15,14,38,67,402
2016-02-11 16:40:00,10,9,25,44,264
2016-02-11 16:50:00,3,1,5,9,54
2016-02-11 17:00:00,0,0,0,0,0
2016-02-11 17:10:00,0,0,0,0,0
2016-02-11 17:20:00,0,0,0,0,0
2016-02-11 17:30:00,0,0,0,0,0
2016-02-12 07:20:00,0,0,0,0,0
2016-02-12 07:30:00,0,0,0,0,0
2016-02-12 07:40:00,0,0,0,0,0
2016-02-12 07:50:00,0,0,0,0,0
2016-02-12 08:00:00,0,0,0,0,0
2016-02-12 08:10:00,4,0,6,10,60
2016-02-12 08:20:00,5,4,20,29,174
2016-02-12 08:30:00,10,17,37,64,384
2016-02-12 08:40:00,12,22,43,77,462
2016-02-12 08:50:00,20,47,75,142,852
2016-02-12 09:00:00,24,77,96,197,1182
2016-02-12 09:10:00,9,117,123,249,1494
2016-02-12 09:20:00,17,128,138,283,1698
2016-02-12 09:30:00,103,157,155,415,2490
2016-02-12 09:40:00,202,184,152,538,3228
2016-02-12 09:50:00,188,157,169,514,3084
2016-02-12 10:00:00,236,208,230,674,4044
2016-02-12 10:10:00,283,180,150,613,3678
2016-02-12 10:20:00,206,178,198,582,3492
2016-02-12 10:30:00,466,429,455,1350,8100
2016-02-12 10:40:00,612,575,602,1789,10734
2016-02-12 10:50:00,394,364,389,1147,6882
2016-02-12 11:00:00,443,415,440,1298,7788
2016-02-12 11:10:00,313,287,311,911,5466
2016-02-12 11:20:00,315,288,310,913,5478
2016-02-12 11:30:00,267,241,261,769,4614
2016-02-12 11:40:00,315,285,308,908,5448
2016-02-12 11:50:00,221,193,241,655,3930
2016-02-12 12:00:00,291,265,286,842,5052
2016-02-12 12:10:00,270,243,263,776,4656
2016-02-12 12:20:00,262,234,254,750,4500
2016-02-12 12:30:00,271,244,263,778,4668
2016-02-12 12:40:00,298,271,289,858,5148
2016-02-12 12:50:00,365,338,358,1061,6366
2016-02-12 13:00:00,772,734,766,2272,13632
2016-02-12 13:10:00,917,874,915,2706,16236
2016-02-12 13:20:00,929,893,927,2749,16494
2016-02-12 13:30:00,605,573,602,1780,10680
2016-02-12 13:40:00,444,418,443,1305,7830
2016-02-12 13:50:00,261,222,222,705,4230
2016-02-12 14:00:00,210,207,163,580,3480
2016-02-12 14:10:00,170,144,164,478,2868
2016-02-12 14:20:00,146,122,142,410,2460
2016-02-12 14:30:00,106,80,98,284,1704
2016-02-12 14:40:00,22,72,93,187,1122
2016-02-12 14:50:00,15,99,118,232,1392
2016-02-12 15:00:00,193,211,240,644,3864
2016-02-12 15:10:00,295,267,290,852,5112
2016-02-12 15:20:00,230,205,223,658,3948
2016-02-12 15:30:00,190,165,182,537,3222
2016-02-12 15:40:00,150,125,142,417,2502
2016-02-12 15:50:00,84,70,93,247,1482
2016-02-12 16:00:00,19,52,79,150,900
2016-02-12 16:10:00,31,50,69,150,900
2016-02-12 16:20:00,19,20,44,83,498
2016-02-12 16:30:00,10,16,36,62,372
2016-02-12 16:40:00,10,10,27,47,282
2016-02-12 16:50:00,6,2,11,19,114
2016-02-12 17:00:00,0,0,1,1,6
2016-02-12 17:10:00,0,0,0,0,0
2016-02-12 17:20:00,0,0,0,0,0
2016-02-12 17:30:00,0,0,0,0,0
2016-02-13 07:10:00,0,0,0,0,0
2016-02-13 07:20:00,0,0,0,0,0
2016-02-13 07:30:00,0,0,0,0,0
2016-02-13 07:40:00,0,0,0,0,0
2016-02-13 07:50:00,2,0,4,6,36
2016-02-13 08:00:00,5,2,18,25,150
2016-02-13 08:10:00,6,15,33,54,324
2016-02-13 08:20:00,15,22,69,106,636
2016-02-13 08:30:00,21,24,81,126,756
2016-02-13 08:40:00,30,54,81,165,990
2016-02-13 08:50:00,30,75,105,210,1260
2016-02-13 09:00:00,40,76,102,218,1308
2016-02-13 09:10:00,9,82,98,189,1134
2016-02-13 09:20:00,130,148,169,447,2682
2016-02-13 09:30:00,358,321,347,1026,6156
2016-02-13 09:40:00,459,424,452,1335,8010
2016-02-13 09:50:00,557,518,552,1627,9762
2016-02-13 10:00:00,466,430,456,1352,8112
2016-02-13 10:10:00,249,223,245,717,4302
2016-02-13 10:20:00,392,359,383,1134,6804
2016-02-13 10:30:00,705,667,696,2068,12408
2016-02-13 10:40:00,556,519,549,1624,9744
2016-02-13 10:50:00,355,326,346,1027,6162
2016-02-13 11:00:00,319,288,310,917,5502
2016-02-13 11:10:00,219,191,211,621,3726
2016-02-13 11:20:00,169,145,161,475,2850
2016-02-13 11:30:00,156,130,147,433,2598
2016-02-13 11:40:00,215,188,206,609,3654
2016-02-13 11:50:00,345,317,336,998,5988
2016-02-13 12:00:00,226,200,221,647,3882
2016-02-13 12:10:00,226,197,218,641,3846
2016-02-13 12:20:00,336,308,331,975,5850
2016-02-13 12:30:00,665,634,663,1962,11772
2016-02-13 12:40:00,783,751,781,2315,13890
2016-02-13 12:50:00,904,866,903,2673,16038
2016-02-13 13:00:00,900,862,894,2656,15936
2016-02-13 13:10:00,898,860,889,2647,15882
2016-02-13 13:20:00,781,741,765,2287,13722
2016-02-13 13:30:00,706,661,695,2062,12372
2016-02-13 13:40:00,750,715,742,2207,13242
2016-02-13 13:50:00,728,696,717,2141,12846
2016-02-13 14:00:00,686,650,678,2014,12084
2016-02-13 14:10:00,622,587,614,1823,10938
2016-02-13 14:20:00,574,541,568,1683,10098
2016-02-13 14:30:00,521,489,511,1521,9126
2016-02-13 14:40:00,474,439,462,1375,8250
2016-02-13 14:50:00,414,379,404,1197,7182
2016-02-13 15:00:00,351,321,342,1014,6084
2016-02-13 15:10:00,299,271,289,859,5154
2016-02-13 15:20:00,245,214,234,693,4158
2016-02-13 15:30:00,171,142,160,473,2838
2016-02-13 15:40:00,130,108,133,371,2226
2016-02-13 15:50:00,37,115,137,289,1734
2016-02-13 16:00:00,36,20,57,113,678
2016-02-13 16:10:00,25,15,46,86,516
2016-02-13 16:20:00,18,12,37,67,402
2016-02-13 16:30:00,13,6,22,41,246
2016-02-13 16:40:00,8,2,14,24,144
2016-02-13 16:50:00,4,0,5,9,54
2016-02-13 17:00:00,0,0,0,0,0
2016-02-13 17:10:00,0,0,0,0,0
2016-02-13 17:20:00,0,0,0,0,0
2016-02-13 17:30:00,0,0,0,0,0
2016-02-14 07:20:00,0,0,0,0,0
2016-02-14 07:30:00,0,0,0,0,0
2016-02-14 07:40:00,0,0,0,0,0
2016-02-14 07:50:00,0,0,0,0,0
2016-02-14 08:00:00,3,0,3,6,36
2016-02-14 08:10:00,11,6,20,37,222
2016-02-14 08:20:00,16,11,33,60,360
2016-02-14 08:30:00,28,4,34,66,396
2016-02-14 08:40:00,32,12,43,87,522
2016-02-14 08:50:00,32,17,53,102,612
2016-02-14 09:00:00,33,15,56,104,624
2016-02-14 09:10:00,18,17,42,77,462
2016-02-14 09:20:00,15,20,44,79,474
2016-02-14 09:30:00,17,13,36,66,396
2016-02-14 09:40:00,38,21,57,116,696
2016-02-14 09:50:00,69,59,86,214,1284
2016-02-14 10:00:00,94,106,57,257,1542
2016-02-14 10:10:00,49,69,83,201,1206
2016-02-14 10:20:00,90,80,111,281,1686
2016-02-14 10:30:00,114,94,138,346,2076
2016-02-14 10:40:00,59,37,85,181,1086
2016-02-14 10:50:00,179,174,200,553,3318
2016-02-14 11:00:00,306,281,302,889,5334
2016-02-14 11:10:00,130,108,121,359,2154
2016-02-14 11:20:00,63,76,93,232,1392
2016-02-14 11:30:00,62,78,76,216,1296
2016-02-14 11:40:00,26,41,62,129,774
2016-02-14 11:50:00,25,36,71,132,792
2016-02-14 12:00:00,23,16,36,75,450
2016-02-14 12:10:00,49,13,57,119,714
2016-02-14 12:20:00,55,35,76,166,996
2016-02-14 12:30:00,49,52,84,185,1110
2016-02-14 12:40:00,53,48,81,182,1092
2016-02-14 12:50:00,57,64,88,209,1254
2016-02-14 13:00:00,26,126,138,290,1740
2016-02-14 13:10:00,0,137,144,281,1686
2016-02-14 13:20:00,46,90,101,237,1422
2016-02-14 13:30:00,51,63,98,212,1272
2016-02-14 13:40:00,25,25,82,132,792
2016-02-14 13:50:00,25,15,61,101,606
2016-02-14 14:00:00,29,12,46,87,522
2016-02-14 14:10:00,39,23,75,137,822
2016-02-14 14:20:00,57,51,80,188,1128
2016-02-14 14:30:00,96,65,178,339,2034
2016-02-14 14:40:00,80,120,173,373,2238
2016-02-14 14:50:00,34,41,70,145,870
2016-02-14 15:00:00,41,30,56,127,762
2016-02-14 15:10:00,49,40,78,167,1002
2016-02-14 15:20:00,45,63,78,186,1116
2016-02-14 15:30:00,44,44,72,160,960
2016-02-14 15:40:00,42,34,71,147,882
2016-02-14 15:50:00,37,16,50,103,618
2016-02-14 16:00:00,31,10,42,83,498
2016-02-14 16:10:00,14,5,20,39,234
2016-02-14 16:20:00,23,4,26,53,318
2016-02-14 16:30:00,11,1,13,25,150
2016-02-14 16:40:00,8,1,11,20,120
2016-02-14 16:50:00,2,0,4,6,36
2016-02-14 17:00:00,1,0,1,2,12
2016-02-14 17:10:00,0,0,0,0,0
2016-02-14 17:20:00,0,0,0,0,0
2016-02-14 17:30:00,0,0,0,0,0
2016-02-15 07:20:00,0,0,0,0,0
2016-02-15 07:30:00,0,0,0,0,0
2016-02-15 07:40:00,0,0,0,0,0
2016-02-15 07:50:00,0,0,1,1,6
2016-02-15 08:00:00,7,2,12,21,126
2016-02-15 08:10:00,13,8,22,43,258
2016-02-15 08:20:00,14,15,35,64,384
2016-02-15 08:30:00,27,16,46,89,534
2016-02-15 08:40:00,23,26,77,126,756
2016-02-15 08:50:00,21,24,65,110,660
2016-02-15 09:00:00,40,25,84,149,894
2016-02-15 09:10:00,42,37,74,153,918
2016-02-15 09:20:00,32,22,58,112,672
2016-02-15 09:30:00,26,20,52,98,588
2016-02-15 09:40:00,41,21,58,120,720
2016-02-15 09:50:00,26,37,75,138,828
2016-02-15 10:00:00,22,95,111,228,1368
2016-02-15 10:10:00,35,126,142,303,1818
2016-02-15 10:20:00,27,136,149,312,1872
2016-02-15 10:30:00,0,134,137,271,1626
2016-02-15 10:40:00,49,130,150,329,1974
2016-02-15 10:50:00,75,151,165,391,2346
2016-02-15 11:00:00,170,61,249,480,2880
2016-02-15 11:10:00,155,19,280,454,2724
2016-02-15 11:20:00,180,144,161,485,2910
2016-02-15 11:30:00,131,31,295,457,2742
2016-02-15 11:40:00,148,52,288,488,2928
2016-02-15 11:50:00,178,60,281,519,3114
2016-02-15 12:00:00,217,191,215,623,3738
2016-02-15 12:10:00,213,187,209,609,3654
2016-02-15 12:20:00,197,181,213,591,3546
2016-02-15 12:30:00,212,194,194,600,3600
2016-02-15 12:40:00,364,332,358,1054,6324
2016-02-15 12:50:00,313,280,301,894,5364
2016-02-15 13:00:00,249,222,243,714,4284
2016-02-15 13:10:00,207,73,207,487,2922
2016-02-15 13:20:00,147,63,240,450,2700
2016-02-15 13:30:00,206,173,210,589,3534
2016-02-15 13:40:00,194,175,212,581,3486
2016-02-15 13:50:00,260,232,251,743,4458
2016-02-15 14:00:00,192,165,179,536,3216
2016-02-15 14:10:00,251,282,303,836,5016
2016-02-15 14:20:00,340,297,306,943,5658
2016-02-15 14:30:00,161,138,152,451,2706
2016-02-15 14:40:00,210,183,199,592,3552
2016-02-15 14:50:00,276,250,267,793,4758
2016-02-15 15:00:00,231,197,221,649,3894
2016-02-15 15:10:00,175,151,167,493,2958
2016-02-15 15:20:00,82,66,88,236,1416
2016-02-15 15:30:00,57,104,126,287,1722
2016-02-15 15:40:00,89,67,104,260,1560
2016-02-15 15:50:00,139,47,237,423,2538
2016-02-15 16:00:00,79,74,103,256,1536
2016-02-15 16:10:00,37,23,73,133,798
2016-02-15 16:20:00,31,8,42,81,486
2016-02-15 16:30:00,22,7,32,61,366
2016-02-15 16:40:00,12,10,29,51,306
2016-02-15 16:50:00,7,3,17,27,162
2016-02-15 17:00:00,3,0,8,11,66
2016-02-15 17:10:00,0,0,0,0,0
2016-02-15 17:20:00,0,0,0,0,0
2016-02-15 17:30:00,0,0,0,0,0
2016-02-15 17:40:00,0,0,0,0,0
2016-02-16 07:10:00,0,0,0,0,0
2016-02-16 07:20:00,0,0,0,0,0
2016-02-16 07:30:00,0,0,0,0,0
2016-02-16 07:40:00,0,0,0,0,0
2016-02-16 07:50:00,3,0,7,10,60
2016-02-16 08:00:00,8,3,14,25,150
2016-02-16 08:10:00,9,8,22,39,234
2016-02-16 08:20:00,14,10,29,53,318
2016-02-16 08:30:00,19,10,37,66,396
2016-02-16 08:40:00,19,15,44,78,468
2016-02-16 08:50:00,25,19,48,92,552
2016-02-16 09:00:00,40,35,70,145,870
2016-02-16 09:10:00,40,58,84,182,1092
2016-02-16 09:20:00,126,122,145,393,2358
2016-02-16 09:30:00,380,348,372,1100,6600
2016-02-16 09:40:00,495,461,490,1446,8676
2016-02-16 09:50:00,588,552,581,1721,10326
2016-02-16 10:00:00,660,622,653,1935,11610
2016-02-16 10:10:00,700,675,700,2075,12450
2016-02-16 10:20:00,771,744,772,2287,13722
2016-02-16 10:30:00,801,771,799,2371,14226
2016-02-16 10:40:00,859,822,845,2526,15156
2016-02-16 10:50:00,799,772,793,2364,14184
2016-02-16 11:00:00,831,788,818,2437,14622
2016-02-16 11:10:00,860,802,843,2505,15030
2016-02-16 11:20:00,853,800,839,2492,14952
2016-02-16 11:30:00,787,745,775,2307,13842
2016-02-16 11:40:00,736,703,732,2171,13026
2016-02-16 11:50:00,728,690,723,2141,12846
2016-02-16 12:00:00,747,701,738,2186,13116
2016-02-16 12:10:00,759,723,757,2239,13434
2016-02-16 12:20:00,766,731,764,2261,13566
2016-02-16 12:30:00,815,779,816,2410,14460
2016-02-16 12:40:00,887,854,888,2629,15774
2016-02-16 12:50:00,921,880,917,2718,16308
2016-02-16 13:00:00,912,871,900,2683,16098
2016-02-16 13:10:00,904,860,902,2666,15996
2016-02-16 13:20:00,878,837,875,2590,15540
2016-02-16 13:30:00,877,837,871,2585,15510
2016-02-16 13:40:00,820,780,815,2415,14490
2016-02-16 13:50:00,779,732,772,2283,13698
2016-02-16 14:00:00,735,691,728,2154,12924
2016-02-16 14:10:00,679,643,676,1998,11988
2016-02-16 14:20:00,632,598,627,1857,11142
2016-02-16 14:30:00,562,523,552,1637,9822
2016-02-16 14:40:00,529,493,521,1543,9258
2016-02-16 14:50:00,452,415,443,1310,7860
2016-02-16 15:00:00,398,365,391,1154,6924
2016-02-16 15:10:00,339,309,335,983,5898
2016-02-16 15:20:00,284,256,278,818,4908
2016-02-16 15:30:00,238,214,237,689,4134
2016-02-16 15:40:00,198,171,192,561,3366
2016-02-16 15:50:00,152,127,142,421,2526
2016-02-16 16:00:00,102,82,90,274,1644
2016-02-16 16:10:00,35,29,69,133,798
2016-02-16 16:20:00,30,19,51,100,600
2016-02-16 16:30:00,16,15,43,74,444
2016-02-16 16:40:00,8,14,34,56,336
2016-02-16 16:50:00,4,5,24,33,198
2016-02-16 17:00:00,3,1,11,15,90
2016-02-16 17:10:00,0,0,1,1,6
2016-02-16 17:20:00,0,0,0,0,0
2016-02-16 17:30:00,0,0,0,0,0
2016-02-17 07:10:00,0,0,0,0,0
2016-02-17 07:20:00,0,0,0,0,0
2016-02-17 07:30:00,0,0,0,0,0
2016-02-17 07:40:00,2,1,2,5,30
2016-02-17 07:50:00,10,3,13,26,156
2016-02-17 08:00:00,16,9,24,49,294
2016-02-17 08:10:00,24,22,47,93,558
2016-02-17 08:20:00,18,46,74,138,828
2016-02-17 08:30:00,26,88,106,220,1320
2016-02-17 08:40:00,19,104,117,240,1440
2016-02-17 08:50:00,35,44,74,153,918
2016-02-17 09:00:00,43,40,72,155,930
2016-02-17 09:10:00,136,42,199,377,2262
2016-02-17 09:20:00,242,141,245,628,3768
2016-02-17 09:30:00,366,331,354,1051,6306
2016-02-17 09:40:00,481,447,476,1404,8424
2016-02-17 09:50:00,540,506,535,1581,9486
2016-02-17 10:00:00,634,598,628,1860,11160
2016-02-17 10:10:00,696,656,686,2038,12228
2016-02-17 10:20:00,713,670,699,2082,12492
2016-02-17 10:30:00,679,639,675,1993,11958
2016-02-17 10:40:00,770,731,768,2269,13614
2016-02-17 10:50:00,681,671,691,2043,12258
2016-02-17 11:00:00,553,517,542,1612,9672
2016-02-17 11:10:00,373,342,364,1079,6474
2016-02-17 11:20:00,371,335,359,1065,6390
2016-02-17 11:30:00,868,812,849,2529,15174
2016-02-17 11:40:00,648,598,628,1874,11244
2016-02-17 11:50:00,776,724,763,2263,13578
2016-02-17 12:00:00,484,446,475,1405,8430
2016-02-17 12:10:00,208,180,202,590,3540
2016-02-17 12:20:00,263,235,263,761,4566
2016-02-17 12:30:00,251,222,245,718,4308
2016-02-17 12:40:00,429,388,413,1230,7380
2016-02-17 12:50:00,302,268,288,858,5148
2016-02-17 13:00:00,331,302,325,958,5748
2016-02-17 13:10:00,152,133,164,449,2694
2016-02-17 13:20:00,237,211,234,682,4092
2016-02-17 13:30:00,521,492,524,1537,9222
2016-02-17 13:40:00,294,267,290,851,5106
2016-02-17 13:50:00,385,360,384,1129,6774
2016-02-17 14:00:00,731,703,732,2166,12996
2016-02-17 14:10:00,377,349,372,1098,6588
2016-02-17 14:20:00,358,329,347,1034,6204
2016-02-17 14:30:00,282,255,276,813,4878
2016-02-17 14:40:00,250,225,243,718,4308
2016-02-17 14:50:00,138,113,131,382,2292
2016-02-17 15:00:00,184,157,176,517,3102
2016-02-17 15:10:00,42,136,156,334,2004
2016-02-17 15:20:00,132,111,136,379,2274
2016-02-17 15:30:00,157,130,148,435,2610
2016-02-17 15:40:00,161,78,143,382,2292
2016-02-17 15:50:00,56,53,106,215,1290
2016-02-17 16:00:00,34,115,138,287,1722
2016-02-17 16:10:00,24,115,123,262,1572
2016-02-17 16:20:00,46,42,72,160,960
2016-02-17 16:30:00,39,16,54,109,654
2016-02-17 16:40:00,38,9,42,89,534
2016-02-17 16:50:00,23,5,26,54,324
2016-02-17 17:00:00,9,2,9,20,120
2016-02-17 17:10:00,1,0,2,3,18
2016-02-17 17:20:00,0,0,0,0,0
2016-02-17 17:30:00,0,0,0,0,0
2016-02-17 17:40:00,0,0,0,0,0
2016-02-18 07:20:00,0,0,0,0,0
2016-02-18 07:30:00,0,0,0,0,0
2016-02-18 07:40:00,0,0,0,0,0
2016-02-18 07:50:00,0,0,0,0,0
2016-02-18 08:00:00,0,0,0,0,0
2016-02-18 08:10:00,1,0,2,3,18
2016-02-18 08:20:00,5,2,14,21,126
2016-02-18 08:30:00,6,3,11,20,120
2016-02-18 08:40:00,3,2,5,10,60
2016-02-18 08:50:00,5,1,6,12,72
2016-02-18 09:00:00,9,5,20,34,204
2016-02-18 09:10:00,14,4,17,35,210
2016-02-18 09:20:00,10,2,13,25,150
2016-02-18 09:30:00,10,2,14,26,156
2016-02-18 09:40:00,22,11,29,62,372
2016-02-18 09:50:00,21,27,75,123,738
2016-02-18 10:00:00,23,30,77,130,780
2016-02-18 10:10:00,40,38,74,152,912
2016-02-18 10:20:00,29,43,63,135,810
2016-02-18 10:30:00,30,47,78,155,930
2016-02-18 10:40:00,2,134,143,279,1674
2016-02-18 10:50:00,13,144,161,318,1908
2016-02-18 11:00:00,0,134,142,276,1656
2016-02-18 11:10:00,19,95,109,223,1338
2016-02-18 11:20:00,51,140,163,354,2124
2016-02-18 11:30:00,242,196,267,705,4230
2016-02-18 11:40:00,478,444,470,1392,8352
2016-02-18 11:50:00,596,564,591,1751,10506
2016-02-18 12:00:00,484,452,476,1412,8472
2016-02-18 12:10:00,601,565,589,1755,10530
2016-02-18 12:20:00,697,651,680,2028,12168
2016-02-18 12:30:00,693,643,673,2009,12054
2016-02-18 12:40:00,379,346,362,1087,6522
2016-02-18 12:50:00,443,406,420,1269,7614
2016-02-18 13:00:00,600,553,575,1728,10368
2016-02-18 13:10:00,761,708,735,2204,13224
2016-02-18 13:20:00,749,701,723,2173,13038
2016-02-18 13:30:00,700,651,675,2026,12156
2016-02-18 13:40:00,393,358,378,1129,6774
2016-02-18 13:50:00,332,300,318,950,5700
2016-02-18 14:00:00,347,314,334,995,5970
2016-02-18 14:10:00,265,235,251,751,4506
2016-02-18 14:20:00,292,212,202,706,4236
2016-02-18 14:30:00,223,210,217,650,3900
2016-02-18 14:40:00,218,190,201,609,3654
2016-02-18 14:50:00,74,33,72,179,1074
2016-02-18 15:00:00,37,30,71,138,828
2016-02-18 15:10:00,43,14,53,110,660
2016-02-18 15:20:00,46,28,69,143,858
2016-02-18 15:30:00,69,48,87,204,1224
2016-02-18 15:40:00,29,122,140,291,1746
2016-02-18 15:50:00,16,107,117,240,1440
2016-02-18 16:00:00,39,65,91,195,1170
2016-02-18 16:10:00,31,33,76,140,840
2016-02-18 16:20:00,27,21,51,99,594
2016-02-18 16:30:00,18,11,34,63,378
2016-02-18 16:40:00,13,11,25,49,294
2016-02-18 16:50:00,10,4,17,31,186
2016-02-18 17:00:00,6,0,6,12,72
2016-02-18 17:10:00,0,0,0,0,0
2016-02-18 17:20:00,0,0,0,0,0
2016-02-18 17:30:00,0,0,0,0,0
2016-02-19 07:10:00,0,0,0,0,0
2016-02-19 07:20:00,0,0,0,0,0
2016-02-19 07:30:00,0,0,0,0,0
2016-02-19 07:40:00,0,0,0,0,0
2016-02-19 07:50:00,0,0,0,0,0
2016-02-19 08:00:00,1,0,2,3,18
2016-02-19 08:10:00,2,0,3,5,30
2016-02-19 08:20:00,5,2,8,15,90
2016-02-19 08:30:00,7,3,12,22,132
2016-02-19 08:40:00,12,7,19,38,228
2016-02-19 08:50:00,12,10,25,47,282
2016-02-19 09:00:00,4,17,27,48,288
2016-02-19 09:10:00,4,7,26,37,222
2016-02-19 09:20:00,6,16,32,54,324
2016-02-19 09:30:00,11,19,43,73,438
2016-02-19 09:40:00,12,25,45,82,492
2016-02-19 09:50:00,9,36,52,97,582
2016-02-19 10:00:00,19,22,74,115,690
2016-02-19 10:10:00,15,15,79,109,654
2016-02-19 10:20:00,27,25,62,114,684
2016-02-19 10:30:00,30,24,60,114,684
2016-02-19 10:40:00,24,20,65,109,654
2016-02-19 10:50:00,17,20,41,78,468
2016-02-19 11:00:00,11,14,34,59,354
2016-02-19 11:10:00,20,21,47,88,528
2016-02-19 11:20:00,21,23,59,103,618
2016-02-19 11:30:00,24,18,59,101,606
2016-02-19 11:40:00,28,20,48,96,576
2016-02-19 11:50:00,18,18,85,121,726
2016-02-19 12:00:00,34,48,67,149,894
2016-02-19 12:10:00,15,70,87,172,1032
2016-02-19 12:20:00,32,77,101,210,1260
2016-02-19 12:30:00,16,107,122,245,1470
2016-02-19 12:40:00,11,113,128,252,1512
2016-02-19 12:50:00,6,129,137,272,1632
2016-02-19 13:00:00,0,145,153,298,1788
2016-02-19 13:10:00,18,149,152,319,1914
2016-02-19 13:20:00,27,148,165,340,2040
2016-02-19 13:30:00,113,163,153,429,2574
2016-02-19 13:40:00,22,148,168,338,2028
2016-02-19 13:50:00,9,145,153,307,1842
2016-02-19 14:00:00,61,63,113,237,1422
2016-02-19 14:10:00,147,70,122,339,2034
2016-02-19 14:20:00,51,33,82,166,996
2016-02-19 14:30:00,34,46,71,151,906
2016-02-19 14:40:00,32,29,77,138,828
2016-02-19 14:50:00,49,20,68,137,822
2016-02-19 15:00:00,25,20,59,104,624
2016-02-19 15:10:00,15,21,79,115,690
2016-02-19 15:20:00,18,29,60,107,642
2016-02-19 15:30:00,11,29,50,90,540
2016-02-19 15:40:00,14,10,31,55,330
2016-02-19 15:50:00,10,9,25,44,264
2016-02-19 16:00:00,10,4,20,34,204
2016-02-19 16:10:00,10,5,19,34,204
2016-02-19 16:20:00,9,3,17,29,174
2016-02-19 16:30:00,6,0,9,15,90
2016-02-19 16:40:00,5,0,9,14,84
2016-02-19 16:50:00,3,0,4,7,42
2016-02-19 17:00:00,0,0,1,1,6
2016-02-19 17:10:00,0,0,0,0,0
2016-02-19 17:20:00,0,0,0,0,0
2016-02-19 17:30:00,0,0,0,0,0
2016-02-20 07:30:00,0,0,0,0,0
2016-02-20 07:40:00,0,0,0,0,0
2016-02-20 07:50:00,0,0,0,0,0
2016-02-20 08:00:00,0,0,0,0,0
2016-02-20 08:10:00,0,0,0,0,0
2016-02-20 08:20:00,0,0,0,0,0
2016-02-20 08:30:00,0,0,0,0,0
2016-02-20 08:40:00,0,0,0,0,0
2016-02-20 08:50:00,0,0,0,0,0
2016-02-20 09:00:00,6,9,7,22,132
2016-02-20 09:10:00,9,2,8,19,114
2016-02-20 09:20:00,11,3,10,24,144
2016-02-20 09:30:00,19,6,26,51,306
2016-02-20 09:40:00,14,3,18,35,210
2016-02-20 09:50:00,51,19,55,125,750
2016-02-20 10:00:00,33,12,31,76,456
2016-02-20 10:10:00,38,22,59,119,714
2016-02-20 10:20:00,51,44,74,169,1014
2016-02-20 10:30:00,75,53,112,240,1440
2016-02-20 10:40:00,43,115,127,285,1710
2016-02-20 10:50:00,46,87,109,242,1452
2016-02-20 11:00:00,26,30,63,119,714
2016-02-20 11:10:00,74,84,98,256,1536
2016-02-20 11:20:00,64,105,165,334,2004
2016-02-20 11:30:00,21,55,80,156,936
2016-02-20 11:40:00,27,26,59,112,672
2016-02-20 11:50:00,45,82,105,232,1392
2016-02-20 12:00:00,292,298,387,977,5862
2016-02-20 12:10:00,737,706,739,2182,13092
2016-02-20 12:20:00,273,247,264,784,4704
2016-02-20 12:30:00,924,884,914,2722,16332
2016-02-20 12:40:00,233,211,232,676,4056
2016-02-20 12:50:00,45,40,66,151,906
2016-02-20 13:00:00,33,27,62,122,732
2016-02-20 13:10:00,52,28,71,151,906
2016-02-20 13:20:00,115,71,120,306,1836
2016-02-20 13:30:00,335,284,352,971,5826
2016-02-20 13:40:00,498,460,487,1445,8670
2016-02-20 13:50:00,200,178,194,572,3432
2016-02-20 14:00:00,515,498,520,1533,9198
2016-02-20 14:10:00,446,422,437,1305,7830
2016-02-20 14:20:00,405,384,399,1188,7128
2016-02-20 14:30:00,304,279,298,881,5286
2016-02-20 14:40:00,488,451,474,1413,8478
2016-02-20 14:50:00,217,192,210,619,3714
2016-02-20 15:00:00,193,168,184,545,3270
2016-02-20 15:10:00,158,133,150,441,2646
2016-02-20 15:20:00,109,81,113,303,1818
2016-02-20 15:30:00,66,32,81,179,1074
2016-02-20 15:40:00,63,87,98,248,1488
2016-02-20 15:50:00,58,79,79,216,1296
2016-02-20 16:00:00,56,55,81,192,1152
2016-02-20 16:10:00,31,36,73,140,840
2016-02-20 16:20:00,30,29,57,116,696
2016-02-20 16:30:00,17,27,51,95,570
2016-02-20 16:40:00,4,11,27,42,252
2016-02-20 16:50:00,1,2,6,9,54
2016-02-20 17:00:00,0,0,0,0,0
2016-02-20 17:10:00,0,0,0,0,0
2016-02-20 17:20:00,0,0,0,0,0
2016-02-20 17:30:00,0,0,0,0,0
2016-02-20 17:40:00,0,0,0,0,0
2016-02-21 07:00:00,0,0,0,0,0
2016-02-21 07:10:00,0,0,0,0,0
2016-02-21 07:20:00,0,0,0,0,0
2016-02-21 07:30:00,1,1,1,3,18
2016-02-21 07:40:00,4,1,6,11,66
2016-02-21 07:50:00,10,9,26,45,270
2016-02-21 08:00:00,9,6,12,27,162
2016-02-21 08:10:00,7,3,8,18,108
2016-02-21 08:20:00,6,2,9,17,102
2016-02-21 08:30:00,28,36,52,116,696
2016-02-21 08:40:00,23,81,97,201,1206
2016-02-21 08:50:00,50,85,96,231,1386
2016-02-21 09:00:00,72,100,138,310,1860
2016-02-21 09:10:00,57,123,145,325,1950
2016-02-21 09:20:00,85,135,196,416,2496
2016-02-21 09:30:00,132,160,146,438,2628
2016-02-21 09:40:00,226,212,212,650,3900
2016-02-21 09:50:00,193,198,197,588,3528
2016-02-21 10:00:00,296,271,290,857,5142
2016-02-21 10:10:00,324,298,317,939,5634
2016-02-21 10:20:00,306,278,297,881,5286
2016-02-21 10:30:00,327,299,316,942,5652
2016-02-21 10:40:00,312,284,303,899,5394
2016-02-21 10:50:00,240,213,233,686,4116
2016-02-21 11:00:00,268,238,261,767,4602
2016-02-21 11:10:00,386,352,379,1117,6702
2016-02-21 11:20:00,617,579,608,1804,10824
2016-02-21 11:30:00,490,456,481,1427,8562
2016-02-21 11:40:00,511,483,506,1500,9000
2016-02-21 11:50:00,633,603,628,1864,11184
2016-02-21 12:00:00,561,534,558,1653,9918
2016-02-21 12:10:00,383,355,379,1117,6702
2016-02-21 12:20:00,323,297,317,937,5622
2016-02-21 12:30:00,310,281,299,890,5340
2016-02-21 12:40:00,251,222,242,715,4290
2016-02-21 12:50:00,227,199,218,644,3864
2016-02-21 13:00:00,157,129,149,435,2610
2016-02-21 13:10:00,33,92,109,234,1404
2016-02-21 13:20:00,52,57,107,216,1296
2016-02-21 13:30:00,262,221,233,716,4296
2016-02-21 13:40:00,282,231,206,719,4314
2016-02-21 13:50:00,312,285,304,901,5406
2016-02-21 14:00:00,198,174,193,565,3390
2016-02-21 14:10:00,23,120,121,264,1584
2016-02-21 14:20:00,63,123,167,353,2118
2016-02-21 14:30:00,27,130,178,335,2010
2016-02-21 14:40:00,62,64,84,210,1260
2016-02-21 14:50:00,48,47,88,183,1098
2016-02-21 15:00:00,41,34,74,149,894
2016-02-21 15:10:00,28,18,45,91,546
2016-02-21 15:20:00,11,8,21,40,240
2016-02-21 15:30:00,29,14,47,90,540
2016-02-21 15:40:00,21,13,40,74,444
2016-02-21 15:50:00,16,12,90,118,708
2016-02-21 16:00:00,30,19,76,125,750
2016-02-21 16:10:00,18,22,56,96,576
2016-02-21 16:20:00,14,15,36,65,390
2016-02-21 16:30:00,8,1,11,20,120
2016-02-21 16:40:00,9,2,13,24,144
2016-02-21 16:50:00,6,0,7,13,78
2016-02-21 17:00:00,3,0,2,5,30
2016-02-21 17:10:00,0,0,0,0,0
2016-02-21 17:20:00,0,0,0,0,0
2016-02-21 17:30:00,0,0,0,0,0
2016-02-22 07:10:00,0,0,0,0,0
2016-02-22 07:20:00,0,0,0,0,0
2016-02-22 07:30:00,0,1,1,2,12
2016-02-22 07:40:00,5,4,7,16,96
2016-02-22 07:50:00,10,6,16,32,192
2016-02-22 08:00:00,15,10,25,50,300
2016-02-22 08:10:00,30,19,48,97,582
2016-02-22 08:20:00,19,60,77,156,936
2016-02-22 08:30:00,39,29,74,142,852
2016-02-22 08:40:00,41,24,75,140,840
2016-02-22 08:50:00,57,30,81,168,1008
2016-02-22 09:00:00,38,62,87,187,1122
2016-02-22 09:10:00,152,146,187,485,2910
2016-02-22 09:20:00,275,246,264,785,4710
2016-02-22 09:30:00,438,406,426,1270,7620
2016-02-22 09:40:00,319,290,309,918,5508
2016-02-22 09:50:00,172,146,170,488,2928
2016-02-22 10:00:00,533,495,517,1545,9270
2016-02-22 10:10:00,656,611,636,1903,11418
2016-02-22 10:20:00,763,722,748,2233,13398
2016-02-22 10:30:00,792,750,776,2318,13908
2016-02-22 10:40:00,809,769,799,2377,14262
2016-02-22 10:50:00,828,788,819,2435,14610
2016-02-22 11:00:00,776,736,763,2275,13650
2016-02-22 11:10:00,812,773,797,2382,14292
2016-02-22 11:20:00,694,657,679,2030,12180
2016-02-22 11:30:00,437,406,428,1271,7626
2016-02-22 11:40:00,921,881,910,2712,16272
2016-02-22 11:50:00,917,883,915,2715,16290
2016-02-22 12:00:00,927,889,924,2740,16440
2016-02-22 12:10:00,751,708,740,2199,13194
2016-02-22 12:20:00,651,608,635,1894,11364
2016-02-22 12:30:00,881,830,863,2574,15444
2016-02-22 12:40:00,765,722,752,2239,13434
2016-02-22 12:50:00,464,427,450,1341,8046
2016-02-22 13:00:00,314,279,301,894,5364
2016-02-22 13:10:00,230,159,168,557,3342
2016-02-22 13:20:00,172,127,202,501,3006
2016-02-22 13:30:00,172,127,184,483,2898
2016-02-22 13:40:00,159,136,185,480,2880
2016-02-22 13:50:00,214,173,185,572,3432
2016-02-22 14:00:00,482,447,473,1402,8412
2016-02-22 14:10:00,688,653,681,2022,12132
2016-02-22 14:20:00,458,426,448,1332,7992
2016-02-22 14:30:00,297,267,287,851,5106
2016-02-22 14:40:00,489,458,479,1426,8556
2016-02-22 14:50:00,447,415,436,1298,7788
2016-02-22 15:00:00,297,270,287,854,5124
2016-02-22 15:10:00,232,209,229,670,4020
2016-02-22 15:20:00,186,160,175,521,3126
2016-02-22 15:30:00,129,104,119,352,2112
2016-02-22 15:40:00,76,134,146,356,2136
2016-02-22 15:50:00,63,109,130,302,1812
2016-02-22 16:00:00,16,114,126,256,1536
2016-02-22 16:10:00,42,76,104,222,1332
2016-02-22 16:20:00,39,28,73,140,840
2016-02-22 16:30:00,10,3,15,28,168
2016-02-22 16:40:00,36,12,48,96,576
2016-02-22 16:50:00,16,7,22,45,270
2016-02-22 17:00:00,13,4,15,32,192
2016-02-22 17:10:00,2,0,2,4,24
2016-02-22 17:20:00,4,0,5,9,54
2016-02-22 17:30:00,2,0,2,4,24
2016-02-22 17:40:00,0,0,0,0,0
2016-02-22 17:50:00,0,0,0,0,0
2016-02-23 07:00:00,0,0,0,0,0
2016-02-23 07:10:00,0,0,0,0,0
2016-02-23 07:20:00,0,0,0,0,0
2016-02-23 07:30:00,2,0,3,5,30
2016-02-23 07:40:00,8,3,13,24,144
2016-02-23 07:50:00,16,7,24,47,282
2016-02-23 08:00:00,29,19,47,95,570
2016-02-23 08:10:00,24,21,47,92,552
2016-02-23 08:20:00,38,14,48,100,600
2016-02-23 08:30:00,26,44,54,124,744
2016-02-23 08:40:00,35,33,71,139,834
2016-02-23 08:50:00,53,27,77,157,942
2016-02-23 09:00:00,73,25,85,183,1098
2016-02-23 09:10:00,193,155,150,498,2988
2016-02-23 09:20:00,271,242,262,775,4650
2016-02-23 09:30:00,426,393,415,1234,7404
2016-02-23 09:40:00,539,500,527,1566,9396
2016-02-23 09:50:00,646,604,635,1885,11310
2016-02-23 10:00:00,707,667,694,2068,12408
2016-02-23 10:10:00,745,700,727,2172,13032
2016-02-23 10:20:00,780,748,775,2303,13818
2016-02-23 10:30:00,720,684,706,2110,12660
2016-02-23 10:40:00,362,333,352,1047,6282
2016-02-23 10:50:00,231,221,243,695,4170
2016-02-23 11:00:00,626,587,614,1827,10962
2016-02-23 11:10:00,382,352,377,1111,6666
2016-02-23 11:20:00,178,102,234,514,3084
2016-02-23 11:30:00,204,134,227,565,3390
2016-02-23 11:40:00,138,121,168,427,2562
2016-02-23 11:50:00,276,250,268,794,4764
2016-02-23 12:00:00,267,241,261,769,4614
2016-02-23 12:10:00,124,132,222,478,2868
2016-02-23 12:20:00,275,261,304,840,5040
2016-02-23 12:30:00,466,441,462,1369,8214
2016-02-23 12:40:00,547,515,541,1603,9618
2016-02-23 12:50:00,350,320,342,1012,6072
2016-02-23 13:00:00,151,123,142,416,2496
2016-02-23 13:10:00,34,129,144,307,1842
2016-02-23 13:20:00,176,183,221,580,3480
2016-02-23 13:30:00,889,858,890,2637,15822
2016-02-23 13:40:00,258,231,252,741,4446
2016-02-23 13:50:00,459,432,453,1344,8064
2016-02-23 14:00:00,709,678,704,2091,12546
2016-02-23 14:10:00,596,568,591,1755,10530
2016-02-23 14:20:00,639,610,635,1884,11304
2016-02-23 14:30:00,294,267,285,846,5076
2016-02-23 14:40:00,196,198,214,608,3648
2016-02-23 14:50:00,320,324,343,987,5922
2016-02-23 15:00:00,344,327,352,1023,6138
2016-02-23 15:10:00,205,182,200,587,3522
2016-02-23 15:20:00,147,125,140,412,2472
2016-02-23 15:30:00,65,39,80,184,1104
2016-02-23 15:40:00,39,75,86,200,1200
2016-02-23 15:50:00,31,38,66,135,810
2016-02-23 16:00:00,38,16,30,84,504
2016-02-23 16:10:00,33,25,47,105,630
2016-02-23 16:20:00,41,49,77,167,1002
2016-02-23 16:30:00,43,66,89,198,1188
2016-02-23 16:40:00,22,13,40,75,450
2016-02-23 16:50:00,21,11,33,65,390
2016-02-23 17:00:00,8,11,21,40,240
2016-02-23 17:10:00,6,2,8,16,96
2016-02-23 17:20:00,1,0,2,3,18
2016-02-23 17:30:00,0,0,0,0,0
2016-02-23 17:40:00,0,0,0,0,0
2016-02-23 17:50:00,0,0,0,0,0
2016-02-24 06:50:00,0,0,0,0,0
2016-02-24 07:00:00,0,0,0,0,0
2016-02-24 07:10:00,0,0,0,0,0
2016-02-24 07:20:00,0,0,0,0,0
2016-02-24 07:30:00,5,2,7,14,84
2016-02-24 07:40:00,10,4,15,29,174
2016-02-24 07:50:00,18,5,23,46,276
2016-02-24 08:00:00,22,8,35,65,390
2016-02-24 08:10:00,22,16,42,80,480
2016-02-24 08:20:00,43,7,48,98,588
2016-02-24 08:30:00,40,16,57,113,678
2016-02-24 08:40:00,32,35,68,135,810
2016-02-24 08:50:00,47,32,75,154,924
2016-02-24 09:00:00,62,37,63,162,972
2016-02-24 09:10:00,224,81,201,506,3036
2016-02-24 09:20:00,293,264,282,839,5034
2016-02-24 09:30:00,446,416,432,1294,7764
2016-02-24 09:40:00,567,533,549,1649,9894
2016-02-24 09:50:00,660,621,640,1921,11526
2016-02-24 10:00:00,737,696,716,2149,12894
2016-02-24 10:10:00,787,747,771,2305,13830
2016-02-24 10:20:00,813,774,799,2386,14316
2016-02-24 10:30:00,837,798,832,2467,14802
2016-02-24 10:40:00,871,826,855,2552,15312
2016-02-24 10:50:00,894,851,875,2620,15720
2016-02-24 11:00:00,890,853,881,2624,15744
2016-02-24 11:10:00,534,505,531,1570,9420
2016-02-24 11:20:00,882,850,879,2611,15666
2016-02-24 11:30:00,960,924,953,2837,17022
2016-02-24 11:40:00,914,873,908,2695,16170
2016-02-24 11:50:00,946,911,948,2805,16830
2016-02-24 12:00:00,975,936,976,2887,17322
2016-02-24 12:10:00,973,936,974,2883,17298
2016-02-24 12:20:00,984,951,984,2919,17514
2016-02-24 12:30:00,985,936,970,2891,17346
2016-02-24 12:40:00,943,902,936,2781,16686
2016-02-24 12:50:00,953,904,938,2795,16770
2016-02-24 13:00:00,784,739,770,2293,13758
2016-02-24 13:10:00,208,183,201,592,3552
2016-02-24 13:20:00,644,613,639,1896,11376
2016-02-24 13:30:00,933,895,920,2748,16488
2016-02-24 13:40:00,887,848,869,2604,15624
2016-02-24 13:50:00,850,807,839,2496,14976
2016-02-24 14:00:00,822,782,810,2414,14484
2016-02-24 14:10:00,824,779,810,2413,14478
2016-02-24 14:20:00,707,671,697,2075,12450
2016-02-24 14:30:00,538,508,530,1576,9456
2016-02-24 14:40:00,570,543,563,1676,10056
2016-02-24 14:50:00,550,522,545,1617,9702
2016-02-24 15:00:00,521,489,511,1521,9126
2016-02-24 15:10:00,455,423,446,1324,7944
2016-02-24 15:20:00,387,355,376,1118,6708
2016-02-24 15:30:00,224,198,215,637,3822
2016-02-24 15:40:00,206,181,197,584,3504
2016-02-24 15:50:00,68,68,89,225,1350
2016-02-24 16:00:00,137,73,219,429,2574
2016-02-24 16:10:00,69,103,122,294,1764
2016-02-24 16:20:00,61,68,87,216,1296
2016-02-24 16:30:00,44,53,77,174,1044
2016-02-24 16:40:00,21,26,75,122,732
2016-02-24 16:50:00,8,22,46,76,456
2016-02-24 17:00:00,14,5,20,39,234
2016-02-24 17:10:00,7,1,9,17,102
2016-02-24 17:20:00,2,0,3,5,30
2016-02-24 17:30:00,0,0,0,0,0
2016-02-24 17:40:00,0,0,0,0,0
2016-02-24 17:50:00,0,0,0,0,0
2016-02-25 06:50:00,0,0,0,0,0
2016-02-25 07:00:00,0,0,0,0,0
2016-02-25 07:10:00,0,0,0,0,0
2016-02-25 07:20:00,0,0,1,1,6
2016-02-25 07:30:00,5,1,8,14,84
2016-02-25 07:40:00,10,4,15,29,174
2016-02-25 07:50:00,13,8,24,45,270
2016-02-25 08:00:00,19,11,36,66,396
2016-02-25 08:10:00,30,33,66,129,774
2016-02-25 08:20:00,54,45,87,186,1116
2016-02-25 08:30:00,60,40,85,185,1110
2016-02-25 08:40:00,44,60,90,194,1164
2016-02-25 08:50:00,47,84,103,234,1404
2016-02-25 09:00:00,33,96,111,240,1440
2016-02-25 09:10:00,198,135,230,563,3378
2016-02-25 09:20:00,321,294,316,931,5586
2016-02-25 09:30:00,492,463,487,1442,8652
2016-02-25 09:40:00,607,574,597,1778,10668
2016-02-25 09:50:00,694,653,680,2027,12162
2016-02-25 10:00:00,768,724,754,2246,13476
2016-02-25 10:10:00,795,763,788,2346,14076
2016-02-25 10:20:00,829,789,818,2436,14616
2016-02-25 10:30:00,861,818,846,2525,15150
2016-02-25 10:40:00,906,860,895,2661,15966
2016-02-25 10:50:00,1044,991,1028,3063,18378
2016-02-25 11:00:00,850,804,835,2489,14934
2016-02-25 11:10:00,631,594,623,1848,11088
2016-02-25 11:20:00,881,841,877,2599,15594
2016-02-25 11:30:00,964,919,952,2835,17010
2016-02-25 11:40:00,949,905,935,2789,16734
2016-02-25 11:50:00,973,927,959,2859,17154
2016-02-25 12:00:00,977,935,968,2880,17280
2016-02-25 12:10:00,978,939,973,2890,17340
2016-02-25 12:20:00,977,943,973,2893,17358
2016-02-25 12:30:00,974,944,974,2892,17352
2016-02-25 12:40:00,970,937,967,2874,17244
2016-02-25 12:50:00,974,935,967,2876,17256
2016-02-25 13:00:00,745,708,734,2187,13122
2016-02-25 13:10:00,755,715,745,2215,13290
2016-02-25 13:20:00,439,404,429,1272,7632
2016-02-25 13:30:00,297,266,287,850,5100
2016-02-25 13:40:00,237,208,228,673,4038
2016-02-25 13:50:00,242,214,233,689,4134
2016-02-25 14:00:00,194,168,184,546,3276
2016-02-25 14:10:00,115,91,107,313,1878
2016-02-25 14:20:00,105,61,107,273,1638
2016-02-25 14:30:00,87,92,139,318,1908
2016-02-25 14:40:00,64,62,106,232,1392
2016-02-25 14:50:00,81,88,167,336,2016
2016-02-25 15:00:00,180,64,206,450,2700
2016-02-25 15:10:00,180,82,266,528,3168
2016-02-25 15:20:00,146,124,191,461,2766
2016-02-25 15:30:00,44,128,162,334,2004
2016-02-25 15:40:00,58,63,98,219,1314
2016-02-25 15:50:00,51,79,96,226,1356
2016-02-25 16:00:00,73,55,88,216,1296
2016-02-25 16:10:00,39,40,73,152,912
2016-02-25 16:20:00,45,44,88,177,1062
2016-02-25 16:30:00,30,25,70,125,750
2016-02-25 16:40:00,40,11,50,101,606
2016-02-25 16:50:00,26,7,33,66,396
2016-02-25 17:00:00,12,3,13,28,168
2016-02-25 17:10:00,5,1,7,13,78
2016-02-25 17:20:00,2,0,3,5,30
2016-02-25 17:30:00,0,0,0,0,0
2016-02-25 17:40:00,0,0,0,0,0
2016-02-25 17:50:00,0,0,0,0,0
2016-02-26 06:50:00,0,0,0,0,0
2016-02-26 07:00:00,0,0,0,0,0
2016-02-26 07:10:00,0,0,0,0,0
2016-02-26 07:20:00,2,0,2,4,24
2016-02-26 07:30:00,6,3,11,20,120
2016-02-26 07:40:00,9,8,20,37,222
2016-02-26 07:50:00,13,10,30,53,318
2016-02-26 08:00:00,16,14,39,69,414
2016-02-26 08:10:00,11,20,52,83,498
2016-02-26 08:20:00,13,32,54,99,594
2016-02-26 08:30:00,23,34,56,113,678
2016-02-26 08:40:00,27,29,74,130,780
2016-02-26 08:50:00,31,48,71,150,900
2016-02-26 09:00:00,28,64,83,175,1050
2016-02-26 09:10:00,187,156,220,563,3378
2016-02-26 09:20:00,304,272,294,870,5220
2016-02-26 09:30:00,436,400,426,1262,7572
2016-02-26 09:40:00,576,540,568,1684,10104
2016-02-26 09:50:00,686,649,676,2011,12066
2016-02-26 10:00:00,762,720,743,2225,13350
2016-02-26 10:10:00,802,759,788,2349,14094
2016-02-26 10:20:00,820,794,823,2437,14622
2016-02-26 10:30:00,859,817,847,2523,15138
2016-02-26 10:40:00,874,836,875,2585,15510
2016-02-26 10:50:00,895,863,898,2656,15936
2016-02-26 11:00:00,913,877,908,2698,16188
2016-02-26 11:10:00,919,884,917,2720,16320
2016-02-26 11:20:00,927,891,926,2744,16464
2016-02-26 11:30:00,933,901,931,2765,16590
2016-02-26 11:40:00,942,906,938,2786,16716
2016-02-26 11:50:00,957,913,945,2815,16890
2016-02-26 12:00:00,965,923,956,2844,17064
2016-02-26 12:10:00,931,938,974,2843,17058
2016-02-26 12:20:00,944,951,972,2867,17202
2016-02-26 12:30:00,962,941,965,2868,17208
2016-02-26 12:40:00,963,929,955,2847,17082
2016-02-26 12:50:00,957,917,943,2817,16902
2016-02-26 13:00:00,949,899,930,2778,16668
2016-02-26 13:10:00,939,894,928,2761,16566
2016-02-26 13:20:00,928,886,911,2725,16350
2016-02-26 13:30:00,909,872,898,2679,16074
2016-02-26 13:40:00,879,836,866,2581,15486
2016-02-26 13:50:00,839,797,828,2464,14784
2016-02-26 14:00:00,797,763,792,2352,14112
2016-02-26 14:10:00,754,720,748,2222,13332
2016-02-26 14:20:00,712,670,707,2089,12534
2016-02-26 14:30:00,652,619,646,1917,11502
2016-02-26 14:40:00,604,578,593,1775,10650
2016-02-26 14:50:00,377,352,372,1101,6606
2016-02-26 15:00:00,506,476,501,1483,8898
2016-02-26 15:10:00,349,319,340,1008,6048
2016-02-26 15:20:00,342,309,330,981,5886
2016-02-26 15:30:00,333,299,321,953,5718
2016-02-26 15:40:00,281,251,270,802,4812
2016-02-26 15:50:00,252,223,242,717,4302
2016-02-26 16:00:00,231,203,222,656,3936
2016-02-26 16:10:00,159,134,150,443,2658
2016-02-26 16:20:00,104,80,96,280,1680
2016-02-26 16:30:00,46,37,71,154,924
2016-02-26 16:40:00,24,35,72,131,786
2016-02-26 16:50:00,30,11,39,80,480
2016-02-26 17:00:00,15,5,23,43,258
2016-02-26 17:10:00,13,5,18,36,216
2016-02-26 17:20:00,6,2,9,17,102
2016-02-26 17:30:00,0,0,1,1,6
2016-02-26 17:40:00,0,0,0,0,0
2016-02-26 17:50:00,0,0,0,0,0
2016-02-27 06:40:00,0,0,0,0,0
2016-02-27 06:50:00,0,0,0,0,0
2016-02-27 07:00:00,0,0,0,0,0
2016-02-27 07:10:00,0,0,0,0,0
2016-02-27 07:20:00,4,0,6,10,60
2016-02-27 07:30:00,11,5,18,34,204
2016-02-27 07:40:00,18,12,37,67,402
2016-02-27 07:50:00,23,15,44,82,492
2016-02-27 08:00:00,36,27,66,129,774
2016-02-27 08:10:00,31,32,70,133,798
2016-02-27 08:20:00,17,77,94,188,1128
2016-02-27 08:30:00,37,113,149,299,1794
2016-02-27 08:40:00,37,102,133,272,1632
2016-02-27 08:50:00,125,60,254,439,2634
2016-02-27 09:00:00,29,89,125,243,1458
2016-02-27 09:10:00,6,138,167,311,1866
2016-02-27 09:20:00,29,123,176,328,1968
2016-02-27 09:30:00,15,152,206,373,2238
2016-02-27 09:40:00,90,124,160,374,2244
2016-02-27 09:50:00,173,91,202,466,2796
2016-02-27 10:00:00,227,132,171,530,3180
2016-02-27 10:10:00,248,215,235,698,4188
2016-02-27 10:20:00,218,186,208,612,3672
2016-02-27 10:30:00,171,137,159,467,2802
2016-02-27 10:40:00,283,246,271,800,4800
2016-02-27 10:50:00,259,222,244,725,4350
2016-02-27 11:00:00,340,305,330,975,5850
2016-02-27 11:10:00,399,364,391,1154,6924
2016-02-27 11:20:00,404,367,399,1170,7020
2016-02-27 11:30:00,400,366,394,1160,6960
2016-02-27 11:40:00,746,706,744,2196,13176
2016-02-27 11:50:00,678,641,676,1995,11970
2016-02-27 12:00:00,674,632,668,1974,11844
2016-02-27 12:10:00,830,790,835,2455,14730
2016-02-27 12:20:00,860,833,876,2569,15414
2016-02-27 12:30:00,885,862,904,2651,15906
2016-02-27 12:40:00,969,928,970,2867,17202
2016-02-27 12:50:00,846,808,847,2501,15006
2016-02-27 13:00:00,775,742,772,2289,13734
2016-02-27 13:10:00,763,736,769,2268,13608
2016-02-27 13:20:00,818,791,814,2423,14538
2016-02-27 13:30:00,798,762,797,2357,14142
2016-02-27 13:40:00,844,809,851,2504,15024
2016-02-27 13:50:00,804,785,819,2408,14448
2016-02-27 14:00:00,763,732,762,2257,13542
2016-02-27 14:10:00,695,667,689,2051,12306
2016-02-27 14:20:00,601,570,590,1761,10566
2016-02-27 14:30:00,540,508,527,1575,9450
2016-02-27 14:40:00,488,455,481,1424,8544
2016-02-27 14:50:00,452,417,443,1312,7872
2016-02-27 15:00:00,411,379,398,1188,7128
2016-02-27 15:10:00,328,297,319,944,5664
2016-02-27 15:20:00,260,232,251,743,4458
2016-02-27 15:30:00,209,182,201,592,3552
2016-02-27 15:40:00,191,165,183,539,3234
2016-02-27 15:50:00,154,128,145,427,2562
2016-02-27 16:00:00,143,118,136,397,2382
2016-02-27 16:10:00,142,27,137,306,1836
2016-02-27 16:20:00,36,81,109,226,1356
2016-02-27 16:30:00,10,80,98,188,1128
2016-02-27 16:40:00,15,64,86,165,990
2016-02-27 16:50:00,31,28,67,126,756
2016-02-27 17:00:00,25,13,42,80,480
2016-02-27 17:10:00,19,4,20,43,258
2016-02-27 17:20:00,6,1,10,17,102
2016-02-27 17:30:00,0,0,0,0,0
2016-02-27 17:40:00,0,0,0,0,0
2016-02-27 17:50:00,0,0,0,0,0
2016-02-28 06:50:00,0,0,0,0,0
2016-02-28 07:00:00,0,0,0,0,0
2016-02-28 07:10:00,0,0,0,0,0
2016-02-28 07:20:00,0,0,0,0,0
2016-02-28 07:30:00,5,1,9,15,90
2016-02-28 07:40:00,7,2,13,22,132
2016-02-28 07:50:00,17,13,37,67,402
2016-02-28 08:00:00,29,16,47,92,552
2016-02-28 08:10:00,41,29,71,141,846
2016-02-28 08:20:00,33,25,74,132,792
2016-02-28 08:30:00,16,28,61,105,630
2016-02-28 08:40:00,23,31,84,138,828
2016-02-28 08:50:00,25,65,91,181,1086
2016-02-28 09:00:00,25,103,133,261,1566
2016-02-28 09:10:00,128,95,143,366,2196
2016-02-28 09:20:00,201,161,220,582,3492
2016-02-28 09:30:00,223,194,213,630,3780
2016-02-28 09:40:00,355,321,341,1017,6102
2016-02-28 09:50:00,301,272,293,866,5196
2016-02-28 10:00:00,329,299,319,947,5682
2016-02-28 10:10:00,255,178,194,627,3762
2016-02-28 10:20:00,256,229,245,730,4380
2016-02-28 10:30:00,193,167,184,544,3264
2016-02-28 10:40:00,215,187,205,607,3642
2016-02-28 10:50:00,242,213,232,687,4122
2016-02-28 11:00:00,183,156,175,514,3084
2016-02-28 11:10:00,236,207,229,672,4032
2016-02-28 11:20:00,247,217,239,703,4218
2016-02-28 11:30:00,385,353,377,1115,6690
2016-02-28 11:40:00,469,433,459,1361,8166
2016-02-28 11:50:00,664,622,649,1935,11610
2016-02-28 12:00:00,496,460,487,1443,8658
2016-02-28 12:10:00,302,270,294,866,5196
2016-02-28 12:20:00,371,335,360,1066,6396
2016-02-28 12:30:00,568,528,555,1651,9906
2016-02-28 12:40:00,936,897,928,2761,16566
2016-02-28 12:50:00,1069,1033,1061,3163,18978
2016-02-28 13:00:00,1009,970,1000,2979,17874
2016-02-28 13:10:00,509,482,505,1496,8976
2016-02-28 13:20:00,504,472,488,1464,8784
2016-02-28 13:30:00,820,783,789,2392,14352
2016-02-28 13:40:00,941,902,909,2752,16512
2016-02-28 13:50:00,557,522,541,1620,9720
2016-02-28 14:00:00,470,435,457,1362,8172
2016-02-28 14:10:00,443,411,435,1289,7734
2016-02-28 14:20:00,526,493,518,1537,9222
2016-02-28 14:30:00,685,648,673,2006,12036
2016-02-28 14:40:00,536,502,530,1568,9408
2016-02-28 14:50:00,537,502,531,1570,9420
2016-02-28 15:00:00,533,496,524,1553,9318
2016-02-28 15:10:00,488,449,476,1413,8478
2016-02-28 15:20:00,416,376,402,1194,7164
2016-02-28 15:30:00,333,297,321,951,5706
2016-02-28 15:40:00,269,240,261,770,4620
2016-02-28 15:50:00,246,216,239,701,4206
2016-02-28 16:00:00,211,182,204,597,3582
2016-02-28 16:10:00,158,131,151,440,2640
2016-02-28 16:20:00,118,91,110,319,1914
2016-02-28 16:30:00,89,38,63,190,1140
2016-02-28 16:40:00,13,18,95,126,756
2016-02-28 16:50:00,37,15,55,107,642
2016-02-28 17:00:00,34,7,42,83,498
2016-02-28 17:10:00,24,5,30,59,354
2016-02-28 17:20:00,10,7,22,39,234
2016-02-28 17:30:00,4,0,7,11,66
2016-02-28 17:40:00,0,0,0,0,0
2016-02-28 17:50:00,0,0,0,0,0
2016-02-28 18:00:00,0,0,0,0,0
2016-02-29 06:40:00,0,0,0,0,0
2016-02-29 06:50:00,0,0,0,0,0
2016-02-29 07:00:00,0,0,0,0,0
2016-02-29 07:10:00,0,0,0,0,0
2016-02-29 07:20:00,0,0,0,0,0
2016-02-29 07:30:00,1,0,1,2,12
2016-02-29 07:40:00,7,2,17,26,156
2016-02-29 07:50:00,5,4,26,35,210
2016-02-29 08:00:00,8,11,30,49,294
2016-02-29 08:10:00,8,17,35,60,360
2016-02-29 08:20:00,10,18,45,73,438
2016-02-29 08:30:00,18,15,43,76,456
2016-02-29 08:40:00,22,19,66,107,642
2016-02-29 08:50:00,19,37,87,143,858
2016-02-29 09:00:00,51,74,75,200,1200
2016-02-29 09:10:00,9,118,121,248,1488
2016-02-29 09:20:00,11,136,142,289,1734
2016-02-29 09:30:00,32,147,165,344,2064
2016-02-29 09:40:00,120,167,154,441,2646
2016-02-29 09:50:00,155,149,202,506,3036
2016-02-29 10:00:00,300,266,292,858,5148
2016-02-29 10:10:00,215,185,207,607,3642
2016-02-29 10:20:00,206,135,192,533,3198
2016-02-29 10:30:00,317,180,143,640,3840
2016-02-29 10:40:00,231,184,249,664,3984
2016-02-29 10:50:00,267,191,174,632,3792
2016-02-29 11:00:00,256,205,212,673,4038
2016-02-29 11:10:00,223,196,216,635,3810
2016-02-29 11:20:00,365,334,356,1055,6330
2016-02-29 11:30:00,244,218,238,700,4200
2016-02-29 11:40:00,263,238,255,756,4536
2016-02-29 11:50:00,299,266,290,855,5130
2016-02-29 12:00:00,325,291,315,931,5586
2016-02-29 12:10:00,303,274,295,872,5232
2016-02-29 12:20:00,442,414,434,1290,7740
2016-02-29 12:30:00,506,476,498,1480,8880
2016-02-29 12:40:00,649,616,634,1899,11394
2016-02-29 12:50:00,319,292,311,922,5532
2016-02-29 13:00:00,331,302,326,959,5754
2016-02-29 13:10:00,887,842,882,2611,15666
2016-02-29 13:20:00,683,645,676,2004,12024
2016-02-29 13:30:00,924,883,931,2738,16428
2016-02-29 13:40:00,801,763,802,2366,14196
2016-02-29 13:50:00,620,587,617,1824,10944
2016-02-29 14:00:00,328,299,322,949,5694
2016-02-29 14:10:00,392,363,389,1144,6864
2016-02-29 14:20:00,666,629,659,1954,11724
2016-02-29 14:30:00,722,688,716,2126,12756
2016-02-29 14:40:00,645,615,640,1900,11400
2016-02-29 14:50:00,586,554,580,1720,10320
2016-02-29 15:00:00,507,475,497,1479,8874
2016-02-29 15:10:00,368,343,359,1070,6420
2016-02-29 15:20:00,344,314,333,991,5946
2016-02-29 15:30:00,367,337,362,1066,6396
2016-02-29 15:40:00,301,273,296,870,5220
2016-02-29 15:50:00,256,227,248,731,4386
2016-02-29 16:00:00,217,188,209,614,3684
2016-02-29 16:10:00,169,141,160,470,2820
2016-02-29 16:20:00,142,60,134,336,2016
2016-02-29 16:30:00,45,63,108,216,1296
2016-02-29 16:40:00,36,39,73,148,888
2016-02-29 16:50:00,16,20,89,125,750
2016-02-29 17:00:00,23,27,49,99,594
2016-02-29 17:10:00,18,10,37,65,390
2016-02-29 17:20:00,11,4,17,32,192
2016-02-29 17:30:00,5,0,8,13,78
2016-02-29 17:40:00,0,0,0,0,0
2016-02-29 17:50:00,0,0,0,0,0
2016-02-29 18:00:00,0,0,0,0,0
2016-03-01 06:40:00,0,0,0,0,0
2016-03-01 06:50:00,0,0,0,0,0
2016-03-01 07:00:00,0,0,0,0,0
2016-03-01 07:10:00,0,0,0,0,0
2016-03-01 07:20:00,0,0,0,0,0
2016-03-01 07:30:00,1,0,2,3,18
2016-03-01 07:40:00,6,0,9,15,90
2016-03-01 07:50:00,9,4,17,30,180
2016-03-01 08:00:00,8,11,29,48,288
2016-03-01 08:10:00,22,19,46,87,522
2016-03-01 08:20:00,23,20,46,89,534
2016-03-01 08:30:00,52,23,63,138,828
2016-03-01 08:40:00,52,29,71,152,912
2016-03-01 08:50:00,29,92,107,228,1368
2016-03-01 09:00:00,24,80,101,205,1230
2016-03-01 09:10:00,26,96,111,233,1398
2016-03-01 09:20:00,25,133,153,311,1866
2016-03-01 09:30:00,8,138,145,291,1746
2016-03-01 09:40:00,4,140,150,294,1764
2016-03-01 09:50:00,56,135,150,341,2046
2016-03-01 10:00:00,20,130,166,316,1896
2016-03-01 10:10:00,183,137,199,519,3114
2016-03-01 10:20:00,166,137,155,458,2748
2016-03-01 10:30:00,166,142,158,466,2796
2016-03-01 10:40:00,182,127,178,487,2922
2016-03-01 10:50:00,323,294,316,933,5598
2016-03-01 11:00:00,250,222,241,713,4278
2016-03-01 11:10:00,420,389,410,1219,7314
2016-03-01 11:20:00,273,246,264,783,4698
2016-03-01 11:30:00,230,204,222,656,3936
2016-03-01 11:40:00,223,197,216,636,3816
2016-03-01 11:50:00,204,177,164,545,3270
2016-03-01 12:00:00,242,179,135,556,3336
2016-03-01 12:10:00,227,196,142,565,3390
2016-03-01 12:20:00,237,131,225,593,3558
2016-03-01 12:30:00,327,168,122,617,3702
2016-03-01 12:40:00,277,129,165,571,3426
2016-03-01 12:50:00,222,165,232,619,3714
2016-03-01 13:00:00,233,204,225,662,3972
2016-03-01 13:10:00,183,111,219,513,3078
2016-03-01 13:20:00,104,122,250,476,2856
2016-03-01 13:30:00,74,200,156,430,2580
2016-03-01 13:40:00,105,91,196,392,2352
2016-03-01 13:50:00,67,134,140,341,2046
2016-03-01 14:00:00,50,132,178,360,2160
2016-03-01 14:10:00,8,141,151,300,1800
2016-03-01 14:20:00,115,92,143,350,2100
2016-03-01 14:30:00,117,102,137,356,2136
2016-03-01 14:40:00,66,154,155,375,2250
2016-03-01 14:50:00,41,105,113,259,1554
2016-03-01 15:00:00,37,108,125,270,1620
2016-03-01 15:10:00,105,98,124,327,1962
2016-03-01 15:20:00,70,95,114,279,1674
2016-03-01 15:30:00,35,105,106,246,1476
2016-03-01 15:40:00,9,125,123,257,1542
2016-03-01 15:50:00,55,68,80,203,1218
2016-03-01 16:00:00,34,44,77,155,930
2016-03-01 16:10:00,46,22,54,122,732
2016-03-01 16:20:00,24,8,52,84,504
2016-03-01 16:30:00,23,12,37,72,432
2016-03-01 16:40:00,16,10,30,56,336
2016-03-01 16:50:00,15,6,19,40,240
2016-03-01 17:00:00,11,4,16,31,186
2016-03-01 17:10:00,3,1,6,10,60
2016-03-01 17:20:00,0,0,0,0,0
2016-03-01 17:30:00,0,0,0,0,0
2016-03-01 17:40:00,0,0,0,0,0
2016-03-01 17:50:00,0,0,0,0,0
2016-03-02 07:00:00,0,0,0,0,0
2016-03-02 07:10:00,0,0,0,0,0
2016-03-02 07:20:00,0,0,0,0,0
2016-03-02 07:30:00,0,0,0,0,0
2016-03-02 07:40:00,0,0,0,0,0
2016-03-02 07:50:00,0,0,0,0,0
2016-03-02 08:00:00,0,0,0,0,0
2016-03-02 08:10:00,1,0,1,2,12
2016-03-02 08:20:00,3,1,4,8,48
2016-03-02 08:30:00,8,2,14,24,144
2016-03-02 08:40:00,8,2,11,21,126
2016-03-02 08:50:00,12,5,14,31,186
2016-03-02 09:00:00,10,9,23,42,252
2016-03-02 09:10:00,11,11,27,49,294
2016-03-02 09:20:00,13,17,37,67,402
2016-03-02 09:30:00,14,16,39,69,414
2016-03-02 09:40:00,15,16,43,74,444
2016-03-02 09:50:00,20,12,39,71,426
2016-03-02 10:00:00,16,13,35,64,384
2016-03-02 10:10:00,19,21,46,86,516
2016-03-02 10:20:00,14,27,63,104,624
2016-03-02 10:30:00,30,18,68,116,696
2016-03-02 10:40:00,26,18,52,96,576
2016-03-02 10:50:00,26,11,40,77,462
2016-03-02 11:00:00,25,16,43,84,504
2016-03-02 11:10:00,25,30,62,117,702
2016-03-02 11:20:00,34,45,75,154,924
2016-03-02 11:30:00,40,58,89,187,1122
2016-03-02 11:40:00,40,71,93,204,1224
2016-03-02 11:50:00,23,61,83,167,1002
2016-03-02 12:00:00,24,33,60,117,702
2016-03-02 12:10:00,22,67,87,176,1056
2016-03-02 12:20:00,33,56,81,170,1020
2016-03-02 12:30:00,27,87,108,222,1332
2016-03-02 12:40:00,16,104,117,237,1422
2016-03-02 12:50:00,28,64,88,180,1080
2016-03-02 13:00:00,19,107,121,247,1482
2016-03-02 13:10:00,22,117,134,273,1638
2016-03-02 13:20:00,61,124,152,337,2022
2016-03-02 13:30:00,14,134,146,294,1764
2016-03-02 13:40:00,2,149,160,311,1866
2016-03-02 13:50:00,37,130,152,319,1914
2016-03-02 14:00:00,38,125,148,311,1866
2016-03-02 14:10:00,2,148,157,307,1842
2016-03-02 14:20:00,0,139,142,281,1686
2016-03-02 14:30:00,0,137,135,272,1632
2016-03-02 14:40:00,12,115,127,254,1524
2016-03-02 14:50:00,26,133,141,300,1800
2016-03-02 15:00:00,26,133,147,306,1836
2016-03-02 15:10:00,47,90,125,262,1572
2016-03-02 15:20:00,32,105,118,255,1530
2016-03-02 15:30:00,43,137,180,360,2160
2016-03-02 15:40:00,44,111,131,286,1716
2016-03-02 15:50:00,59,63,90,212,1272
2016-03-02 16:00:00,45,55,78,178,1068
2016-03-02 16:10:00,47,42,91,180,1080
2016-03-02 16:20:00,24,20,48,92,552
2016-03-02 16:30:00,22,11,39,72,432
2016-03-02 16:40:00,8,3,12,23,138
2016-03-02 16:50:00,0,0,1,1,6
2016-03-02 17:00:00,0,0,0,0,0
2016-03-02 17:10:00,0,0,0,0,0
2016-03-02 17:20:00,0,0,0,0,0
2016-03-02 17:30:00,0,0,0,0,0
2016-03-02 17:40:00,0,0,0,0,0
2016-03-03 06:40:00,0,0,0,0,0
2016-03-03 06:50:00,0,0,0,0,0
2016-03-03 07:00:00,0,0,0,0,0
2016-03-03 07:10:00,0,0,0,0,0
2016-03-03 07:20:00,0,0,1,1,6
2016-03-03 07:30:00,6,1,9,16,96
2016-03-03 07:40:00,10,7,22,39,234
2016-03-03 07:50:00,14,15,36,65,390
2016-03-03 08:00:00,7,17,50,74,444
2016-03-03 08:10:00,9,28,50,87,522
2016-03-03 08:20:00,25,27,56,108,648
2016-03-03 08:30:00,17,56,77,150,900
2016-03-03 08:40:00,30,81,91,202,1212
2016-03-03 08:50:00,47,91,96,234,1404
2016-03-03 09:00:00,9,141,148,298,1788
2016-03-03 09:10:00,89,95,195,379,2274
2016-03-03 09:20:00,216,168,220,604,3624
2016-03-03 09:30:00,244,211,230,685,4110
2016-03-03 09:40:00,271,240,258,769,4614
2016-03-03 09:50:00,327,289,312,928,5568
2016-03-03 10:00:00,419,382,410,1211,7266
2016-03-03 10:10:00,447,411,435,1293,7758
2016-03-03 10:20:00,413,381,403,1197,7182
2016-03-03 10:30:00,462,427,447,1336,8016
2016-03-03 10:40:00,494,462,482,1438,8628
2016-03-03 10:50:00,485,452,473,1410,8460
2016-03-03 11:00:00,458,415,442,1315,7890
2016-03-03 11:10:00,488,450,474,1412,8472
2016-03-03 11:20:00,437,402,426,1265,7590
2016-03-03 11:30:00,443,406,433,1282,7692
2016-03-03 11:40:00,476,441,463,1380,8280
2016-03-03 11:50:00,443,409,434,1286,7716
2016-03-03 12:00:00,403,368,392,1163,6978
2016-03-03 12:10:00,392,361,385,1138,6828
2016-03-03 12:20:00,384,355,380,1119,6714
2016-03-03 12:30:00,350,326,349,1025,6150
2016-03-03 12:40:00,339,315,337,991,5946
2016-03-03 12:50:00,367,342,361,1070,6420
2016-03-03 13:00:00,416,385,407,1208,7248
2016-03-03 13:10:00,408,380,402,1190,7140
2016-03-03 13:20:00,532,501,520,1553,9318
2016-03-03 13:30:00,397,370,387,1154,6924
2016-03-03 13:40:00,335,309,327,971,5826
2016-03-03 13:50:00,306,277,296,879,5274
2016-03-03 14:00:00,305,274,296,875,5250
2016-03-03 14:10:00,300,271,292,863,5178
2016-03-03 14:20:00,286,256,276,818,4908
2016-03-03 14:30:00,272,244,264,780,4680
2016-03-03 14:40:00,256,228,247,731,4386
2016-03-03 14:50:00,269,243,261,773,4638
2016-03-03 15:00:00,284,257,276,817,4902
2016-03-03 15:10:00,276,247,268,791,4746
2016-03-03 15:20:00,264,234,254,752,4512
2016-03-03 15:30:00,216,189,208,613,3678
2016-03-03 15:40:00,198,172,189,559,3354
2016-03-03 15:50:00,176,89,161,426,2556
2016-03-03 16:00:00,62,108,153,323,1938
2016-03-03 16:10:00,31,105,115,251,1506
2016-03-03 16:20:00,4,127,122,253,1518
2016-03-03 16:30:00,6,116,121,243,1458
2016-03-03 16:40:00,46,80,93,219,1314
2016-03-03 16:50:00,9,86,96,191,1146
2016-03-03 17:00:00,17,53,74,144,864
2016-03-03 17:10:00,12,19,41,72,432
2016-03-03 17:20:00,10,10,27,47,282
2016-03-03 17:30:00,11,5,18,34,204
2016-03-03 17:40:00,0,0,1,1,6
2016-03-03 17:50:00,0,0,0,0,0
2016-03-03 18:00:00,0,0,0,0,0
2016-03-04 06:40:00,0,0,0,0,0
2016-03-04 06:50:00,0,0,0,0,0
2016-03-04 07:00:00,0,0,0,0,0
2016-03-04 07:10:00,0,0,0,0,0
2016-03-04 07:20:00,0,0,0,0,0
2016-03-04 07:30:00,0,0,1,1,6
2016-03-04 07:40:00,2,0,6,8,48
2016-03-04 07:50:00,5,2,15,22,132
2016-03-04 08:00:00,7,17,34,58,348
2016-03-04 08:10:00,8,24,42,74,444
2016-03-04 08:20:00,16,33,65,114,684
2016-03-04 08:30:00,62,75,101,238,1428
2016-03-04 08:40:00,106,97,137,340,2040
2016-03-04 08:50:00,151,100,191,442,2652
2016-03-04 09:00:00,98,128,182,408,2448
2016-03-04 09:10:00,202,171,190,563,3378
2016-03-04 09:20:00,217,192,208,617,3702
2016-03-04 09:30:00,321,291,313,925,5550
2016-03-04 09:40:00,585,559,590,1734,10404
2016-03-04 09:50:00,678,653,681,2012,12072
2016-03-04 10:00:00,721,692,722,2135,12810
2016-03-04 10:10:00,733,703,729,2165,12990
2016-03-04 10:20:00,765,732,763,2260,13560
2016-03-04 10:30:00,564,531,557,1652,9912
2016-03-04 10:40:00,851,812,843,2506,15036
2016-03-04 10:50:00,519,480,508,1507,9042
2016-03-04 11:00:00,480,452,476,1408,8448
2016-03-04 11:10:00,596,566,590,1752,10512
2016-03-04 11:20:00,292,264,283,839,5034
2016-03-04 11:30:00,234,208,226,668,4008
2016-03-04 11:40:00,226,199,215,640,3840
2016-03-04 11:50:00,366,335,350,1051,6306
2016-03-04 12:00:00,918,880,891,2689,16134
2016-03-04 12:10:00,529,496,512,1537,9222
2016-03-04 12:20:00,271,243,259,773,4638
2016-03-04 12:30:00,297,269,287,853,5118
2016-03-04 12:40:00,206,182,199,587,3522
2016-03-04 12:50:00,246,223,241,710,4260
2016-03-04 13:00:00,274,246,266,786,4716
2016-03-04 13:10:00,200,175,196,571,3426
2016-03-04 13:20:00,189,90,229,508,3048
2016-03-04 13:30:00,254,192,221,667,4002
2016-03-04 13:40:00,249,223,240,712,4272
2016-03-04 13:50:00,113,95,119,327,1962
2016-03-04 14:00:00,106,138,154,398,2388
2016-03-04 14:10:00,112,88,254,454,2724
2016-03-04 14:20:00,245,77,212,534,3204
2016-03-04 14:30:00,245,101,177,523,3138
2016-03-04 14:40:00,13,142,156,311,1866
2016-03-04 14:50:00,117,142,140,399,2394
2016-03-04 15:00:00,109,162,184,455,2730
2016-03-04 15:10:00,174,132,295,601,3606
2016-03-04 15:20:00,165,89,231,485,2910
2016-03-04 15:30:00,28,36,66,130,780
2016-03-04 15:40:00,32,18,54,104,624
2016-03-04 15:50:00,20,13,85,118,708
2016-03-04 16:00:00,29,26,55,110,660
2016-03-04 16:10:00,39,13,50,102,612
2016-03-04 16:20:00,31,21,51,103,618
2016-03-04 16:30:00,28,16,65,109,654
2016-03-04 16:40:00,41,25,78,144,864
2016-03-04 16:50:00,59,23,78,160,960
2016-03-04 17:00:00,35,16,53,104,624
2016-03-04 17:10:00,14,12,33,59,354
2016-03-04 17:20:00,12,6,19,37,222
2016-03-04 17:30:00,4,1,7,12,72
2016-03-04 17:40:00,0,0,0,0,0
2016-03-04 17:50:00,0,0,0,0,0
2016-03-04 18:00:00,0,0,0,0,0
2016-03-04 18:10:00,0,0,0,0,0
2016-03-05 06:50:00,0,0,0,0,0
2016-03-05 07:00:00,0,0,0,0,0
2016-03-05 07:10:00,0,0,0,0,0
2016-03-05 07:20:00,0,0,0,0,0
2016-03-05 07:30:00,0,0,0,0,0
2016-03-05 07:40:00,0,0,0,0,0
2016-03-05 07:50:00,0,0,0,0,0
2016-03-05 08:00:00,0,0,0,0,0
2016-03-05 08:10:00,6,3,7,16,96
2016-03-05 08:20:00,13,10,26,49,294
2016-03-05 08:30:00,19,13,37,69,414
2016-03-05 08:40:00,21,11,36,68,408
2016-03-05 08:50:00,10,10,26,46,276
2016-03-05 09:00:00,14,9,29,52,312
2016-03-05 09:10:00,22,22,46,90,540
2016-03-05 09:20:00,31,30,68,129,774
2016-03-05 09:30:00,35,29,43,107,642
2016-03-05 09:40:00,21,20,46,87,522
2016-03-05 09:50:00,22,43,61,126,756
2016-03-05 10:00:00,22,48,73,143,858
2016-03-05 10:10:00,25,27,54,106,636
2016-03-05 10:20:00,31,16,53,100,600
2016-03-05 10:30:00,30,41,57,128,768
2016-03-05 10:40:00,24,29,56,109,654
2016-03-05 10:50:00,16,25,50,91,546
2016-03-05 11:00:00,12,23,48,83,498
2016-03-05 11:10:00,16,18,41,75,450
2016-03-05 11:20:00,12,9,52,73,438
2016-03-05 11:30:00,30,11,42,83,498
2016-03-05 11:40:00,25,8,40,73,438
2016-03-05 11:50:00,19,13,39,71,426
2016-03-05 12:00:00,15,9,28,52,312
2016-03-05 12:10:00,13,9,26,48,288
2016-03-05 12:20:00,16,13,36,65,390
2016-03-05 12:30:00,26,30,57,113,678
2016-03-05 12:40:00,33,27,67,127,762
2016-03-05 12:50:00,35,25,66,126,756
2016-03-05 13:00:00,56,32,79,167,1002
2016-03-05 13:10:00,48,58,95,201,1206
2016-03-05 13:20:00,56,30,82,168,1008
2016-03-05 13:30:00,76,11,85,172,1032
2016-03-05 13:40:00,33,19,53,105,630
2016-03-05 13:50:00,22,19,44,85,510
2016-03-05 14:00:00,16,20,43,79,474
2016-03-05 14:10:00,11,8,24,43,258
2016-03-05 14:20:00,6,7,26,39,234
2016-03-05 14:30:00,10,7,24,41,246
2016-03-05 14:40:00,9,11,30,50,300
2016-03-05 14:50:00,7,5,23,35,210
2016-03-05 15:00:00,7,6,21,34,204
2016-03-05 15:10:00,7,6,21,34,204
2016-03-05 15:20:00,7,4,13,24,144
2016-03-05 15:30:00,5,3,21,29,174
2016-03-05 15:40:00,7,5,23,35,210
2016-03-05 15:50:00,11,3,16,30,180
2016-03-05 16:00:00,9,7,22,38,228
2016-03-05 16:10:00,6,1,13,20,120
2016-03-05 16:20:00,2,1,17,20,120
2016-03-05 16:30:00,0,0,7,7,42
2016-03-05 16:40:00,0,0,1,1,6
2016-03-05 16:50:00,0,0,0,0,0
2016-03-05 17:00:00,0,0,0,0,0
2016-03-05 17:10:00,0,0,0,0,0
2016-03-05 17:20:00,0,0,0,0,0
2016-03-05 17:30:00,0,0,0,0,0
2016-03-05 17:40:00,0,0,0,0,0
2016-03-05 17:50:00,0,0,0,0,0
2016-03-06 06:40:00,0,0,0,0,0
2016-03-06 06:50:00,0,0,0,0,0
2016-03-06 07:00:00,0,0,0,0,0
2016-03-06 07:10:00,0,0,0,0,0
2016-03-06 07:20:00,0,0,0,0,0
2016-03-06 07:30:00,0,0,0,0,0
2016-03-06 07:40:00,0,0,0,0,0
2016-03-06 07:50:00,1,0,2,3,18
2016-03-06 08:00:00,6,2,15,23,138
2016-03-06 08:10:00,8,3,17,28,168
2016-03-06 08:20:00,7,10,28,45,270
2016-03-06 08:30:00,11,14,37,62,372
2016-03-06 08:40:00,9,20,45,74,444
2016-03-06 08:50:00,12,23,47,82,492
2016-03-06 09:00:00,15,27,54,96,576
2016-03-06 09:10:00,14,30,56,100,600
2016-03-06 09:20:00,19,28,65,112,672
2016-03-06 09:30:00,24,29,59,112,672
2016-03-06 09:40:00,44,34,70,148,888
2016-03-06 09:50:00,52,54,88,194,1164
2016-03-06 10:00:00,54,51,91,196,1176
2016-03-06 10:10:00,28,60,88,176,1056
2016-03-06 10:20:00,14,72,92,178,1068
2016-03-06 10:30:00,39,53,87,179,1074
2016-03-06 10:40:00,28,62,84,174,1044
2016-03-06 10:50:00,17,73,97,187,1122
2016-03-06 11:00:00,34,86,107,227,1362
2016-03-06 11:10:00,41,80,104,225,1350
2016-03-06 11:20:00,26,93,110,229,1374
2016-03-06 11:30:00,3,126,130,259,1554
2016-03-06 11:40:00,9,117,127,253,1518
2016-03-06 11:50:00,10,129,131,270,1620
2016-03-06 12:00:00,0,130,137,267,1602
2016-03-06 12:10:00,19,132,113,264,1584
2016-03-06 12:20:00,2,120,127,249,1494
2016-03-06 12:30:00,0,119,129,248,1488
2016-03-06 12:40:00,0,128,128,256,1536
2016-03-06 12:50:00,79,68,108,255,1530
2016-03-06 13:00:00,19,106,133,258,1548
2016-03-06 13:10:00,77,54,134,265,1590
2016-03-06 13:20:00,1,143,153,297,1782
2016-03-06 13:30:00,66,88,158,312,1872
2016-03-06 13:40:00,117,45,157,319,1914
2016-03-06 13:50:00,84,119,143,346,2076
2016-03-06 14:00:00,43,134,150,327,1962
2016-03-06 14:10:00,0,131,134,265,1590
2016-03-06 14:20:00,0,124,128,252,1512
2016-03-06 14:30:00,0,123,127,250,1500
2016-03-06 14:40:00,0,127,135,262,1572
2016-03-06 14:50:00,0,133,140,273,1638
2016-03-06 15:00:00,0,134,141,275,1650
2016-03-06 15:10:00,0,130,138,268,1608
2016-03-06 15:20:00,5,114,127,246,1476
2016-03-06 15:30:00,4,103,132,239,1434
2016-03-06 15:40:00,21,94,118,233,1398
2016-03-06 15:50:00,40,71,106,217,1302
2016-03-06 16:00:00,39,57,87,183,1098
2016-03-06 16:10:00,23,40,82,145,870
2016-03-06 16:20:00,9,16,101,126,756
2016-03-06 16:30:00,17,23,72,112,672
2016-03-06 16:40:00,18,20,45,83,498
2016-03-06 16:50:00,20,20,45,85,510
2016-03-06 17:00:00,17,21,46,84,504
2016-03-06 17:10:00,15,12,27,54,324
2016-03-06 17:20:00,7,4,17,28,168
2016-03-06 17:30:00,2,0,4,6,36
2016-03-06 17:40:00,0,0,0,0,0
2016-03-06 17:50:00,0,0,0,0,0
2016-03-06 18:00:00,0,0,0,0,0
2016-03-07 06:40:00,0,0,0,0,0
2016-03-07 06:50:00,0,0,0,0,0
2016-03-07 07:00:00,0,0,0,0,0
2016-03-07 07:10:00,0,0,0,0,0
2016-03-07 07:20:00,0,0,0,0,0
2016-03-07 07:30:00,0,0,0,0,0
2016-03-07 07:40:00,1,0,2,3,18
2016-03-07 07:50:00,1,0,1,2,12
2016-03-07 08:00:00,2,0,3,5,30
2016-03-07 08:10:00,5,1,8,14,84
2016-03-07 08:20:00,12,4,16,32,192
2016-03-07 08:30:00,20,3,21,44,264
2016-03-07 08:40:00,17,2,17,36,216
2016-03-07 08:50:00,23,10,34,67,402
2016-03-07 09:00:00,27,37,70,134,804
2016-03-07 09:10:00,29,32,76,137,822
2016-03-07 09:20:00,33,30,62,125,750
2016-03-07 09:30:00,22,23,65,110,660
2016-03-07 09:40:00,25,53,80,158,948
2016-03-07 09:50:00,6,81,94,181,1086
2016-03-07 10:00:00,41,71,98,210,1260
2016-03-07 10:10:00,40,91,111,242,1452
2016-03-07 10:20:00,52,129,146,327,1962
2016-03-07 10:30:00,51,75,93,219,1314
2016-03-07 10:40:00,18,135,164,317,1902
2016-03-07 10:50:00,64,155,188,407,2442
2016-03-07 11:00:00,108,152,150,410,2460
2016-03-07 11:10:00,23,133,151,307,1842
2016-03-07 11:20:00,21,111,122,254,1524
2016-03-07 11:30:00,32,87,105,224,1344
2016-03-07 11:40:00,23,62,88,173,1038
2016-03-07 11:50:00,11,110,125,246,1476
2016-03-07 12:00:00,16,112,127,255,1530
2016-03-07 12:10:00,23,91,117,231,1386
2016-03-07 12:20:00,71,108,194,373,2238
2016-03-07 12:30:00,82,110,177,369,2214
2016-03-07 12:40:00,172,142,159,473,2838
2016-03-07 12:50:00,332,232,232,796,4776
2016-03-07 13:00:00,620,586,616,1822,10932
2016-03-07 13:10:00,852,810,845,2507,15042
2016-03-07 13:20:00,479,445,470,1394,8364
2016-03-07 13:30:00,831,792,822,2445,14670
2016-03-07 13:40:00,585,552,578,1715,10290
2016-03-07 13:50:00,597,560,585,1742,10452
2016-03-07 14:00:00,727,677,709,2113,12678
2016-03-07 14:10:00,667,621,654,1942,11652
2016-03-07 14:20:00,567,534,558,1659,9954
2016-03-07 14:30:00,360,331,349,1040,6240
2016-03-07 14:40:00,258,230,249,737,4422
2016-03-07 14:50:00,189,164,182,535,3210
2016-03-07 15:00:00,196,171,189,556,3336
2016-03-07 15:10:00,204,178,197,579,3474
2016-03-07 15:20:00,207,182,199,588,3528
2016-03-07 15:30:00,202,175,195,572,3432
2016-03-07 15:40:00,220,192,212,624,3744
2016-03-07 15:50:00,130,134,159,423,2538
2016-03-07 16:00:00,41,140,152,333,1998
2016-03-07 16:10:00,33,71,97,201,1206
2016-03-07 16:20:00,36,124,145,305,1830
2016-03-07 16:30:00,17,71,91,179,1074
2016-03-07 16:40:00,6,77,92,175,1050
2016-03-07 16:50:00,21,28,85,134,804
2016-03-07 17:00:00,36,39,70,145,870
2016-03-07 17:10:00,19,12,34,65,390
2016-03-07 17:20:00,8,3,14,25,150
2016-03-07 17:30:00,5,3,7,15,90
2016-03-07 17:40:00,1,0,2,3,18
2016-03-07 17:50:00,0,0,0,0,0
2016-03-07 18:00:00,0,0,0,0,0
2016-03-07 18:10:00,0,0,0,0,0
2016-03-08 06:20:00,0,0,0,0,0
2016-03-08 06:30:00,0,0,0,0,0
2016-03-08 06:40:00,0,0,0,0,0
2016-03-08 06:50:00,0,0,0,0,0
2016-03-08 07:00:00,2,1,5,8,48
2016-03-08 07:10:00,6,8,29,43,258
2016-03-08 07:20:00,7,18,37,62,372
2016-03-08 07:30:00,9,29,54,92,552
2016-03-08 07:40:00,16,55,77,148,888
2016-03-08 07:50:00,30,69,95,194,1164
2016-03-08 08:00:00,33,64,96,193,1158
2016-03-08 08:10:00,30,90,119,239,1434
2016-03-08 08:20:00,27,85,114,226,1356
2016-03-08 08:30:00,33,83,114,230,1380
2016-03-08 08:40:00,23,73,127,223,1338
2016-03-08 08:50:00,23,135,162,320,1920
2016-03-08 09:00:00,89,162,169,420,2520
2016-03-08 09:10:00,268,153,178,599,3594
2016-03-08 09:20:00,256,214,277,747,4482
2016-03-08 09:30:00,262,234,253,749,4494
2016-03-08 09:40:00,281,250,271,802,4812
2016-03-08 09:50:00,228,199,221,648,3888
2016-03-08 10:00:00,228,201,219,648,3888
2016-03-08 10:10:00,253,227,246,726,4356
2016-03-08 10:20:00,250,222,242,714,4284
2016-03-08 10:30:00,168,142,161,471,2826
2016-03-08 10:40:00,262,234,255,751,4506
2016-03-08 10:50:00,268,232,248,748,4488
2016-03-08 11:00:00,296,267,287,850,5100
2016-03-08 11:10:00,358,327,350,1035,6210
2016-03-08 11:20:00,387,354,378,1119,6714
2016-03-08 11:30:00,271,241,262,774,4644
2016-03-08 11:40:00,241,211,231,683,4098
2016-03-08 11:50:00,243,213,233,689,4134
2016-03-08 12:00:00,354,321,342,1017,6102
2016-03-08 12:10:00,516,477,502,1495,8970
2016-03-08 12:20:00,447,411,434,1292,7752
2016-03-08 12:30:00,438,406,426,1270,7620
2016-03-08 12:40:00,350,317,339,1006,6036
2016-03-08 12:50:00,300,269,293,862,5172
2016-03-08 13:00:00,384,349,374,1107,6642
2016-03-08 13:10:00,678,635,665,1978,11868
2016-03-08 13:20:00,448,414,436,1298,7788
2016-03-08 13:30:00,568,530,552,1650,9900
2016-03-08 13:40:00,331,299,320,950,5700
2016-03-08 13:50:00,214,188,205,607,3642
2016-03-08 14:00:00,216,189,208,613,3678
2016-03-08 14:10:00,300,225,201,726,4356
2016-03-08 14:20:00,346,317,336,999,5994
2016-03-08 14:30:00,384,354,371,1109,6654
2016-03-08 14:40:00,313,286,304,903,5418
2016-03-08 14:50:00,274,247,264,785,4710
2016-03-08 15:00:00,285,257,276,818,4908
2016-03-08 15:10:00,260,235,253,748,4488
2016-03-08 15:20:00,176,151,169,496,2976
2016-03-08 15:30:00,109,86,101,296,1776
2016-03-08 15:40:00,98,74,89,261,1566
2016-03-08 15:50:00,51,62,77,190,1140
2016-03-08 16:00:00,31,54,85,170,1020
2016-03-08 16:10:00,43,46,90,179,1074
2016-03-08 16:20:00,35,44,76,155,930
2016-03-08 16:30:00,24,25,73,122,732
2016-03-08 16:40:00,23,16,44,83,498
2016-03-08 16:50:00,14,9,27,50,300
2016-03-08 17:00:00,11,2,17,30,180
2016-03-08 17:10:00,7,1,10,18,108
2016-03-08 17:20:00,5,2,9,16,96
2016-03-08 17:30:00,1,0,1,2,12
2016-03-08 17:40:00,0,0,0,0,0
2016-03-08 17:50:00,0,0,0,0,0
2016-03-08 18:00:00,0,0,0,0,0
2016-03-09 06:20:00,0,0,0,0,0
2016-03-09 06:30:00,0,0,0,0,0
2016-03-09 06:40:00,0,0,0,0,0
2016-03-09 06:50:00,0,0,0,0,0
2016-03-09 07:00:00,1,0,2,3,18
2016-03-09 07:10:00,6,1,7,14,84
2016-03-09 07:20:00,9,1,12,22,132
2016-03-09 07:30:00,10,6,21,37,222
2016-03-09 07:40:00,10,3,13,26,156
2016-03-09 07:50:00,9,2,13,24,144
2016-03-09 08:00:00,14,7,24,45,270
2016-03-09 08:10:00,12,9,26,47,282
2016-03-09 08:20:00,23,11,35,69,414
2016-03-09 08:30:00,18,11,35,64,384
2016-03-09 08:40:00,35,27,65,127,762
2016-03-09 08:50:00,36,28,67,131,786
2016-03-09 09:00:00,27,38,69,134,804
2016-03-09 09:10:00,50,48,84,182,1092
2016-03-09 09:20:00,11,111,123,245,1470
2016-03-09 09:30:00,0,136,142,278,1668
2016-03-09 09:40:00,39,132,154,325,1950
2016-03-09 09:50:00,58,129,159,346,2076
2016-03-09 10:00:00,44,134,180,358,2148
2016-03-09 10:10:00,187,170,197,554,3324
2016-03-09 10:20:00,216,137,177,530,3180
2016-03-09 10:30:00,191,108,190,489,2934
2016-03-09 10:40:00,83,106,209,398,2388
2016-03-09 10:50:00,234,178,257,669,4014
2016-03-09 11:00:00,363,328,353,1044,6264
2016-03-09 11:10:00,417,380,407,1204,7224
2016-03-09 11:20:00,583,546,577,1706,10236
2016-03-09 11:30:00,364,330,353,1047,6282
2016-03-09 11:40:00,498,467,488,1453,8718
2016-03-09 11:50:00,429,397,418,1244,7464
2016-03-09 12:00:00,683,646,673,2002,12012
2016-03-09 12:10:00,733,697,726,2156,12936
2016-03-09 12:20:00,871,836,855,2562,15372
2016-03-09 12:30:00,902,871,885,2658,15948
2016-03-09 12:40:00,959,926,945,2830,16980
2016-03-09 12:50:00,955,921,938,2814,16884
2016-03-09 13:00:00,948,907,927,2782,16692
2016-03-09 13:10:00,919,880,902,2701,16206
2016-03-09 13:20:00,928,886,915,2729,16374
2016-03-09 13:30:00,917,884,919,2720,16320
2016-03-09 13:40:00,904,875,906,2685,16110
2016-03-09 13:50:00,876,841,873,2590,15540
2016-03-09 14:00:00,835,800,830,2465,14790
2016-03-09 14:10:00,802,771,800,2373,14238
2016-03-09 14:20:00,767,737,757,2261,13566
2016-03-09 14:30:00,725,695,719,2139,12834
2016-03-09 14:40:00,675,646,674,1995,11970
2016-03-09 14:50:00,623,593,617,1833,10998
2016-03-09 15:00:00,585,550,579,1714,10284
2016-03-09 15:10:00,541,512,534,1587,9522
2016-03-09 15:20:00,485,469,491,1445,8670
2016-03-09 15:30:00,428,403,424,1255,7530
2016-03-09 15:40:00,347,321,342,1010,6060
2016-03-09 15:50:00,298,274,296,868,5208
2016-03-09 16:00:00,245,222,243,710,4260
2016-03-09 16:10:00,207,184,204,595,3570
2016-03-09 16:20:00,173,150,165,488,2928
2016-03-09 16:30:00,134,113,122,369,2214
2016-03-09 16:40:00,27,112,121,260,1560
2016-03-09 16:50:00,32,64,79,175,1050
2016-03-09 17:00:00,38,47,54,139,834
2016-03-09 17:10:00,27,25,52,104,624
2016-03-09 17:20:00,8,19,37,64,384
2016-03-09 17:30:00,6,6,21,33,198
2016-03-09 17:40:00,1,0,9,10,60
2016-03-09 17:50:00,0,0,0,0,0
2016-03-09 18:00:00,0,0,0,0,0
2016-03-09 18:10:00,0,0,0,0,0
2016-03-09 18:20:00,0,0,0,0,0
2016-03-10 06:20:00,0,0,0,0,0
2016-03-10 06:30:00,0,0,0,0,0
2016-03-10 06:40:00,0,0,0,0,0
2016-03-10 06:50:00,0,0,0,0,0
2016-03-10 07:00:00,0,0,0,0,0
2016-03-10 07:10:00,3,0,9,12,72
2016-03-10 07:20:00,4,5,24,33,198
2016-03-10 07:30:00,5,14,33,52,312
2016-03-10 07:40:00,10,29,49,88,528
2016-03-10 07:50:00,21,41,69,131,786
2016-03-10 08:00:00,36,86,104,226,1356
2016-03-10 08:10:00,12,120,125,257,1542
2016-03-10 08:20:00,24,139,148,311,1866
2016-03-10 08:30:00,25,140,145,310,1860
2016-03-10 08:40:00,20,133,145,298,1788
2016-03-10 08:50:00,22,101,117,240,1440
2016-03-10 09:00:00,30,94,115,239,1434
2016-03-10 09:10:00,34,84,103,221,1326
2016-03-10 09:20:00,2,129,136,267,1602
2016-03-10 09:30:00,3,140,148,291,1746
2016-03-10 09:40:00,0,144,152,296,1776
2016-03-10 09:50:00,16,144,159,319,1914
2016-03-10 10:00:00,55,138,168,361,2166
2016-03-10 10:10:00,204,202,231,637,3822
2016-03-10 10:20:00,289,259,278,826,4956
2016-03-10 10:30:00,238,208,227,673,4038
2016-03-10 10:40:00,242,215,234,691,4146
2016-03-10 10:50:00,277,199,179,655,3930
2016-03-10 11:00:00,215,152,201,568,3408
2016-03-10 11:10:00,227,170,174,571,3426
2016-03-10 11:20:00,280,202,258,740,4440
2016-03-10 11:30:00,264,230,254,748,4488
2016-03-10 11:40:00,294,258,279,831,4986
2016-03-10 11:50:00,262,227,249,738,4428
2016-03-10 12:00:00,287,251,275,813,4878
2016-03-10 12:10:00,306,266,291,863,5178
2016-03-10 12:20:00,325,290,313,928,5568
2016-03-10 12:30:00,212,186,203,601,3606
2016-03-10 12:40:00,145,60,271,476,2856
2016-03-10 12:50:00,201,152,245,598,3588
2016-03-10 13:00:00,164,138,156,458,2748
2016-03-10 13:10:00,129,63,268,460,2760
2016-03-10 13:20:00,136,101,220,457,2742
2016-03-10 13:30:00,62,121,168,351,2106
2016-03-10 13:40:00,25,146,192,363,2178
2016-03-10 13:50:00,32,129,168,329,1974
2016-03-10 14:00:00,0,144,153,297,1782
2016-03-10 14:10:00,0,130,134,264,1584
2016-03-10 14:20:00,58,83,93,234,1404
2016-03-10 14:30:00,62,73,76,211,1266
2016-03-10 14:40:00,48,77,88,213,1278
2016-03-10 14:50:00,27,74,92,193,1158
2016-03-10 15:00:00,29,56,67,152,912
2016-03-10 15:10:00,8,79,91,178,1068
2016-03-10 15:20:00,27,55,78,160,960
2016-03-10 15:30:00,28,78,93,199,1194
2016-03-10 15:40:00,28,56,77,161,966
2016-03-10 15:50:00,51,35,77,163,978
2016-03-10 16:00:00,29,18,66,113,678
2016-03-10 16:10:00,34,16,50,100,600
2016-03-10 16:20:00,35,19,52,106,636
2016-03-10 16:30:00,39,12,46,97,582
2016-03-10 16:40:00,30,16,72,118,708
2016-03-10 16:50:00,17,26,43,86,516
2016-03-10 17:00:00,6,9,20,35,210
2016-03-10 17:10:00,4,1,11,16,96
2016-03-10 17:20:00,3,0,7,10,60
2016-03-10 17:30:00,0,0,2,2,12
2016-03-10 17:40:00,0,0,0,0,0
2016-03-10 17:50:00,0,0,0,0,0
2016-03-10 18:00:00,0,0,0,0,0
2016-03-10 18:10:00,0,0,0,0,0
2016-03-11 06:20:00,0,0,0,0,0
2016-03-11 06:30:00,0,0,0,0,0
2016-03-11 06:40:00,0,0,0,0,0
2016-03-11 06:50:00,0,0,0,0,0
2016-03-11 07:00:00,0,0,0,0,0
2016-03-11 07:10:00,1,0,2,3,18
2016-03-11 07:20:00,6,1,9,16,96
2016-03-11 07:30:00,9,7,23,39,234
2016-03-11 07:40:00,13,14,34,61,366
2016-03-11 07:50:00,11,16,37,64,384
2016-03-11 08:00:00,11,25,48,84,504
2016-03-11 08:10:00,15,28,56,99,594
2016-03-11 08:20:00,12,33,51,96,576
2016-03-11 08:30:00,13,29,51,93,558
2016-03-11 08:40:00,11,19,82,112,672
2016-03-11 08:50:00,21,43,75,139,834
2016-03-11 09:00:00,14,59,80,153,918
2016-03-11 09:10:00,17,72,93,182,1092
2016-03-11 09:20:00,12,127,135,274,1644
2016-03-11 09:30:00,0,134,142,276,1656
2016-03-11 09:40:00,11,141,148,300,1800
2016-03-11 09:50:00,153,40,298,491,2946
2016-03-11 10:00:00,179,168,144,491,2946
2016-03-11 10:10:00,165,151,155,471,2826
2016-03-11 10:20:00,214,168,219,601,3606
2016-03-11 10:30:00,344,319,337,1000,6000
2016-03-11 10:40:00,263,236,253,752,4512
2016-03-11 10:50:00,474,438,461,1373,8238
2016-03-11 11:00:00,221,197,213,631,3786
2016-03-11 11:10:00,283,258,276,817,4902
2016-03-11 11:20:00,425,395,417,1237,7422
2016-03-11 11:30:00,376,343,370,1089,6534
2016-03-11 11:40:00,327,301,322,950,5700
2016-03-11 11:50:00,515,485,505,1505,9030
2016-03-11 12:00:00,456,428,447,1331,7986
2016-03-11 12:10:00,426,396,417,1239,7434
2016-03-11 12:20:00,380,347,371,1098,6588
2016-03-11 12:30:00,276,249,273,798,4788
2016-03-11 12:40:00,321,293,316,930,5580
2016-03-11 12:50:00,611,578,603,1792,10752
2016-03-11 13:00:00,950,918,949,2817,16902
2016-03-11 13:10:00,945,916,940,2801,16806
2016-03-11 13:20:00,943,905,936,2784,16704
2016-03-11 13:30:00,811,776,798,2385,14310
2016-03-11 13:40:00,381,355,373,1109,6654
2016-03-11 13:50:00,263,232,245,740,4440
2016-03-11 14:00:00,248,222,239,709,4254
2016-03-11 14:10:00,297,237,228,762,4572
2016-03-11 14:20:00,294,268,287,849,5094
2016-03-11 14:30:00,351,326,349,1026,6156
2016-03-11 14:40:00,369,343,364,1076,6456
2016-03-11 14:50:00,469,439,459,1367,8202
2016-03-11 15:00:00,392,358,381,1131,6786
2016-03-11 15:10:00,279,249,270,798,4788
2016-03-11 15:20:00,247,218,233,698,4188
2016-03-11 15:30:00,183,158,176,517,3102
2016-03-11 15:40:00,180,62,197,439,2634
2016-03-11 15:50:00,100,79,211,390,2340
2016-03-11 16:00:00,97,109,148,354,2124
2016-03-11 16:10:00,94,127,144,365,2190
2016-03-11 16:20:00,56,90,116,262,1572
2016-03-11 16:30:00,29,91,104,224,1344
2016-03-11 16:40:00,36,89,102,227,1362
2016-03-11 16:50:00,70,24,89,183,1098
2016-03-11 17:00:00,38,46,82,166,996
2016-03-11 17:10:00,31,35,72,138,828
2016-03-11 17:20:00,26,18,45,89,534
2016-03-11 17:30:00,14,18,40,72,432
2016-03-11 17:40:00,10,9,25,44,264
2016-03-11 17:50:00,5,0,7,12,72
2016-03-11 18:00:00,0,0,0,0,0
2016-03-11 18:10:00,0,0,0,0,0
2016-03-11 18:20:00,0,0,0,0,0
2016-03-12 06:10:00,0,0,0,0,0
2016-03-12 06:20:00,0,0,0,0,0
2016-03-12 06:30:00,0,0,0,0,0
2016-03-12 06:40:00,0,0,0,0,0
2016-03-12 06:50:00,0,0,0,0,0
2016-03-12 07:00:00,4,0,5,9,54
2016-03-12 07:10:00,9,5,18,32,192
2016-03-12 07:20:00,8,11,27,46,276
2016-03-12 07:30:00,10,19,38,67,402
2016-03-12 07:40:00,17,22,51,90,540
2016-03-12 07:50:00,15,19,77,111,666
2016-03-12 08:00:00,31,31,75,137,822
2016-03-12 08:10:00,33,42,71,146,876
2016-03-12 08:20:00,11,77,89,177,1062
2016-03-12 08:30:00,30,75,90,195,1170
2016-03-12 08:40:00,40,97,105,242,1452
2016-03-12 08:50:00,82,94,71,247,1482
2016-03-12 09:00:00,68,85,92,245,1470
2016-03-12 09:10:00,34,91,108,233,1398
2016-03-12 09:20:00,27,85,121,233,1398
2016-03-12 09:30:00,51,73,94,218,1308
2016-03-12 09:40:00,25,129,139,293,1758
2016-03-12 09:50:00,66,137,154,357,2142
2016-03-12 10:00:00,75,109,137,321,1926
2016-03-12 10:10:00,1,139,148,288,1728
2016-03-12 10:20:00,69,116,169,354,2124
2016-03-12 10:30:00,159,105,169,433,2598
2016-03-12 10:40:00,101,107,163,371,2226
2016-03-12 10:50:00,125,99,171,395,2370
2016-03-12 11:00:00,170,49,237,456,2736
2016-03-12 11:10:00,191,77,260,528,3168
2016-03-12 11:20:00,212,112,181,505,3030
2016-03-12 11:30:00,175,0,317,492,2952
2016-03-12 11:40:00,251,106,208,565,3390
2016-03-12 11:50:00,266,154,182,602,3612
2016-03-12 12:00:00,181,119,162,462,2772
2016-03-12 12:10:00,210,80,235,525,3150
2016-03-12 12:20:00,225,30,279,534,3204
2016-03-12 12:30:00,174,0,317,491,2946
2016-03-12 12:40:00,177,0,323,500,3000
2016-03-12 12:50:00,267,132,168,567,3402
2016-03-12 13:00:00,190,26,291,507,3042
2016-03-12 13:10:00,180,0,331,511,3066
2016-03-12 13:20:00,215,183,192,590,3540
2016-03-12 13:30:00,270,248,261,779,4674
2016-03-12 13:40:00,298,274,284,856,5136
2016-03-12 13:50:00,249,226,235,710,4260
2016-03-12 14:00:00,251,228,241,720,4320
2016-03-12 14:10:00,268,244,258,770,4620
2016-03-12 14:20:00,250,227,240,717,4302
2016-03-12 14:30:00,218,195,209,622,3732
2016-03-12 14:40:00,226,202,216,644,3864
2016-03-12 14:50:00,264,238,256,758,4548
2016-03-12 15:00:00,280,255,276,811,4866
2016-03-12 15:10:00,194,170,189,553,3318
2016-03-12 15:20:00,218,191,184,593,3558
2016-03-12 15:30:00,171,29,274,474,2844
2016-03-12 15:40:00,113,182,167,462,2772
2016-03-12 15:50:00,88,134,169,391,2346
2016-03-12 16:00:00,0,135,143,278,1668
2016-03-12 16:10:00,24,115,122,261,1566
2016-03-12 16:20:00,16,115,119,250,1500
2016-03-12 16:30:00,47,67,87,201,1206
2016-03-12 16:40:00,33,49,81,163,978
2016-03-12 16:50:00,68,36,90,194,1164
2016-03-12 17:00:00,77,16,88,181,1086
2016-03-12 17:10:00,57,33,87,177,1062
2016-03-12 17:20:00,62,27,87,176,1056
2016-03-12 17:30:00,34,27,73,134,804
2016-03-12 17:40:00,22,26,71,119,714
2016-03-12 17:50:00,15,13,32,60,360
2016-03-12 18:00:00,8,2,10,20,120
2016-03-12 18:10:00,0,0,0,0,0
2016-03-12 18:20:00,0,0,0,0,0
2016-03-13 06:10:00,0,0,0,0,0
2016-03-13 06:20:00,0,0,0,0,0
2016-03-13 06:30:00,0,0,0,0,0
2016-03-13 06:40:00,0,0,0,0,0
2016-03-13 06:50:00,1,0,1,2,12
2016-03-13 07:00:00,5,1,9,15,90
2016-03-13 07:10:00,10,4,16,30,180
2016-03-13 07:20:00,11,8,25,44,264
2016-03-13 07:30:00,12,18,40,70,420
2016-03-13 07:40:00,12,26,51,89,534
2016-03-13 07:50:00,18,31,52,101,606
2016-03-13 08:00:00,30,26,58,114,684
2016-03-13 08:10:00,28,52,79,159,954
2016-03-13 08:20:00,37,66,103,206,1236
2016-03-13 08:30:00,31,99,112,242,1452
2016-03-13 08:40:00,1,132,140,273,1638
2016-03-13 08:50:00,26,139,153,318,1908
2016-03-13 09:00:00,57,136,179,372,2232
2016-03-13 09:10:00,95,154,155,404,2424
2016-03-13 09:20:00,178,165,174,517,3102
2016-03-13 09:30:00,169,142,161,472,2832
2016-03-13 09:40:00,187,97,188,472,2832
2016-03-13 09:50:00,114,127,257,498,2988
2016-03-13 10:00:00,156,105,266,527,3162
2016-03-13 10:10:00,209,121,252,582,3492
2016-03-13 10:20:00,204,154,190,548,3288
2016-03-13 10:30:00,228,129,207,564,3384
2016-03-13 10:40:00,256,204,128,588,3528
2016-03-13 10:50:00,267,220,187,674,4044
2016-03-13 11:00:00,269,236,257,762,4572
2016-03-13 11:10:00,306,274,294,874,5244
2016-03-13 11:20:00,267,236,256,759,4554
2016-03-13 11:30:00,285,255,273,813,4878
2016-03-13 11:40:00,352,319,341,1012,6072
2016-03-13 11:50:00,336,304,326,966,5796
2016-03-13 12:00:00,413,371,397,1181,7086
2016-03-13 12:10:00,449,405,435,1289,7734
2016-03-13 12:20:00,314,280,300,894,5364
2016-03-13 12:30:00,387,355,373,1115,6690
2016-03-13 12:40:00,265,236,255,756,4536
2016-03-13 12:50:00,267,238,259,764,4584
2016-03-13 13:00:00,337,302,326,965,5790
2016-03-13 13:10:00,397,363,387,1147,6882
2016-03-13 13:20:00,425,385,411,1221,7326
2016-03-13 13:30:00,342,309,332,983,5898
2016-03-13 13:40:00,325,292,313,930,5580
2016-03-13 13:50:00,609,571,595,1775,10650
2016-03-13 14:00:00,842,796,821,2459,14754
2016-03-13 14:10:00,448,411,435,1294,7764
2016-03-13 14:20:00,369,335,357,1061,6366
2016-03-13 14:30:00,327,293,317,937,5622
2016-03-13 14:40:00,344,308,333,985,5910
2016-03-13 14:50:00,305,272,301,878,5268
2016-03-13 15:00:00,321,281,310,912,5472
2016-03-13 15:10:00,509,469,503,1481,8886
2016-03-13 15:20:00,358,324,349,1031,6186
2016-03-13 15:30:00,291,257,282,830,4980
2016-03-13 15:40:00,256,223,248,727,4362
2016-03-13 15:50:00,235,204,227,666,3996
2016-03-13 16:00:00,204,176,197,577,3462
2016-03-13 16:10:00,182,154,174,510,3060
2016-03-13 16:20:00,70,116,131,317,1902
2016-03-13 16:30:00,19,152,167,338,2028
2016-03-13 16:40:00,0,160,168,328,1968
2016-03-13 16:50:00,0,155,164,319,1914
2016-03-13 17:00:00,1,132,141,274,1644
2016-03-13 17:10:00,62,48,99,209,1254
2016-03-13 17:20:00,30,55,87,172,1032
2016-03-13 17:30:00,32,19,54,105,630
2016-03-13 17:40:00,18,6,26,50,300
2016-03-13 17:50:00,6,1,9,16,96
2016-03-13 18:00:00,0,0,0,0,0
2016-03-13 18:10:00,0,0,0,0,0
2016-03-13 18:20:00,0,0,0,0,0
2016-03-14 06:20:00,0,0,0,0,0
2016-03-14 06:30:00,0,0,0,0,0
2016-03-14 06:40:00,0,0,0,0,0
2016-03-14 06:50:00,0,0,0,0,0
2016-03-14 07:00:00,0,0,0,0,0
2016-03-14 07:10:00,3,0,4,7,42
2016-03-14 07:20:00,6,2,9,17,102
2016-03-14 07:30:00,9,5,14,28,168
2016-03-14 07:40:00,9,9,26,44,264
2016-03-14 07:50:00,11,14,35,60,360
2016-03-14 08:00:00,9,16,35,60,360
2016-03-14 08:10:00,10,17,38,65,390
2016-03-14 08:20:00,9,19,42,70,420
2016-03-14 08:30:00,29,16,50,95,570
2016-03-14 08:40:00,31,24,57,112,672
2016-03-14 08:50:00,38,38,62,138,828
2016-03-14 09:00:00,37,38,74,149,894
2016-03-14 09:10:00,51,42,85,178,1068
2016-03-14 09:20:00,49,58,88,195,1170
2016-03-14 09:30:00,57,52,90,199,1194
2016-03-14 09:40:00,48,74,99,221,1326
2016-03-14 09:50:00,18,109,122,249,1494
2016-03-14 10:00:00,6,125,127,258,1548
2016-03-14 10:10:00,0,141,147,288,1728
2016-03-14 10:20:00,17,108,120,245,1470
2016-03-14 10:30:00,0,130,135,265,1590
2016-03-14 10:40:00,9,141,150,300,1800
2016-03-14 10:50:00,21,142,159,322,1932
2016-03-14 11:00:00,68,119,156,343,2058
2016-03-14 11:10:00,58,126,166,350,2100
2016-03-14 11:20:00,40,145,194,379,2274
2016-03-14 11:30:00,128,51,199,378,2268
2016-03-14 11:40:00,77,117,148,342,2052
2016-03-14 11:50:00,47,127,147,321,1926
2016-03-14 12:00:00,1,144,151,296,1776
2016-03-14 12:10:00,81,139,158,378,2268
2016-03-14 12:20:00,69,140,160,369,2214
2016-03-14 12:30:00,126,166,148,440,2640
2016-03-14 12:40:00,101,150,141,392,2352
2016-03-14 12:50:00,57,107,256,420,2520
2016-03-14 13:00:00,78,110,206,394,2364
2016-03-14 13:10:00,126,113,191,430,2580
2016-03-14 13:20:00,77,141,183,401,2406
2016-03-14 13:30:00,162,0,306,468,2808
2016-03-14 13:40:00,113,98,221,432,2592
2016-03-14 13:50:00,62,151,157,370,2220
2016-03-14 14:00:00,72,147,158,377,2262
2016-03-14 14:10:00,164,19,290,473,2838
2016-03-14 14:20:00,257,114,192,563,3378
2016-03-14 14:30:00,178,0,316,494,2964
2016-03-14 14:40:00,160,26,259,445,2670
2016-03-14 14:50:00,175,139,168,482,2892
2016-03-14 15:00:00,315,160,127,602,3612
2016-03-14 15:10:00,218,184,198,600,3600
2016-03-14 15:20:00,240,217,233,690,4140
2016-03-14 15:30:00,218,194,211,623,3738
2016-03-14 15:40:00,217,149,250,616,3696
2016-03-14 15:50:00,194,162,203,559,3354
2016-03-14 16:00:00,188,163,180,531,3186
2016-03-14 16:10:00,157,133,150,440,2640
2016-03-14 16:20:00,157,62,141,360,2160
2016-03-14 16:30:00,77,121,174,372,2232
2016-03-14 16:40:00,14,141,152,307,1842
2016-03-14 16:50:00,0,133,138,271,1626
2016-03-14 17:00:00,36,94,105,235,1410
2016-03-14 17:10:00,39,54,86,179,1074
2016-03-14 17:20:00,33,34,63,130,780
2016-03-14 17:30:00,23,19,47,89,534
2016-03-14 17:40:00,17,6,26,49,294
2016-03-14 17:50:00,7,3,10,20,120
2016-03-14 18:00:00,0,0,0,0,0
2016-03-14 18:10:00,0,0,0,0,0
2016-03-14 18:20:00,0,0,0,0,0
2016-03-15 06:00:00,0,0,0,0,0
2016-03-15 06:10:00,0,0,0,0,0
2016-03-15 06:20:00,0,0,0,0,0
2016-03-15 06:30:00,0,0,0,0,0
2016-03-15 06:40:00,0,0,0,0,0
2016-03-15 06:50:00,6,5,8,19,114
2016-03-15 07:00:00,13,6,19,38,228
2016-03-15 07:10:00,16,15,36,67,402
2016-03-15 07:20:00,37,41,74,152,912
2016-03-15 07:30:00,27,59,85,171,1026
2016-03-15 07:40:00,27,65,93,185,1110
2016-03-15 07:50:00,14,83,112,209,1254
2016-03-15 08:00:00,18,112,122,252,1512
2016-03-15 08:10:00,32,147,162,341,2046
2016-03-15 08:20:00,56,142,156,354,2124
2016-03-15 08:30:00,51,142,169,362,2172
2016-03-15 08:40:00,133,60,189,382,2292
2016-03-15 08:50:00,73,142,163,378,2268
2016-03-15 09:00:00,59,138,151,348,2088
2016-03-15 09:10:00,3,139,144,286,1716
2016-03-15 09:20:00,87,108,137,332,1992
2016-03-15 09:30:00,85,82,217,384,2304
2016-03-15 09:40:00,270,146,158,574,3444
2016-03-15 09:50:00,234,105,231,570,3420
2016-03-15 10:00:00,295,264,286,845,5070
2016-03-15 10:10:00,292,262,283,837,5022
2016-03-15 10:20:00,287,259,278,824,4944
2016-03-15 10:30:00,249,222,241,712,4272
2016-03-15 10:40:00,321,292,314,927,5562
2016-03-15 10:50:00,388,356,380,1124,6744
2016-03-15 11:00:00,525,490,516,1531,9186
2016-03-15 11:10:00,639,600,626,1865,11190
2016-03-15 11:20:00,557,520,545,1622,9732
2016-03-15 11:30:00,494,462,485,1441,8646
2016-03-15 11:40:00,656,615,641,1912,11472
2016-03-15 11:50:00,502,466,483,1451,8706
2016-03-15 12:00:00,609,568,591,1768,10608
2016-03-15 12:10:00,548,519,543,1610,9660
2016-03-15 12:20:00,415,382,402,1199,7194
2016-03-15 12:30:00,465,434,458,1357,8142
2016-03-15 12:40:00,454,426,447,1327,7962
2016-03-15 12:50:00,315,287,306,908,5448
2016-03-15 13:00:00,273,244,264,781,4686
2016-03-15 13:10:00,226,198,218,642,3852
2016-03-15 13:20:00,270,244,267,781,4686
2016-03-15 13:30:00,291,268,291,850,5100
2016-03-15 13:40:00,334,307,329,970,5820
2016-03-15 13:50:00,271,245,263,779,4674
2016-03-15 14:00:00,365,330,352,1047,6282
2016-03-15 14:10:00,467,436,455,1358,8148
2016-03-15 14:20:00,348,319,338,1005,6030
2016-03-15 14:30:00,322,295,311,928,5568
2016-03-15 14:40:00,324,295,313,932,5592
2016-03-15 14:50:00,328,299,317,944,5664
2016-03-15 15:00:00,285,261,281,827,4962
2016-03-15 15:10:00,245,221,239,705,4230
2016-03-15 15:20:00,365,337,357,1059,6354
2016-03-15 15:30:00,384,358,373,1115,6690
2016-03-15 15:40:00,220,196,213,629,3774
2016-03-15 15:50:00,171,101,161,433,2598
2016-03-15 16:00:00,42,134,142,318,1908
2016-03-15 16:10:00,52,86,101,239,1434
2016-03-15 16:20:00,73,112,128,313,1878
2016-03-15 16:30:00,19,128,128,275,1650
2016-03-15 16:40:00,76,65,135,276,1656
2016-03-15 16:50:00,56,62,99,217,1302
2016-03-15 17:00:00,27,55,76,158,948
2016-03-15 17:10:00,24,29,49,102,612
2016-03-15 17:20:00,14,13,33,60,360
2016-03-15 17:30:00,17,4,18,39,234
2016-03-15 17:40:00,2,0,3,5,30
2016-03-15 17:50:00,0,0,0,0,0
2016-03-15 18:00:00,0,0,0,0,0
2016-03-15 18:10:00,0,0,0,0,0
2016-03-15 18:20:00,0,0,0,0,0
2016-03-15 18:30:00,0,0,0,0,0
2016-03-16 06:00:00,0,0,0,0,0
2016-03-16 06:10:00,0,0,0,0,0
2016-03-16 06:20:00,0,0,0,0,0
2016-03-16 06:30:00,1,0,2,3,18
2016-03-16 06:40:00,7,1,10,18,108
2016-03-16 06:50:00,12,4,17,33,198
2016-03-16 07:00:00,12,10,27,49,294
2016-03-16 07:10:00,22,8,32,62,372
2016-03-16 07:20:00,30,9,40,79,474
2016-03-16 07:30:00,34,11,46,91,546
2016-03-16 07:40:00,37,14,48,99,594
2016-03-16 07:50:00,26,27,55,108,648
2016-03-16 08:00:00,31,15,72,118,708
2016-03-16 08:10:00,21,26,80,127,762
2016-03-16 08:20:00,28,42,68,138,828
2016-03-16 08:30:00,40,37,77,154,924
2016-03-16 08:40:00,53,31,84,168,1008
2016-03-16 08:50:00,114,85,89,288,1728
2016-03-16 09:00:00,234,151,197,582,3492
2016-03-16 09:10:00,281,254,274,809,4854
2016-03-16 09:20:00,528,500,520,1548,9288
2016-03-16 09:30:00,739,708,728,2175,13050
2016-03-16 09:40:00,804,761,788,2353,14118
2016-03-16 09:50:00,846,803,834,2483,14898
2016-03-16 10:00:00,875,837,867,2579,15474
2016-03-16 10:10:00,902,858,898,2658,15948
2016-03-16 10:20:00,928,880,917,2725,16350
2016-03-16 10:30:00,940,908,935,2783,16698
2016-03-16 10:40:00,957,932,953,2842,17052
2016-03-16 10:50:00,979,948,965,2892,17352
2016-03-16 11:00:00,993,952,979,2924,17544
2016-03-16 11:10:00,1004,962,994,2960,17760
2016-03-16 11:20:00,1020,971,1005,2996,17976
2016-03-16 11:30:00,1025,979,1012,3016,18096
2016-03-16 11:40:00,1030,988,1015,3033,18198
2016-03-16 11:50:00,1029,998,1021,3048,18288
2016-03-16 12:00:00,1032,999,1024,3055,18330
2016-03-16 12:10:00,1029,1000,1026,3055,18330
2016-03-16 12:20:00,1032,1004,1028,3064,18384
2016-03-16 12:30:00,1043,999,1033,3075,18450
2016-03-16 12:40:00,1046,1000,1029,3075,18450
2016-03-16 12:50:00,1032,991,1021,3044,18264
2016-03-16 13:00:00,1025,980,1012,3017,18102
2016-03-16 13:10:00,1011,980,1000,2991,17946
2016-03-16 13:20:00,1000,967,984,2951,17706
2016-03-16 13:30:00,983,951,972,2906,17436
2016-03-16 13:40:00,966,935,951,2852,17112
2016-03-16 13:50:00,928,896,915,2739,16434
2016-03-16 14:00:00,894,866,888,2648,15888
2016-03-16 14:10:00,847,814,834,2495,14970
2016-03-16 14:20:00,807,778,792,2377,14262
2016-03-16 14:30:00,768,729,752,2249,13494
2016-03-16 14:40:00,727,681,712,2120,12720
2016-03-16 14:50:00,678,639,665,1982,11892
2016-03-16 15:00:00,623,590,612,1825,10950
2016-03-16 15:10:00,574,547,569,1690,10140
2016-03-16 15:20:00,523,494,518,1535,9210
2016-03-16 15:30:00,476,446,466,1388,8328
2016-03-16 15:40:00,418,390,408,1216,7296
2016-03-16 15:50:00,370,343,361,1074,6444
2016-03-16 16:00:00,317,290,312,919,5514
2016-03-16 16:10:00,272,244,265,781,4686
2016-03-16 16:20:00,222,195,216,633,3798
2016-03-16 16:30:00,179,152,165,496,2976
2016-03-16 16:40:00,131,111,125,367,2202
2016-03-16 16:50:00,87,78,87,252,1512
2016-03-16 17:00:00,47,46,66,159,954
2016-03-16 17:10:00,24,27,68,119,714
2016-03-16 17:20:00,26,32,41,99,594
2016-03-16 17:30:00,19,25,31,75,450
2016-03-16 17:40:00,11,16,28,55,330
2016-03-16 17:50:00,5,6,24,35,210
2016-03-16 18:00:00,3,2,10,15,90
2016-03-16 18:10:00,0,0,0,0,0
2016-03-16 18:20:00,0,0,0,0,0
2016-03-16 18:30:00,0,0,0,0,0
2016-03-16 18:40:00,0,0,0,0,0
2016-03-17 05:50:00,0,0,0,0,0
2016-03-17 06:00:00,0,0,0,0,0
2016-03-17 06:10:00,0,0,0,0,0
2016-03-17 06:20:00,0,0,0,0,0
2016-03-17 06:30:00,1,1,2,4,24
2016-03-17 06:40:00,7,2,10,19,114
2016-03-17 06:50:00,9,6,20,35,210
2016-03-17 07:00:00,8,14,28,50,300
2016-03-17 07:10:00,10,17,37,64,384
2016-03-17 07:20:00,20,18,44,82,492
2016-03-17 07:30:00,15,28,51,94,564
2016-03-17 07:40:00,24,31,52,107,642
2016-03-17 07:50:00,11,12,97,120,720
2016-03-17 08:00:00,18,32,82,132,792
2016-03-17 08:10:00,27,44,67,138,828
2016-03-17 08:20:00,33,40,73,146,876
2016-03-17 08:30:00,20,59,82,161,966
2016-03-17 08:40:00,34,58,87,179,1074
2016-03-17 08:50:00,95,65,135,295,1770
2016-03-17 09:00:00,166,119,300,585,3510
2016-03-17 09:10:00,304,275,311,890,5340
2016-03-17 09:20:00,558,530,545,1633,9798
2016-03-17 09:30:00,753,713,741,2207,13242
2016-03-17 09:40:00,808,767,795,2370,14220
2016-03-17 09:50:00,857,812,840,2509,15054
2016-03-17 10:00:00,883,835,866,2584,15504
2016-03-17 10:10:00,907,853,897,2657,15942
2016-03-17 10:20:00,924,884,922,2730,16380
2016-03-17 10:30:00,934,904,940,2778,16668
2016-03-17 10:40:00,956,924,956,2836,17016
2016-03-17 10:50:00,986,942,973,2901,17406
2016-03-17 11:00:00,1002,954,980,2936,17616
2016-03-17 11:10:00,1006,965,988,2959,17754
2016-03-17 11:20:00,1017,972,999,2988,17928
2016-03-17 11:30:00,1017,972,1007,2996,17976
2016-03-17 11:40:00,1021,984,1008,3013,18078
2016-03-17 11:50:00,1016,987,1013,3016,18096
2016-03-17 12:00:00,1014,976,1004,2994,17964
2016-03-17 12:10:00,1010,971,999,2980,17880
2016-03-17 12:20:00,1008,970,988,2966,17796
2016-03-17 12:30:00,1010,970,996,2976,17856
2016-03-17 12:40:00,893,875,887,2655,15930
2016-03-17 12:50:00,605,585,596,1786,10716
2016-03-17 13:00:00,1018,963,1002,2983,17898
2016-03-17 13:10:00,1017,970,999,2986,17916
2016-03-17 13:20:00,1003,955,987,2945,17670
2016-03-17 13:30:00,992,932,968,2892,17352
2016-03-17 13:40:00,975,923,953,2851,17106
2016-03-17 13:50:00,934,889,917,2740,16440
2016-03-17 14:00:00,893,855,889,2637,15822
2016-03-17 14:10:00,825,790,819,2434,14604
2016-03-17 14:20:00,820,791,806,2417,14502
2016-03-17 14:30:00,412,384,403,1199,7194
2016-03-17 14:40:00,292,147,133,572,3432
2016-03-17 14:50:00,190,31,257,478,2868
2016-03-17 15:00:00,116,117,152,385,2310
2016-03-17 15:10:00,136,53,168,357,2142
2016-03-17 15:20:00,82,98,133,313,1878
2016-03-17 15:30:00,52,105,131,288,1728
2016-03-17 15:40:00,24,103,115,242,1452
2016-03-17 15:50:00,40,40,77,157,942
2016-03-17 16:00:00,23,56,75,154,924
2016-03-17 16:10:00,27,47,76,150,900
2016-03-17 16:20:00,36,20,60,116,696
2016-03-17 16:30:00,33,23,60,116,696
2016-03-17 16:40:00,29,20,54,103,618
2016-03-17 16:50:00,27,11,42,80,480
2016-03-17 17:00:00,12,12,32,56,336
2016-03-17 17:10:00,12,6,20,38,228
2016-03-17 17:20:00,13,5,17,35,210
2016-03-17 17:30:00,10,4,12,26,156
2016-03-17 17:40:00,6,1,8,15,90
2016-03-17 17:50:00,1,0,2,3,18
2016-03-17 18:00:00,0,0,0,0,0
2016-03-17 18:10:00,0,0,0,0,0
2016-03-17 18:20:00,0,0,0,0,0
2016-03-17 18:30:00,0,0,0,0,0
2016-03-18 06:00:00,0,0,0,0,0
2016-03-18 06:10:00,0,0,0,0,0
2016-03-18 06:20:00,0,0,0,0,0
2016-03-18 06:30:00,0,0,0,0,0
2016-03-18 06:40:00,0,0,0,0,0
2016-03-18 06:50:00,0,0,0,0,0
2016-03-18 07:00:00,3,0,5,8,48
2016-03-18 07:10:00,6,1,11,18,108
2016-03-18 07:20:00,10,4,16,30,180
2016-03-18 07:30:00,11,4,18,33,198
2016-03-18 07:40:00,13,10,29,52,312
2016-03-18 07:50:00,13,13,33,59,354
2016-03-18 08:00:00,13,15,43,71,426
2016-03-18 08:10:00,32,22,51,105,630
2016-03-18 08:20:00,31,26,69,126,756
2016-03-18 08:30:00,34,38,61,133,798
2016-03-18 08:40:00,33,42,69,144,864
2016-03-18 08:50:00,37,43,73,153,918
2016-03-18 09:00:00,38,38,76,152,912
2016-03-18 09:10:00,44,53,86,183,1098
2016-03-18 09:20:00,48,62,97,207,1242
2016-03-18 09:30:00,46,76,106,228,1368
2016-03-18 09:40:00,88,86,216,390,2340
2016-03-18 09:50:00,120,38,185,343,2058
2016-03-18 10:00:00,82,80,225,387,2322
2016-03-18 10:10:00,255,224,245,724,4344
2016-03-18 10:20:00,278,244,265,787,4722
2016-03-18 10:30:00,290,259,277,826,4956
2016-03-18 10:40:00,367,336,357,1060,6360
2016-03-18 10:50:00,517,485,513,1515,9090
2016-03-18 11:00:00,370,340,362,1072,6432
2016-03-18 11:10:00,303,275,295,873,5238
2016-03-18 11:20:00,308,278,299,885,5310
2016-03-18 11:30:00,446,409,433,1288,7728
2016-03-18 11:40:00,302,272,293,867,5202
2016-03-18 11:50:00,433,401,424,1258,7548
2016-03-18 12:00:00,430,399,421,1250,7500
2016-03-18 12:10:00,607,574,598,1779,10674
2016-03-18 12:20:00,350,322,343,1015,6090
2016-03-18 12:30:00,393,361,382,1136,6816
2016-03-18 12:40:00,589,551,581,1721,10326
2016-03-18 12:50:00,844,802,841,2487,14922
2016-03-18 13:00:00,544,504,534,1582,9492
2016-03-18 13:10:00,313,280,305,898,5388
2016-03-18 13:20:00,319,287,312,918,5508
2016-03-18 13:30:00,539,504,536,1579,9474
2016-03-18 13:40:00,608,575,607,1790,10740
2016-03-18 13:50:00,485,453,476,1414,8484
2016-03-18 14:00:00,663,622,648,1933,11598
2016-03-18 14:10:00,706,668,697,2071,12426
2016-03-18 14:20:00,747,716,743,2206,13236
2016-03-18 14:30:00,678,649,673,2000,12000
2016-03-18 14:40:00,644,619,633,1896,11376
2016-03-18 14:50:00,458,434,451,1343,8058
2016-03-18 15:00:00,291,269,287,847,5082
2016-03-18 15:10:00,322,297,319,938,5628
2016-03-18 15:20:00,496,467,491,1454,8724
2016-03-18 15:30:00,475,445,469,1389,8334
2016-03-18 15:40:00,410,383,402,1195,7170
2016-03-18 15:50:00,345,319,338,1002,6012
2016-03-18 16:00:00,287,260,282,829,4974
2016-03-18 16:10:00,245,219,240,704,4224
2016-03-18 16:20:00,223,197,216,636,3816
2016-03-18 16:30:00,173,147,166,486,2916
2016-03-18 16:40:00,135,110,127,372,2232
2016-03-18 16:50:00,63,104,117,284,1704
2016-03-18 17:00:00,26,75,95,196,1176
2016-03-18 17:10:00,3,87,99,189,1134
2016-03-18 17:20:00,14,67,83,164,984
2016-03-18 17:30:00,27,31,64,122,732
2016-03-18 17:40:00,12,25,48,85,510
2016-03-18 17:50:00,5,18,34,57,342
2016-03-18 18:00:00,6,3,15,24,144
2016-03-18 18:10:00,0,0,2,2,12
2016-03-18 18:20:00,0,0,0,0,0
2016-03-18 18:30:00,0,0,0,0,0
2016-03-18 18:40:00,0,0,0,0,0
2016-03-19 05:50:00,0,0,0,0,0
2016-03-19 06:00:00,0,0,0,0,0
2016-03-19 06:10:00,0,0,0,0,0
2016-03-19 06:20:00,0,0,0,0,0
2016-03-19 06:30:00,0,0,0,0,0
2016-03-19 06:40:00,3,0,5,8,48
2016-03-19 06:50:00,8,4,13,25,150
2016-03-19 07:00:00,14,14,32,60,360
2016-03-19 07:10:00,17,36,76,129,774
2016-03-19 07:20:00,24,56,83,163,978
2016-03-19 07:30:00,29,22,85,136,816
2016-03-19 07:40:00,54,27,80,161,966
2016-03-19 07:50:00,30,14,49,93,558
2016-03-19 08:00:00,32,83,108,223,1338
2016-03-19 08:10:00,52,88,130,270,1620
2016-03-19 08:20:00,100,116,177,393,2358
2016-03-19 08:30:00,143,78,191,412,2472
2016-03-19 08:40:00,166,9,303,478,2868
2016-03-19 08:50:00,185,24,259,468,2808
2016-03-19 09:00:00,107,70,266,443,2658
2016-03-19 09:10:00,164,173,230,567,3402
2016-03-19 09:20:00,223,193,212,628,3768
2016-03-19 09:30:00,205,176,195,576,3456
2016-03-19 09:40:00,252,169,188,609,3654
2016-03-19 09:50:00,196,168,186,550,3300
2016-03-19 10:00:00,186,160,176,522,3132
2016-03-19 10:10:00,219,163,239,621,3726
2016-03-19 10:20:00,252,217,234,703,4218
2016-03-19 10:30:00,295,263,282,840,5040
2016-03-19 10:40:00,258,226,246,730,4380
2016-03-19 10:50:00,219,190,206,615,3690
2016-03-19 11:00:00,219,191,204,614,3684
2016-03-19 11:10:00,242,214,230,686,4116
2016-03-19 11:20:00,223,194,211,628,3768
2016-03-19 11:30:00,232,206,223,661,3966
2016-03-19 11:40:00,299,204,187,690,4140
2016-03-19 11:50:00,267,243,262,772,4632
2016-03-19 12:00:00,266,238,258,762,4572
2016-03-19 12:10:00,339,309,329,977,5862
2016-03-19 12:20:00,450,421,439,1310,7860
2016-03-19 12:30:00,401,371,385,1157,6942
2016-03-19 12:40:00,506,471,497,1474,8844
2016-03-19 12:50:00,719,681,711,2111,12666
2016-03-19 13:00:00,954,906,941,2801,16806
2016-03-19 13:10:00,922,880,915,2717,16302
2016-03-19 13:20:00,927,889,920,2736,16416
2016-03-19 13:30:00,996,952,988,2936,17616
2016-03-19 13:40:00,980,932,969,2881,17286
2016-03-19 13:50:00,932,882,920,2734,16404
2016-03-19 14:00:00,851,805,843,2499,14994
2016-03-19 14:10:00,858,813,849,2520,15120
2016-03-19 14:20:00,806,765,799,2370,14220
2016-03-19 14:30:00,742,702,733,2177,13062
2016-03-19 14:40:00,703,669,692,2064,12384
2016-03-19 14:50:00,670,631,657,1958,11748
2016-03-19 15:00:00,622,591,618,1831,10986
2016-03-19 15:10:00,549,521,541,1611,9666
2016-03-19 15:20:00,505,476,497,1478,8868
2016-03-19 15:30:00,434,407,424,1265,7590
2016-03-19 15:40:00,424,400,416,1240,7440
2016-03-19 15:50:00,385,358,375,1118,6708
2016-03-19 16:00:00,338,312,331,981,5886
2016-03-19 16:10:00,273,249,266,788,4728
2016-03-19 16:20:00,233,209,227,669,4014
2016-03-19 16:30:00,179,155,172,506,3036
2016-03-19 16:40:00,136,114,127,377,2262
2016-03-19 16:50:00,101,80,96,277,1662
2016-03-19 17:00:00,28,74,86,188,1128
2016-03-19 17:10:00,31,45,63,139,834
2016-03-19 17:20:00,24,16,70,110,660
2016-03-19 17:30:00,28,12,45,85,510
2016-03-19 17:40:00,19,12,39,70,420
2016-03-19 17:50:00,14,9,26,49,294
2016-03-19 18:00:00,9,5,10,24,144
2016-03-19 18:10:00,2,2,2,6,36
2016-03-19 18:20:00,0,0,0,0,0
2016-03-19 18:30:00,0,0,0,0,0
2016-03-19 18:40:00,0,0,0,0,0
2016-03-20 05:50:00,0,0,0,0,0
2016-03-20 06:00:00,0,0,0,0,0
2016-03-20 06:10:00,0,0,0,0,0
2016-03-20 06:20:00,1,0,1,2,12
2016-03-20 06:30:00,6,2,7,15,90
2016-03-20 06:40:00,11,4,15,30,180
2016-03-20 06:50:00,14,7,24,45,270
2016-03-20 07:00:00,14,11,33,58,348
2016-03-20 07:10:00,19,13,42,74,444
2016-03-20 07:20:00,16,24,47,87,522
2016-03-20 07:30:00,31,15,50,96,576
2016-03-20 07:40:00,28,26,52,106,636
2016-03-20 07:50:00,45,10,56,111,666
2016-03-20 08:00:00,27,12,80,119,714
2016-03-20 08:10:00,14,15,101,130,780
2016-03-20 08:20:00,29,44,70,143,858
2016-03-20 08:30:00,27,52,80,159,954
2016-03-20 08:40:00,93,94,182,369,2214
2016-03-20 08:50:00,201,54,251,506,3036
2016-03-20 09:00:00,297,217,199,713,4278
2016-03-20 09:10:00,429,400,417,1246,7476
2016-03-20 09:20:00,666,631,657,1954,11724
2016-03-20 09:30:00,638,598,627,1863,11178
2016-03-20 09:40:00,821,776,816,2413,14478
2016-03-20 09:50:00,821,778,818,2417,14502
2016-03-20 10:00:00,756,714,750,2220,13320
2016-03-20 10:10:00,517,482,508,1507,9042
2016-03-20 10:20:00,705,669,700,2074,12444
2016-03-20 10:30:00,584,550,571,1705,10230
2016-03-20 10:40:00,518,483,508,1509,9054
2016-03-20 10:50:00,507,471,497,1475,8850
2016-03-20 11:00:00,567,528,556,1651,9906
2016-03-20 11:10:00,544,504,528,1576,9456
2016-03-20 11:20:00,600,568,583,1751,10506
2016-03-20 11:30:00,627,594,610,1831,10986
2016-03-20 11:40:00,570,534,562,1666,9996
2016-03-20 11:50:00,532,490,520,1542,9252
2016-03-20 12:00:00,458,425,447,1330,7980
2016-03-20 12:10:00,440,402,431,1273,7638
2016-03-20 12:20:00,465,427,456,1348,8088
2016-03-20 12:30:00,401,366,392,1159,6954
2016-03-20 12:40:00,472,438,459,1369,8214
2016-03-20 12:50:00,717,681,704,2102,12612
2016-03-20 13:00:00,642,609,625,1876,11256
2016-03-20 13:10:00,836,796,818,2450,14700
2016-03-20 13:20:00,553,518,537,1608,9648
2016-03-20 13:30:00,472,439,460,1371,8226
2016-03-20 13:40:00,394,365,387,1146,6876
2016-03-20 13:50:00,411,379,402,1192,7152
2016-03-20 14:00:00,482,451,473,1406,8436
2016-03-20 14:10:00,468,438,461,1367,8202
2016-03-20 14:20:00,604,573,598,1775,10650
2016-03-20 14:30:00,552,525,544,1621,9726
2016-03-20 14:40:00,354,331,348,1033,6198
2016-03-20 14:50:00,340,314,331,985,5910
2016-03-20 15:00:00,324,293,315,932,5592
2016-03-20 15:10:00,289,262,285,836,5016
2016-03-20 15:20:00,347,321,343,1011,6066
2016-03-20 15:30:00,432,403,427,1262,7572
2016-03-20 15:40:00,297,270,290,857,5142
2016-03-20 15:50:00,220,196,214,630,3780
2016-03-20 16:00:00,236,210,230,676,4056
2016-03-20 16:10:00,241,124,188,553,3318
2016-03-20 16:20:00,171,0,310,481,2886
2016-03-20 16:30:00,195,121,239,555,3330
2016-03-20 16:40:00,191,167,185,543,3258
2016-03-20 16:50:00,74,66,88,228,1368
2016-03-20 17:00:00,50,47,92,189,1134
2016-03-20 17:10:00,22,48,77,147,882
2016-03-20 17:20:00,20,18,48,86,516
2016-03-20 17:30:00,19,17,47,83,498
2016-03-20 17:40:00,19,20,44,83,498
2016-03-20 17:50:00,17,10,35,62,372
2016-03-20 18:00:00,15,2,18,35,210
2016-03-20 18:10:00,5,1,7,13,78
2016-03-20 18:20:00,0,0,0,0,0
2016-03-20 18:30:00,0,0,0,0,0
2016-03-20 18:40:00,0,0,0,0,0
2016-03-21 05:50:00,0,0,0,0,0
2016-03-21 06:00:00,0,0,0,0,0
2016-03-21 06:10:00,0,0,0,0,0
2016-03-21 06:20:00,1,1,2,4,24
2016-03-21 06:30:00,7,3,11,21,126
2016-03-21 06:40:00,13,6,20,39,234
2016-03-21 06:50:00,17,10,29,56,336
2016-03-21 07:00:00,14,15,41,70,420
2016-03-21 07:10:00,19,21,45,85,510
2016-03-21 07:20:00,36,14,52,102,612
2016-03-21 07:30:00,15,14,93,122,732
2016-03-21 07:40:00,20,27,83,130,780
2016-03-21 07:50:00,17,24,89,130,780
2016-03-21 08:00:00,29,45,67,141,846
2016-03-21 08:10:00,44,42,74,160,960
2016-03-21 08:20:00,28,68,86,182,1092
2016-03-21 08:30:00,48,89,97,234,1404
2016-03-21 08:40:00,165,165,181,511,3066
2016-03-21 08:50:00,299,272,293,864,5184
2016-03-21 09:00:00,270,247,265,782,4692
2016-03-21 09:10:00,241,177,220,638,3828
2016-03-21 09:20:00,528,495,519,1542,9252
2016-03-21 09:30:00,894,852,889,2635,15810
2016-03-21 09:40:00,733,697,721,2151,12906
2016-03-21 09:50:00,414,384,404,1202,7212
2016-03-21 10:00:00,589,558,580,1727,10362
2016-03-21 10:10:00,407,379,401,1187,7122
2016-03-21 10:20:00,273,247,266,786,4716
2016-03-21 10:30:00,342,311,333,986,5916
2016-03-21 10:40:00,908,869,904,2681,16086
2016-03-21 10:50:00,656,623,653,1932,11592
2016-03-21 11:00:00,574,546,575,1695,10170
2016-03-21 11:10:00,815,772,811,2398,14388
2016-03-21 11:20:00,1005,950,992,2947,17682
2016-03-21 11:30:00,1112,1063,1095,3270,19620
2016-03-21 11:40:00,588,549,574,1711,10266
2016-03-21 11:50:00,825,789,813,2427,14562
2016-03-21 12:00:00,1025,992,1012,3029,18174
2016-03-21 12:10:00,1035,1003,1028,3066,18396
2016-03-21 12:20:00,727,690,719,2136,12816
2016-03-21 12:30:00,990,943,982,2915,17490
2016-03-21 12:40:00,769,735,764,2268,13608
2016-03-21 12:50:00,880,848,873,2601,15606
2016-03-21 13:00:00,206,182,197,585,3510
2016-03-21 13:10:00,363,333,353,1049,6294
2016-03-21 13:20:00,253,184,167,604,3624
2016-03-21 13:30:00,319,230,202,751,4506
2016-03-21 13:40:00,465,439,461,1365,8190
2016-03-21 13:50:00,470,442,454,1366,8196
2016-03-21 14:00:00,512,484,503,1499,8994
2016-03-21 14:10:00,482,455,471,1408,8448
2016-03-21 14:20:00,343,317,340,1000,6000
2016-03-21 14:30:00,287,260,282,829,4974
2016-03-21 14:40:00,215,191,210,616,3696
2016-03-21 14:50:00,185,162,179,526,3156
2016-03-21 15:00:00,131,110,124,365,2190
2016-03-21 15:10:00,70,125,139,334,2004
2016-03-21 15:20:00,29,123,120,272,1632
2016-03-21 15:30:00,64,96,109,269,1614
2016-03-21 15:40:00,55,104,135,294,1764
2016-03-21 15:50:00,31,70,88,189,1134
2016-03-21 16:00:00,11,109,113,233,1398
2016-03-21 16:10:00,19,98,110,227,1362
2016-03-21 16:20:00,8,64,92,164,984
2016-03-21 16:30:00,17,100,117,234,1404
2016-03-21 16:40:00,23,49,87,159,954
2016-03-21 16:50:00,28,28,53,109,654
2016-03-21 17:00:00,10,14,34,58,348
2016-03-21 17:10:00,25,57,82,164,984
2016-03-21 17:20:00,12,95,107,214,1284
2016-03-21 17:30:00,28,75,96,199,1194
2016-03-21 17:40:00,31,36,70,137,822
2016-03-21 17:50:00,10,9,23,42,252
2016-03-21 18:00:00,4,4,4,12,72
2016-03-21 18:10:00,1,1,2,4,24
2016-03-21 18:20:00,0,0,0,0,0
2016-03-21 18:30:00,0,0,0,0,0
2016-03-21 18:40:00,0,0,0,0,0
2016-03-22 05:50:00,0,0,0,0,0
2016-03-22 06:00:00,0,0,0,0,0
2016-03-22 06:10:00,0,0,0,0,0
2016-03-22 06:20:00,2,2,3,7,42
2016-03-22 06:30:00,9,4,15,28,168
2016-03-22 06:40:00,13,12,33,58,348
2016-03-22 06:50:00,16,22,42,80,480
2016-03-22 07:00:00,14,8,32,54,324
2016-03-22 07:10:00,20,6,27,53,318
2016-03-22 07:20:00,26,10,40,76,456
2016-03-22 07:30:00,23,26,50,99,594
2016-03-22 07:40:00,20,63,108,191,1146
2016-03-22 07:50:00,20,76,94,190,1140
2016-03-22 08:00:00,39,83,107,229,1374
2016-03-22 08:10:00,42,100,113,255,1530
2016-03-22 08:20:00,23,104,122,249,1494
2016-03-22 08:30:00,22,142,157,321,1926
2016-03-22 08:40:00,29,140,151,320,1920
2016-03-22 08:50:00,42,148,184,374,2244
2016-03-22 09:00:00,94,93,221,408,2448
2016-03-22 09:10:00,162,12,302,476,2856
2016-03-22 09:20:00,213,128,212,553,3318
2016-03-22 09:30:00,162,2,315,479,2874
2016-03-22 09:40:00,195,158,204,557,3342
2016-03-22 09:50:00,196,168,188,552,3312
2016-03-22 10:00:00,234,207,226,667,4002
2016-03-22 10:10:00,239,212,232,683,4098
2016-03-22 10:20:00,238,212,230,680,4080
2016-03-22 10:30:00,229,202,222,653,3918
2016-03-22 10:40:00,343,313,333,989,5934
2016-03-22 10:50:00,394,362,385,1141,6846
2016-03-22 11:00:00,305,276,297,878,5268
2016-03-22 11:10:00,413,382,404,1199,7194
2016-03-22 11:20:00,371,340,362,1073,6438
2016-03-22 11:30:00,594,553,577,1724,10344
2016-03-22 11:40:00,494,458,484,1436,8616
2016-03-22 11:50:00,558,527,555,1640,9840
2016-03-22 12:00:00,470,444,469,1383,8298
2016-03-22 12:10:00,745,708,742,2195,13170
2016-03-22 12:20:00,659,627,654,1940,11640
2016-03-22 12:30:00,606,568,594,1768,10608
2016-03-22 12:40:00,835,791,826,2452,14712
2016-03-22 12:50:00,967,923,958,2848,17088
2016-03-22 13:00:00,922,887,916,2725,16350
2016-03-22 13:10:00,914,874,905,2693,16158
2016-03-22 13:20:00,1020,977,1007,3004,18024
2016-03-22 13:30:00,995,959,982,2936,17616
2016-03-22 13:40:00,971,934,961,2866,17196
2016-03-22 13:50:00,935,900,925,2760,16560
2016-03-22 14:00:00,908,869,896,2673,16038
2016-03-22 14:10:00,862,825,851,2538,15228
2016-03-22 14:20:00,822,784,808,2414,14484
2016-03-22 14:30:00,756,713,743,2212,13272
2016-03-22 14:40:00,742,701,732,2175,13050
2016-03-22 14:50:00,686,650,680,2016,12096
2016-03-22 15:00:00,633,599,623,1855,11130
2016-03-22 15:10:00,607,577,598,1782,10692
2016-03-22 15:20:00,641,615,630,1886,11316
2016-03-22 15:30:00,548,514,532,1594,9564
2016-03-22 15:40:00,188,161,178,527,3162
2016-03-22 15:50:00,165,83,217,465,2790
2016-03-22 16:00:00,168,6,318,492,2952
2016-03-22 16:10:00,138,144,189,471,2826
2016-03-22 16:20:00,41,116,166,323,1938
2016-03-22 16:30:00,26,104,117,247,1482
2016-03-22 16:40:00,46,153,195,394,2364
2016-03-22 16:50:00,36,157,206,399,2394
2016-03-22 17:00:00,69,144,157,370,2220
2016-03-22 17:10:00,63,117,139,319,1914
2016-03-22 17:20:00,16,75,88,179,1074
2016-03-22 17:30:00,4,80,93,177,1062
2016-03-22 17:40:00,22,45,78,145,870
2016-03-22 17:50:00,26,34,70,130,780
2016-03-22 18:00:00,13,49,79,141,846
2016-03-22 18:10:00,6,14,32,52,312
2016-03-22 18:20:00,4,10,25,39,234
2016-03-22 18:30:00,0,0,3,3,18
2016-03-22 18:40:00,0,0,0,0,0
2016-03-23 05:40:00,0,0,0,0,0
2016-03-23 05:50:00,0,0,0,0,0
2016-03-23 06:00:00,0,0,0,0,0
2016-03-23 06:10:00,0,0,0,0,0
2016-03-23 06:20:00,2,1,3,6,36
2016-03-23 06:30:00,7,3,11,21,126
2016-03-23 06:40:00,8,7,21,36,216
2016-03-23 06:50:00,11,11,32,54,324
2016-03-23 07:00:00,17,13,39,69,414
2016-03-23 07:10:00,29,13,44,86,516
2016-03-23 07:20:00,26,20,49,95,570
2016-03-23 07:30:00,33,17,52,102,612
2016-03-23 07:40:00,30,26,52,108,648
2016-03-23 07:50:00,37,28,47,112,672
2016-03-23 08:00:00,14,13,91,118,708
2016-03-23 08:10:00,36,29,66,131,786
2016-03-23 08:20:00,32,42,71,145,870
2016-03-23 08:30:00,45,40,78,163,978
2016-03-23 08:40:00,182,138,207,527,3162
2016-03-23 08:50:00,280,228,228,736,4416
2016-03-23 09:00:00,426,394,418,1238,7428
2016-03-23 09:10:00,613,574,599,1786,10716
2016-03-23 09:20:00,768,726,756,2250,13500
2016-03-23 09:30:00,821,783,809,2413,14478
2016-03-23 09:40:00,864,829,855,2548,15288
2016-03-23 09:50:00,899,869,890,2658,15948
2016-03-23 10:00:00,927,899,922,2748,16488
2016-03-23 10:10:00,952,921,942,2815,16890
2016-03-23 10:20:00,710,679,698,2087,12522
2016-03-23 10:30:00,435,404,424,1263,7578
2016-03-23 10:40:00,375,346,369,1090,6540
2016-03-23 10:50:00,361,329,354,1044,6264
2016-03-23 11:00:00,345,317,340,1002,6012
2016-03-23 11:10:00,375,344,368,1087,6522
2016-03-23 11:20:00,376,347,366,1089,6534
2016-03-23 11:30:00,358,330,352,1040,6240
2016-03-23 11:40:00,375,349,369,1093,6558
2016-03-23 11:50:00,451,426,446,1323,7938
2016-03-23 12:00:00,667,633,655,1955,11730
2016-03-23 12:10:00,872,830,861,2563,15378
2016-03-23 12:20:00,618,586,611,1815,10890
2016-03-23 12:30:00,845,809,840,2494,14964
2016-03-23 12:40:00,1060,1018,1041,3119,18714
2016-03-23 12:50:00,989,951,975,2915,17490
2016-03-23 13:00:00,573,538,563,1674,10044
2016-03-23 13:10:00,656,622,652,1930,11580
2016-03-23 13:20:00,744,710,739,2193,13158
2016-03-23 13:30:00,995,958,984,2937,17622
2016-03-23 13:40:00,970,935,960,2865,17190
2016-03-23 13:50:00,857,820,847,2524,15144
2016-03-23 14:00:00,730,692,717,2139,12834
2016-03-23 14:10:00,820,783,813,2416,14496
2016-03-23 14:20:00,859,810,840,2509,15054
2016-03-23 14:30:00,796,767,784,2347,14082
2016-03-23 14:40:00,749,709,735,2193,13158
2016-03-23 14:50:00,709,669,699,2077,12462
2016-03-23 15:00:00,658,620,649,1927,11562
2016-03-23 15:10:00,624,591,620,1835,11010
2016-03-23 15:20:00,535,504,529,1568,9408
2016-03-23 15:30:00,515,482,505,1502,9012
2016-03-23 15:40:00,480,448,469,1397,8382
2016-03-23 15:50:00,419,391,415,1225,7350
2016-03-23 16:00:00,371,338,361,1070,6420
2016-03-23 16:10:00,315,288,312,915,5490
2016-03-23 16:20:00,260,236,255,751,4506
2016-03-23 16:30:00,211,189,206,606,3636
2016-03-23 16:40:00,163,141,159,463,2778
2016-03-23 16:50:00,116,91,111,318,1908
2016-03-23 17:00:00,84,59,78,221,1326
2016-03-23 17:10:00,21,48,83,152,912
2016-03-23 17:20:00,21,30,53,104,624
2016-03-23 17:30:00,12,32,52,96,576
2016-03-23 17:40:00,11,22,43,76,456
2016-03-23 17:50:00,12,15,29,56,336
2016-03-23 18:00:00,13,5,16,34,204
2016-03-23 18:10:00,4,2,7,13,78
2016-03-23 18:20:00,0,0,0,0,0
2016-03-23 18:30:00,0,0,0,0,0
2016-03-23 18:40:00,0,0,0,0,0
2016-03-23 18:50:00,0,0,0,0,0
2016-03-24 05:40:00,0,0,0,0,0
2016-03-24 05:50:00,0,0,0,0,0
2016-03-24 06:00:00,0,0,0,0,0
2016-03-24 06:10:00,3,0,4,7,42
2016-03-24 06:20:00,9,1,11,21,126
2016-03-24 06:30:00,12,5,19,36,216
2016-03-24 06:40:00,16,8,24,48,288
2016-03-24 06:50:00,21,8,32,61,366
2016-03-24 07:00:00,24,14,43,81,486
2016-03-24 07:10:00,31,14,46,91,546
2016-03-24 07:20:00,29,21,52,102,612
2016-03-24 07:30:00,29,25,54,108,648
2016-03-24 07:40:00,16,36,60,112,672
2016-03-24 07:50:00,12,6,101,119,714
2016-03-24 08:00:00,8,5,115,128,768
2016-03-24 08:10:00,30,42,68,140,840
2016-03-24 08:20:00,37,70,102,209,1254
2016-03-24 08:30:00,120,121,226,467,2802
2016-03-24 08:40:00,192,197,190,579,3474
2016-03-24 08:50:00,272,247,268,787,4722
2016-03-24 09:00:00,486,466,480,1432,8592
2016-03-24 09:10:00,678,647,665,1990,11940
2016-03-24 09:20:00,794,750,776,2320,13920
2016-03-24 09:30:00,809,759,788,2356,14136
2016-03-24 09:40:00,808,773,802,2383,14298
2016-03-24 09:50:00,831,789,816,2436,14616
2016-03-24 10:00:00,916,876,901,2693,16158
2016-03-24 10:10:00,887,852,871,2610,15660
2016-03-24 10:20:00,837,800,819,2456,14736
2016-03-24 10:30:00,935,899,918,2752,16512
2016-03-24 10:40:00,743,714,728,2185,13110
2016-03-24 10:50:00,801,772,794,2367,14202
2016-03-24 11:00:00,970,940,962,2872,17232
2016-03-24 11:10:00,903,865,894,2662,15972
2016-03-24 11:20:00,1024,980,1012,3016,18096
2016-03-24 11:30:00,894,852,881,2627,15762
2016-03-24 11:40:00,927,882,915,2724,16344
2016-03-24 11:50:00,878,848,873,2599,15594
2016-03-24 12:00:00,879,853,868,2600,15600
2016-03-24 12:10:00,913,893,908,2714,16284
2016-03-24 12:20:00,916,879,910,2705,16230
2016-03-24 12:30:00,824,788,817,2429,14574
2016-03-24 12:40:00,876,837,871,2584,15504
2016-03-24 12:50:00,756,729,751,2236,13416
2016-03-24 13:00:00,1049,1020,1031,3100,18600
2016-03-24 13:10:00,941,913,926,2780,16680
2016-03-24 13:20:00,855,831,858,2544,15264
2016-03-24 13:30:00,564,532,556,1652,9912
2016-03-24 13:40:00,770,735,761,2266,13596
2016-03-24 13:50:00,914,879,909,2702,16212
2016-03-24 14:00:00,785,764,777,2326,13956
2016-03-24 14:10:00,588,560,578,1726,10356
2016-03-24 14:20:00,522,496,516,1534,9204
2016-03-24 14:30:00,486,452,475,1413,8478
2016-03-24 14:40:00,508,475,498,1481,8886
2016-03-24 14:50:00,473,439,464,1376,8256
2016-03-24 15:00:00,393,364,386,1143,6858
2016-03-24 15:10:00,277,250,269,796,4776
2016-03-24 15:20:00,254,227,244,725,4350
2016-03-24 15:30:00,216,187,206,609,3654
2016-03-24 15:40:00,164,138,157,459,2754
2016-03-24 15:50:00,97,72,89,258,1548
2016-03-24 16:00:00,63,47,77,187,1122
2016-03-24 16:10:00,31,29,46,106,636
2016-03-24 16:20:00,11,30,43,84,504
2016-03-24 16:30:00,11,24,51,86,516
2016-03-24 16:40:00,43,40,68,151,906
2016-03-24 16:50:00,29,27,65,121,726
2016-03-24 17:00:00,24,8,35,67,402
2016-03-24 17:10:00,14,5,21,40,240
2016-03-24 17:20:00,12,4,16,32,192
2016-03-24 17:30:00,15,3,17,35,210
2016-03-24 17:40:00,8,2,10,20,120
2016-03-24 17:50:00,5,0,7,12,72
2016-03-24 18:00:00,0,0,1,1,6
2016-03-24 18:10:00,0,0,0,0,0
2016-03-24 18:20:00,0,0,0,0,0
2016-03-24 18:30:00,0,0,0,0,0
2016-03-25 05:40:00,0,0,0,0,0
2016-03-25 05:50:00,0,0,0,0,0
2016-03-25 06:00:00,0,0,0,0,0
2016-03-25 06:10:00,0,0,0,0,0
2016-03-25 06:20:00,0,0,0,0,0
2016-03-25 06:30:00,0,0,0,0,0
2016-03-25 06:40:00,1,1,2,4,24
2016-03-25 06:50:00,4,2,4,10,60
2016-03-25 07:00:00,9,2,11,22,132
2016-03-25 07:10:00,7,9,27,43,258
2016-03-25 07:20:00,9,25,46,80,480
2016-03-25 07:30:00,19,28,51,98,588
2016-03-25 07:40:00,20,21,70,111,666
2016-03-25 07:50:00,26,22,74,122,732
2016-03-25 08:00:00,24,23,84,131,786
2016-03-25 08:10:00,61,22,78,161,966
2016-03-25 08:20:00,29,68,88,185,1110
2016-03-25 08:30:00,19,69,78,166,996
2016-03-25 08:40:00,29,55,68,152,912
2016-03-25 08:50:00,32,72,103,207,1242
2016-03-25 09:00:00,44,60,93,197,1182
2016-03-25 09:10:00,12,125,134,271,1626
2016-03-25 09:20:00,16,112,132,260,1560
2016-03-25 09:30:00,40,69,92,201,1206
2016-03-25 09:40:00,47,66,94,207,1242
2016-03-25 09:50:00,16,119,121,256,1536
2016-03-25 10:00:00,20,87,102,209,1254
2016-03-25 10:10:00,46,76,88,210,1260
2016-03-25 10:20:00,41,90,100,231,1386
2016-03-25 10:30:00,34,119,132,285,1710
2016-03-25 10:40:00,60,115,135,310,1860
2016-03-25 10:50:00,69,179,160,408,2448
2016-03-25 11:00:00,97,248,145,490,2940
2016-03-25 11:10:00,130,151,205,486,2916
2016-03-25 11:20:00,260,148,151,559,3354
2016-03-25 11:30:00,233,208,223,664,3984
2016-03-25 11:40:00,213,188,202,603,3618
2016-03-25 11:50:00,179,153,168,500,3000
2016-03-25 12:00:00,153,127,145,425,2550
2016-03-25 12:10:00,41,128,146,315,1890
2016-03-25 12:20:00,101,100,261,462,2772
2016-03-25 12:30:00,162,117,247,526,3156
2016-03-25 12:40:00,210,167,229,606,3636
2016-03-25 12:50:00,233,147,168,548,3288
2016-03-25 13:00:00,233,75,233,541,3246
2016-03-25 13:10:00,72,104,216,392,2352
2016-03-25 13:20:00,47,112,186,345,2070
2016-03-25 13:30:00,8,116,122,246,1476
2016-03-25 13:40:00,135,84,242,461,2766
2016-03-25 13:50:00,257,218,279,754,4524
2016-03-25 14:00:00,290,260,284,834,5004
2016-03-25 14:10:00,216,193,215,624,3744
2016-03-25 14:20:00,127,104,120,351,2106
2016-03-25 14:30:00,107,84,100,291,1746
2016-03-25 14:40:00,188,161,180,529,3174
2016-03-25 14:50:00,86,126,139,351,2106
2016-03-25 15:00:00,27,50,82,159,954
2016-03-25 15:10:00,21,62,86,169,1014
2016-03-25 15:20:00,24,92,111,227,1362
2016-03-25 15:30:00,35,106,128,269,1614
2016-03-25 15:40:00,144,31,144,319,1914
2016-03-25 15:50:00,29,90,114,233,1398
2016-03-25 16:00:00,57,114,125,296,1776
2016-03-25 16:10:00,157,24,297,478,2868
2016-03-25 16:20:00,59,108,182,349,2094
2016-03-25 16:30:00,19,41,69,129,774
2016-03-25 16:40:00,11,10,30,51,306
2016-03-25 16:50:00,12,14,33,59,354
2016-03-25 17:00:00,16,21,43,80,480
2016-03-25 17:10:00,23,30,58,111,666
2016-03-25 17:20:00,33,39,69,141,846
2016-03-25 17:30:00,32,59,83,174,1044
2016-03-25 17:40:00,33,64,86,183,1098
2016-03-25 17:50:00,21,14,38,73,438
2016-03-25 18:00:00,10,9,26,45,270
2016-03-25 18:10:00,7,4,16,27,162
2016-03-25 18:20:00,2,0,5,7,42
2016-03-25 18:30:00,0,0,0,0,0
2016-03-25 18:40:00,0,0,0,0,0
2016-03-25 18:50:00,0,0,0,0,0
2016-03-26 05:30:00,0,0,0,0,0
2016-03-26 05:40:00,0,0,0,0,0
2016-03-26 05:50:00,0,0,0,0,0
2016-03-26 06:00:00,0,0,0,0,0
2016-03-26 06:10:00,4,1,5,10,60
2016-03-26 06:20:00,12,2,13,27,162
2016-03-26 06:30:00,13,5,18,36,216
2016-03-26 06:40:00,15,5,21,41,246
2016-03-26 06:50:00,11,20,43,74,444
2016-03-26 07:00:00,12,19,47,78,468
2016-03-26 07:10:00,25,34,72,131,786
2016-03-26 07:20:00,14,76,89,179,1074
2016-03-26 07:30:00,27,110,124,261,1566
2016-03-26 07:40:00,23,90,104,217,1302
2016-03-26 07:50:00,64,122,120,306,1836
2016-03-26 08:00:00,82,143,147,372,2232
2016-03-26 08:10:00,114,136,197,447,2682
2016-03-26 08:20:00,185,160,179,524,3144
2016-03-26 08:30:00,231,204,225,660,3960
2016-03-26 08:40:00,235,210,230,675,4050
2016-03-26 08:50:00,268,238,260,766,4596
2016-03-26 09:00:00,389,358,381,1128,6768
2016-03-26 09:10:00,321,290,316,927,5562
2016-03-26 09:20:00,492,473,501,1466,8796
2016-03-26 09:30:00,659,648,672,1979,11874
2016-03-26 09:40:00,862,851,880,2593,15558
2016-03-26 09:50:00,670,634,664,1968,11808
2016-03-26 10:00:00,917,879,910,2706,16236
2016-03-26 10:10:00,980,936,976,2892,17352
2016-03-26 10:20:00,966,939,967,2872,17232
2016-03-26 10:30:00,907,874,914,2695,16170
2016-03-26 10:40:00,1060,1026,1063,3149,18894
2016-03-26 10:50:00,812,783,814,2409,14454
2016-03-26 11:00:00,776,741,779,2296,13776
2016-03-26 11:10:00,779,751,790,2320,13920
2016-03-26 11:20:00,699,673,705,2077,12462
2016-03-26 11:30:00,790,764,799,2353,14118
2016-03-26 11:40:00,1127,1093,1124,3344,20064
2016-03-26 11:50:00,1096,1061,1097,3254,19524
2016-03-26 12:00:00,1085,1050,1085,3220,19320
2016-03-26 12:10:00,1088,1060,1089,3237,19422
2016-03-26 12:20:00,958,921,952,2831,16986
2016-03-26 12:30:00,1001,964,993,2958,17748
2016-03-26 12:40:00,938,909,938,2785,16710
2016-03-26 12:50:00,898,873,901,2672,16032
2016-03-26 13:00:00,1082,1029,1062,3173,19038
2016-03-26 13:10:00,1082,1030,1068,3180,19080
2016-03-26 13:20:00,1078,1036,1070,3184,19104
2016-03-26 13:30:00,1069,1023,1059,3151,18906
2016-03-26 13:40:00,1060,1014,1045,3119,18714
2016-03-26 13:50:00,977,933,967,2877,17262
2016-03-26 14:00:00,957,922,951,2830,16980
2016-03-26 14:10:00,891,853,881,2625,15750
2016-03-26 14:20:00,865,818,849,2532,15192
2016-03-26 14:30:00,817,775,804,2396,14376
2016-03-26 14:40:00,780,739,775,2294,13764
2016-03-26 14:50:00,733,695,726,2154,12924
2016-03-26 15:00:00,686,642,673,2001,12006
2016-03-26 15:10:00,596,550,582,1728,10368
2016-03-26 15:20:00,571,532,557,1660,9960
2016-03-26 15:30:00,493,460,480,1433,8598
2016-03-26 15:40:00,364,332,353,1049,6294
2016-03-26 15:50:00,373,344,364,1081,6486
2016-03-26 16:00:00,311,285,308,904,5424
2016-03-26 16:10:00,288,260,282,830,4980
2016-03-26 16:20:00,228,202,225,655,3930
2016-03-26 16:30:00,166,140,159,465,2790
2016-03-26 16:40:00,128,103,121,352,2112
2016-03-26 16:50:00,72,120,136,328,1968
2016-03-26 17:00:00,26,118,149,293,1758
2016-03-26 17:10:00,49,86,110,245,1470
2016-03-26 17:20:00,59,42,88,189,1134
2016-03-26 17:30:00,41,39,65,145,870
2016-03-26 17:40:00,29,16,61,106,636
2016-03-26 17:50:00,19,11,36,66,396
2016-03-26 18:00:00,14,4,17,35,210
2016-03-26 18:10:00,7,1,8,16,96
2016-03-26 18:20:00,1,0,1,2,12
2016-03-26 18:30:00,0,0,0,0,0
2016-03-26 18:40:00,0,0,0,0,0
2016-03-26 18:50:00,0,0,0,0,0
2016-03-27 06:30:00,0,0,0,0,0
2016-03-27 06:40:00,0,0,0,0,0
2016-03-27 06:50:00,0,0,0,0,0
2016-03-27 07:00:00,0,0,0,0,0
2016-03-27 07:10:00,3,4,2,9,54
2016-03-27 07:20:00,16,2,13,31,186
2016-03-27 07:30:00,16,4,17,37,222
2016-03-27 07:40:00,28,8,38,74,444
2016-03-27 07:50:00,31,28,67,126,756
2016-03-27 08:00:00,34,54,84,172,1032
2016-03-27 08:10:00,64,76,83,223,1338
2016-03-27 08:20:00,63,78,83,224,1344
2016-03-27 08:30:00,53,97,93,243,1458
2016-03-27 08:40:00,25,126,133,284,1704
2016-03-27 08:50:00,45,126,148,319,1914
2016-03-27 09:00:00,50,120,161,331,1986
2016-03-27 09:10:00,50,152,162,364,2184
2016-03-27 09:20:00,83,95,234,412,2472
2016-03-27 09:30:00,150,0,290,440,2640
2016-03-27 09:40:00,160,0,305,465,2790
2016-03-27 09:50:00,170,0,324,494,2964
2016-03-27 10:00:00,150,157,239,546,3276
2016-03-27 10:10:00,191,164,225,580,3480
2016-03-27 10:20:00,198,157,232,587,3522
2016-03-27 10:30:00,230,120,199,549,3294
2016-03-27 10:40:00,59,257,181,497,2982
2016-03-27 10:50:00,107,108,172,387,2322
2016-03-27 11:00:00,40,114,125,279,1674
2016-03-27 11:10:00,20,70,89,179,1074
2016-03-27 11:20:00,25,71,90,186,1116
2016-03-27 11:30:00,21,31,53,105,630
2016-03-27 11:40:00,15,19,40,74,444
2016-03-27 11:50:00,9,15,31,55,330
2016-03-27 12:00:00,7,15,27,49,294
2016-03-27 12:10:00,10,22,42,74,444
2016-03-27 12:20:00,27,18,44,89,534
2016-03-27 12:30:00,23,18,45,86,516
2016-03-27 12:40:00,27,20,55,102,612
2016-03-27 12:50:00,23,34,67,124,744
2016-03-27 13:00:00,22,52,77,151,906
2016-03-27 13:10:00,24,23,49,96,576
2016-03-27 13:20:00,14,8,29,51,306
2016-03-27 13:30:00,28,15,46,89,534
2016-03-27 13:40:00,37,33,65,135,810
2016-03-27 13:50:00,29,55,79,163,978
2016-03-27 14:00:00,12,79,94,185,1110
2016-03-27 14:10:00,40,59,92,191,1146
2016-03-27 14:20:00,36,58,86,180,1080
2016-03-27 14:30:00,26,57,80,163,978
2016-03-27 14:40:00,49,50,75,174,1044
2016-03-27 14:50:00,39,67,89,195,1170
2016-03-27 15:00:00,29,85,102,216,1296
2016-03-27 15:10:00,35,122,135,292,1752
2016-03-27 15:20:00,37,131,152,320,1920
2016-03-27 15:30:00,75,124,145,344,2064
2016-03-27 15:40:00,56,151,179,386,2316
2016-03-27 15:50:00,118,99,199,416,2496
2016-03-27 16:00:00,89,69,254,412,2472
2016-03-27 16:10:00,192,69,187,448,2688
2016-03-27 16:20:00,175,116,242,533,3198
2016-03-27 16:30:00,270,241,264,775,4650
2016-03-27 16:40:00,207,180,199,586,3516
2016-03-27 16:50:00,199,166,185,550,3300
2016-03-27 17:00:00,182,156,175,513,3078
2016-03-27 17:10:00,184,158,177,519,3114
2016-03-27 17:20:00,147,145,145,437,2622
2016-03-27 17:30:00,96,102,213,411,2466
2016-03-27 17:40:00,128,43,272,443,2658
2016-03-27 17:50:00,10,155,162,327,1962
2016-03-27 18:00:00,0,138,147,285,1710
2016-03-27 18:10:00,21,110,127,258,1548
2016-03-27 18:20:00,16,90,111,217,1302
2016-03-27 18:30:00,17,81,91,189,1134
2016-03-27 18:40:00,7,77,88,172,1032
2016-03-27 18:50:00,13,76,90,179,1074
2016-03-27 19:00:00,36,21,72,129,774
2016-03-27 19:10:00,22,13,34,69,414
2016-03-27 19:20:00,11,3,14,28,168
2016-03-27 19:30:00,6,2,9,17,102
2016-03-27 19:40:00,0,0,0,0,0
2016-03-27 19:50:00,0,0,0,0,0
2016-03-28 06:30:00,0,0,0,0,0
2016-03-28 06:40:00,0,0,0,0,0
2016-03-28 06:50:00,0,0,0,0,0
2016-03-28 07:00:00,3,2,4,9,54
2016-03-28 07:10:00,9,5,16,30,180
2016-03-28 07:20:00,10,12,29,51,306
2016-03-28 07:30:00,22,8,38,68,408
2016-03-28 07:40:00,27,11,44,82,492
2016-03-28 07:50:00,33,18,51,102,612
2016-03-28 08:00:00,26,21,75,122,732
2016-03-28 08:10:00,38,37,63,138,828
2016-03-28 08:20:00,50,30,73,153,918
2016-03-28 08:30:00,54,56,62,172,1032
2016-03-28 08:40:00,74,32,86,192,1152
2016-03-28 08:50:00,55,68,98,221,1326
2016-03-28 09:00:00,61,86,91,238,1428
2016-03-28 09:10:00,43,111,112,266,1596
2016-03-28 09:20:00,92,160,171,423,2538
2016-03-28 09:30:00,236,209,227,672,4032
2016-03-28 09:40:00,267,238,256,761,4566
2016-03-28 09:50:00,364,338,355,1057,6342
2016-03-28 10:00:00,515,493,507,1515,9090
2016-03-28 10:10:00,574,543,558,1675,10050
2016-03-28 10:20:00,667,628,654,1949,11694
2016-03-28 10:30:00,711,674,699,2084,12504
2016-03-28 10:40:00,664,632,654,1950,11700
2016-03-28 10:50:00,725,687,711,2123,12738
2016-03-28 11:00:00,724,686,718,2128,12768
2016-03-28 11:10:00,793,756,779,2328,13968
2016-03-28 11:20:00,755,720,740,2215,13290
2016-03-28 11:30:00,709,677,690,2076,12456
2016-03-28 11:40:00,499,467,482,1448,8688
2016-03-28 11:50:00,643,609,625,1877,11262
2016-03-28 12:00:00,743,697,719,2159,12954
2016-03-28 12:10:00,476,448,467,1391,8346
2016-03-28 12:20:00,478,459,474,1411,8466
2016-03-28 12:30:00,451,430,444,1325,7950
2016-03-28 12:40:00,449,424,437,1310,7860
2016-03-28 12:50:00,873,840,858,2571,15426
2016-03-28 13:00:00,311,286,302,899,5394
2016-03-28 13:10:00,234,214,227,675,4050
2016-03-28 13:20:00,259,237,249,745,4470
2016-03-28 13:30:00,237,214,227,678,4068
2016-03-28 13:40:00,183,162,173,518,3108
2016-03-28 13:50:00,140,94,134,368,2208
2016-03-28 14:00:00,128,94,162,384,2304
2016-03-28 14:10:00,304,155,151,610,3660
2016-03-28 14:20:00,315,266,267,848,5088
2016-03-28 14:30:00,264,241,253,758,4548
2016-03-28 14:40:00,201,178,191,570,3420
2016-03-28 14:50:00,200,176,190,566,3396
2016-03-28 15:00:00,276,250,267,793,4758
2016-03-28 15:10:00,226,200,217,643,3858
2016-03-28 15:20:00,146,152,161,459,2754
2016-03-28 15:30:00,178,42,191,411,2466
2016-03-28 15:40:00,143,65,237,445,2670
2016-03-28 15:50:00,70,100,88,258,1548
2016-03-28 16:00:00,104,125,135,364,2184
2016-03-28 16:10:00,137,110,161,408,2448
2016-03-28 16:20:00,123,78,166,367,2202
2016-03-28 16:30:00,19,128,131,278,1668
2016-03-28 16:40:00,57,97,110,264,1584
2016-03-28 16:50:00,42,39,73,154,924
2016-03-28 17:00:00,31,38,63,132,792
2016-03-28 17:10:00,34,12,47,93,558
2016-03-28 17:20:00,27,16,35,78,468
2016-03-28 17:30:00,14,10,20,44,264
2016-03-28 17:40:00,9,9,19,37,222
2016-03-28 17:50:00,9,10,10,29,174
2016-03-28 18:00:00,12,18,14,44,264
2016-03-28 18:10:00,3,16,11,30,180
2016-03-28 18:20:00,13,2,15,30,180
2016-03-28 18:30:00,15,3,16,34,204
2016-03-28 18:40:00,19,2,21,42,252
2016-03-28 18:50:00,45,25,66,136,816
2016-03-28 19:00:00,13,4,11,28,168
2016-03-28 19:10:00,2,0,2,4,24
2016-03-28 19:20:00,0,0,0,0,0
2016-03-28 19:30:00,0,0,0,0,0
2016-03-28 19:40:00,0,0,0,0,0
2016-03-28 19:50:00,0,0,0,0,0
2016-03-29 06:30:00,0,0,0,0,0
2016-03-29 06:40:00,0,0,0,0,0
2016-03-29 06:50:00,0,0,0,0,0
2016-03-29 07:00:00,1,1,4,6,36
2016-03-29 07:10:00,12,4,15,31,186
2016-03-29 07:20:00,20,5,25,50,300
2016-03-29 07:30:00,26,8,38,72,432
2016-03-29 07:40:00,35,14,50,99,594
2016-03-29 07:50:00,33,36,65,134,804
2016-03-29 08:00:00,44,37,75,156,936
2016-03-29 08:10:00,43,45,84,172,1032
2016-03-29 08:20:00,59,56,88,203,1218
2016-03-29 08:30:00,69,72,85,226,1356
2016-03-29 08:40:00,66,83,88,237,1422
2016-03-29 08:50:00,80,79,119,278,1668
2016-03-29 09:00:00,113,104,188,405,2430
2016-03-29 09:10:00,213,156,198,567,3402
2016-03-29 09:20:00,268,199,206,673,4038
2016-03-29 09:30:00,219,194,210,623,3738
2016-03-29 09:40:00,265,237,250,752,4512
2016-03-29 09:50:00,251,224,242,717,4302
2016-03-29 10:00:00,522,493,515,1530,9180
2016-03-29 10:10:00,716,681,704,2101,12606
2016-03-29 10:20:00,778,738,764,2280,13680
2016-03-29 10:30:00,825,783,813,2421,14526
2016-03-29 10:40:00,863,822,851,2536,15216
2016-03-29 10:50:00,895,850,882,2627,15762
2016-03-29 11:00:00,947,900,936,2783,16698
2016-03-29 11:10:00,954,906,941,2801,16806
2016-03-29 11:20:00,886,853,875,2614,15684
2016-03-29 11:30:00,848,813,837,2498,14988
2016-03-29 11:40:00,735,694,729,2158,12948
2016-03-29 11:50:00,414,376,403,1193,7158
2016-03-29 12:00:00,868,817,857,2542,15252
2016-03-29 12:10:00,971,927,968,2866,17196
2016-03-29 12:20:00,738,704,730,2172,13032
2016-03-29 12:30:00,1069,1022,1059,3150,18900
2016-03-29 12:40:00,925,883,916,2724,16344
2016-03-29 12:50:00,895,864,888,2647,15882
2016-03-29 13:00:00,931,901,923,2755,16530
2016-03-29 13:10:00,961,925,959,2845,17070
2016-03-29 13:20:00,1045,1007,1038,3090,18540
2016-03-29 13:30:00,599,566,589,1754,10524
2016-03-29 13:40:00,1033,1000,1032,3065,18390
2016-03-29 13:50:00,1035,1003,1039,3077,18462
2016-03-29 14:00:00,1023,989,1025,3037,18222
2016-03-29 14:10:00,988,947,982,2917,17502
2016-03-29 14:20:00,885,853,882,2620,15720
2016-03-29 14:30:00,748,733,749,2230,13380
2016-03-29 14:40:00,472,450,470,1392,8352
2016-03-29 14:50:00,624,594,618,1836,11016
2016-03-29 15:00:00,724,691,715,2130,12780
2016-03-29 15:10:00,534,505,528,1567,9402
2016-03-29 15:20:00,682,648,676,2006,12036
2016-03-29 15:30:00,773,739,769,2281,13686
2016-03-29 15:40:00,744,710,733,2187,13122
2016-03-29 15:50:00,781,745,771,2297,13782
2016-03-29 16:00:00,678,665,681,2024,12144
2016-03-29 16:10:00,639,619,634,1892,11352
2016-03-29 16:20:00,582,563,579,1724,10344
2016-03-29 16:30:00,569,551,560,1680,10080
2016-03-29 16:40:00,490,464,479,1433,8598
2016-03-29 16:50:00,445,413,435,1293,7758
2016-03-29 17:00:00,394,362,385,1141,6846
2016-03-29 17:10:00,335,304,326,965,5790
2016-03-29 17:20:00,280,253,275,808,4848
2016-03-29 17:30:00,229,207,226,662,3972
2016-03-29 17:40:00,177,156,170,503,3018
2016-03-29 17:50:00,118,125,147,390,2340
2016-03-29 18:00:00,149,9,148,306,1836
2016-03-29 18:10:00,41,76,100,217,1302
2016-03-29 18:20:00,16,58,74,148,888
2016-03-29 18:30:00,23,31,67,121,726
2016-03-29 18:40:00,31,35,41,107,642
2016-03-29 18:50:00,25,24,31,80,480
2016-03-29 19:00:00,22,21,16,59,354
2016-03-29 19:10:00,14,9,14,37,222
2016-03-29 19:20:00,5,3,8,16,96
2016-03-29 19:30:00,1,0,1,2,12
2016-03-29 19:40:00,0,0,0,0,0
2016-03-29 19:50:00,0,0,0,0,0
2016-03-29 20:00:00,0,0,0,0,0
2016-03-30 06:20:00,0,0,0,0,0
2016-03-30 06:30:00,0,0,0,0,0
2016-03-30 06:40:00,0,0,0,0,0
2016-03-30 06:50:00,0,0,0,0,0
2016-03-30 07:00:00,5,1,7,13,78
2016-03-30 07:10:00,8,2,12,22,132
2016-03-30 07:20:00,11,11,31,53,318
2016-03-30 07:30:00,17,18,47,82,492
2016-03-30 07:40:00,31,22,52,105,630
2016-03-30 07:50:00,22,44,74,140,840
2016-03-30 08:00:00,27,47,79,153,918
2016-03-30 08:10:00,31,37,50,118,708
2016-03-30 08:20:00,33,29,55,117,702
2016-03-30 08:30:00,16,17,45,78,468
2016-03-30 08:40:00,24,33,65,122,732
2016-03-30 08:50:00,27,56,82,165,990
2016-03-30 09:00:00,48,35,74,157,942
2016-03-30 09:10:00,28,28,68,124,744
2016-03-30 09:20:00,8,6,16,30,180
2016-03-30 09:30:00,10,6,19,35,210
2016-03-30 09:40:00,7,14,30,51,306
2016-03-30 09:50:00,10,8,27,45,270
2016-03-30 10:00:00,21,23,46,90,540
2016-03-30 10:10:00,13,25,47,85,510
2016-03-30 10:20:00,25,55,84,164,984
2016-03-30 10:30:00,27,100,118,245,1470
2016-03-30 10:40:00,0,137,129,266,1596
2016-03-30 10:50:00,0,139,137,276,1656
2016-03-30 11:00:00,8,148,158,314,1884
2016-03-30 11:10:00,49,151,175,375,2250
2016-03-30 11:20:00,81,111,142,334,2004
2016-03-30 11:30:00,47,128,232,407,2442
2016-03-30 11:40:00,147,77,289,513,3078
2016-03-30 11:50:00,162,35,244,441,2646
2016-03-30 12:00:00,100,134,206,440,2640
2016-03-30 12:10:00,217,57,231,505,3030
2016-03-30 12:20:00,108,142,174,424,2544
2016-03-30 12:30:00,76,73,185,334,2004
2016-03-30 12:40:00,30,140,171,341,2046
2016-03-30 12:50:00,170,1,325,496,2976
2016-03-30 13:00:00,110,106,267,483,2898
2016-03-30 13:10:00,229,99,241,569,3414
2016-03-30 13:20:00,216,191,211,618,3708
2016-03-30 13:30:00,261,234,254,749,4494
2016-03-30 13:40:00,232,206,222,660,3960
2016-03-30 13:50:00,214,189,205,608,3648
2016-03-30 14:00:00,216,189,208,613,3678
2016-03-30 14:10:00,226,200,218,644,3864
2016-03-30 14:20:00,163,134,206,503,3018
2016-03-30 14:30:00,416,396,445,1257,7542
2016-03-30 14:40:00,972,941,980,2893,17358
2016-03-30 14:50:00,723,683,717,2123,12738
2016-03-30 15:00:00,510,477,503,1490,8940
2016-03-30 15:10:00,966,932,967,2865,17190
2016-03-30 15:20:00,374,343,366,1083,6498
2016-03-30 15:30:00,499,473,500,1472,8832
2016-03-30 15:40:00,783,753,781,2317,13902
2016-03-30 15:50:00,566,532,562,1660,9960
2016-03-30 16:00:00,179,152,174,505,3030
2016-03-30 16:10:00,141,116,135,392,2352
2016-03-30 16:20:00,346,316,344,1006,6036
2016-03-30 16:30:00,182,155,175,512,3072
2016-03-30 16:40:00,24,141,162,327,1962
2016-03-30 16:50:00,403,370,401,1174,7044
2016-03-30 17:00:00,162,130,152,444,2664
2016-03-30 17:10:00,164,133,154,451,2706
2016-03-30 17:20:00,169,139,159,467,2802
2016-03-30 17:30:00,207,181,199,587,3522
2016-03-30 17:40:00,75,134,139,348,2088
2016-03-30 17:50:00,162,151,145,458,2748
2016-03-30 18:00:00,72,82,108,262,1572
2016-03-30 18:10:00,26,59,77,162,972
2016-03-30 18:20:00,37,78,87,202,1212
2016-03-30 18:30:00,35,26,57,118,708
2016-03-30 18:40:00,29,21,51,101,606
2016-03-30 18:50:00,15,5,16,36,216
2016-03-30 19:00:00,14,1,16,31,186
2016-03-30 19:10:00,4,1,4,9,54
2016-03-30 19:20:00,0,0,0,0,0
2016-03-30 19:30:00,0,0,0,0,0
2016-03-30 19:40:00,0,0,0,0,0
2016-03-30 19:50:00,0,0,0,0,0
2016-03-30 20:00:00,0,0,0,0,0
2016-03-31 06:20:00,0,0,0,0,0
2016-03-31 06:30:00,0,0,0,0,0
2016-03-31 06:40:00,0,0,0,0,0
2016-03-31 06:50:00,0,0,0,0,0
2016-03-31 07:00:00,3,1,4,8,48
2016-03-31 07:10:00,13,5,20,38,228
2016-03-31 07:20:00,12,14,36,62,372
2016-03-31 07:30:00,21,16,45,82,492
2016-03-31 07:40:00,35,16,53,104,624
2016-03-31 07:50:00,26,25,54,105,630
2016-03-31 08:00:00,26,36,68,130,780
2016-03-31 08:10:00,40,42,78,160,960
2016-03-31 08:20:00,39,55,88,182,1092
2016-03-31 08:30:00,45,63,89,197,1182
2016-03-31 08:40:00,24,107,118,249,1494
2016-03-31 08:50:00,121,149,169,439,2634
2016-03-31 09:00:00,171,146,164,481,2886
2016-03-31 09:10:00,148,164,192,504,3024
2016-03-31 09:20:00,179,153,172,504,3024
2016-03-31 09:30:00,195,170,187,552,3312
2016-03-31 09:40:00,382,355,370,1107,6642
2016-03-31 09:50:00,531,498,518,1547,9282
2016-03-31 10:00:00,666,629,653,1948,11688
2016-03-31 10:10:00,745,709,734,2188,13128
2016-03-31 10:20:00,601,569,592,1762,10572
2016-03-31 10:30:00,406,377,397,1180,7080
2016-03-31 10:40:00,555,524,547,1626,9756
2016-03-31 10:50:00,864,822,854,2540,15240
2016-03-31 11:00:00,950,907,939,2796,16776
2016-03-31 11:10:00,980,934,966,2880,17280
2016-03-31 11:20:00,1007,950,985,2942,17652
2016-03-31 11:30:00,974,915,951,2840,17040
2016-03-31 11:40:00,943,893,925,2761,16566
2016-03-31 11:50:00,1050,1001,1036,3087,18522
2016-03-31 12:00:00,1068,1012,1050,3130,18780
2016-03-31 12:10:00,1101,1045,1084,3230,19380
2016-03-31 12:20:00,1103,1048,1084,3235,19410
2016-03-31 12:30:00,1092,1048,1081,3221,19326
2016-03-31 12:40:00,1116,1076,1108,3300,19800
2016-03-31 12:50:00,1197,1144,1178,3519,21114
2016-03-31 13:00:00,1135,1083,1112,3330,19980
2016-03-31 13:10:00,610,575,596,1781,10686
2016-03-31 13:20:00,250,223,238,711,4266
2016-03-31 13:30:00,1258,1224,1241,3723,22338
2016-03-31 13:40:00,685,654,671,2010,12060
2016-03-31 13:50:00,760,721,748,2229,13374
2016-03-31 14:00:00,821,785,807,2413,14478
2016-03-31 14:10:00,582,545,566,1693,10158
2016-03-31 14:20:00,586,550,570,1706,10236
2016-03-31 14:30:00,672,637,659,1968,11808
2016-03-31 14:40:00,280,254,272,806,4836
2016-03-31 14:50:00,362,334,356,1052,6312
2016-03-31 15:00:00,257,231,249,737,4422
2016-03-31 15:10:00,460,415,457,1332,7992
2016-03-31 15:20:00,834,795,827,2456,14736
2016-03-31 15:30:00,347,321,339,1007,6042
2016-03-31 15:40:00,548,519,536,1603,9618
2016-03-31 15:50:00,481,457,477,1415,8490
2016-03-31 16:00:00,727,703,732,2162,12972
2016-03-31 16:10:00,666,640,668,1974,11844
2016-03-31 16:20:00,625,599,624,1848,11088
2016-03-31 16:30:00,577,550,577,1704,10224
2016-03-31 16:40:00,531,504,531,1566,9396
2016-03-31 16:50:00,473,445,471,1389,8334
2016-03-31 17:00:00,407,388,406,1201,7206
2016-03-31 17:10:00,349,333,349,1031,6186
2016-03-31 17:20:00,284,267,288,839,5034
2016-03-31 17:30:00,237,218,240,695,4170
2016-03-31 17:40:00,188,165,181,534,3204
2016-03-31 17:50:00,150,126,139,415,2490
2016-03-31 18:00:00,77,115,135,327,1962
2016-03-31 18:10:00,69,96,86,251,1506
2016-03-31 18:20:00,54,54,86,194,1164
2016-03-31 18:30:00,36,24,61,121,726
2016-03-31 18:40:00,27,25,54,106,636
2016-03-31 18:50:00,26,14,44,84,504
2016-03-31 19:00:00,21,11,34,66,396
2016-03-31 19:10:00,17,6,24,47,282
2016-03-31 19:20:00,12,3,15,30,180
2016-03-31 19:30:00,5,3,6,14,84
2016-03-31 19:40:00,0,0,0,0,0
2016-03-31 19:50:00,0,0,0,0,0
2016-03-31 20:00:00,0,0,0,0,0
2016-04-01 06:20:00,0,0,0,0,0
2016-04-01 06:30:00,0,0,0,0,0
2016-04-01 06:40:00,0,0,0,0,0
2016-04-01 06:50:00,1,0,2,3,18
2016-04-01 07:00:00,3,0,15,18,108
2016-04-01 07:10:00,9,4,18,31,186
2016-04-01 07:20:00,15,7,22,44,264
2016-04-01 07:30:00,22,6,31,59,354
2016-04-01 07:40:00,24,15,44,83,498
2016-04-01 07:50:00,26,24,49,99,594
2016-04-01 08:00:00,24,27,55,106,636
2016-04-01 08:10:00,24,30,56,110,660
2016-04-01 08:20:00,27,28,59,114,684
2016-04-01 08:30:00,13,9,100,122,732
2016-04-01 08:40:00,26,46,54,126,756
2016-04-01 08:50:00,29,42,63,134,804
2016-04-01 09:00:00,27,45,73,145,870
2016-04-01 09:10:00,288,265,287,840,5040
2016-04-01 09:20:00,406,378,400,1184,7104
2016-04-01 09:30:00,458,425,448,1331,7986
2016-04-01 09:40:00,549,514,539,1602,9612
2016-04-01 09:50:00,640,606,634,1880,11280
2016-04-01 10:00:00,725,689,722,2136,12816
2016-04-01 10:10:00,795,761,793,2349,14094
2016-04-01 10:20:00,841,809,842,2492,14952
2016-04-01 10:30:00,891,857,886,2634,15804
2016-04-01 10:40:00,925,890,923,2738,16428
2016-04-01 10:50:00,952,916,941,2809,16854
2016-04-01 11:00:00,982,939,964,2885,17310
2016-04-01 11:10:00,1003,958,989,2950,17700
2016-04-01 11:20:00,1023,982,1017,3022,18132
2016-04-01 11:30:00,1042,1003,1034,3079,18474
2016-04-01 11:40:00,1052,1015,1045,3112,18672
2016-04-01 11:50:00,1055,1030,1062,3147,18882
2016-04-01 12:00:00,1070,1036,1075,3181,19086
2016-04-01 12:10:00,1099,1049,1086,3234,19404
2016-04-01 12:20:00,1095,1053,1089,3237,19422
2016-04-01 12:30:00,1103,1061,1101,3265,19590
2016-04-01 12:40:00,1106,1067,1101,3274,19644
2016-04-01 12:50:00,1108,1067,1102,3277,19662
2016-04-01 13:00:00,1112,1071,1100,3283,19698
2016-04-01 13:10:00,1111,1067,1100,3278,19668
2016-04-01 13:20:00,1100,1064,1094,3258,19548
2016-04-01 13:30:00,1093,1054,1092,3239,19434
2016-04-01 13:40:00,1090,1064,1084,3238,19428
2016-04-01 13:50:00,1084,1062,1072,3218,19308
2016-04-01 14:00:00,1085,1035,1069,3189,19134
2016-04-01 14:10:00,1080,1028,1062,3170,19020
2016-04-01 14:20:00,1056,1018,1051,3125,18750
2016-04-01 14:30:00,1044,1003,1035,3082,18492
2016-04-01 14:40:00,1030,982,1020,3032,18192
2016-04-01 14:50:00,1003,960,995,2958,17748
2016-04-01 15:00:00,964,925,955,2844,17064
2016-04-01 15:10:00,929,900,923,2752,16512
2016-04-01 15:20:00,882,848,875,2605,15630
2016-04-01 15:30:00,839,805,836,2480,14880
2016-04-01 15:40:00,806,771,796,2373,14238
2016-04-01 15:50:00,765,729,754,2248,13488
2016-04-01 16:00:00,714,685,712,2111,12666
2016-04-01 16:10:00,659,629,655,1943,11658
2016-04-01 16:20:00,613,591,610,1814,10884
2016-04-01 16:30:00,567,538,559,1664,9984
2016-04-01 16:40:00,526,503,520,1549,9294
2016-04-01 16:50:00,445,419,443,1307,7842
2016-04-01 17:00:00,356,331,352,1039,6234
2016-04-01 17:10:00,309,283,303,895,5370
2016-04-01 17:20:00,248,223,241,712,4272
2016-04-01 17:30:00,168,143,162,473,2838
2016-04-01 17:40:00,160,136,155,451,2706
2016-04-01 17:50:00,156,133,151,440,2640
2016-04-01 18:00:00,103,80,97,280,1680
2016-04-01 18:10:00,13,128,128,269,1614
2016-04-01 18:20:00,56,84,114,254,1524
2016-04-01 18:30:00,54,54,89,197,1182
2016-04-01 18:40:00,32,29,74,135,810
2016-04-01 18:50:00,30,19,50,99,594
2016-04-01 19:00:00,19,17,41,77,462
2016-04-01 19:10:00,15,8,24,47,282
2016-04-01 19:20:00,9,2,12,23,138
2016-04-01 19:30:00,2,1,3,6,36
2016-04-01 19:40:00,0,0,0,0,0
2016-04-01 19:50:00,0,0,0,0,0
2016-04-01 20:00:00,0,0,0,0,0
2016-04-02 06:20:00,0,0,0,0,0
2016-04-02 06:30:00,0,0,0,0,0
2016-04-02 06:40:00,0,0,0,0,0
2016-04-02 06:50:00,1,0,3,4,24
2016-04-02 07:00:00,8,4,17,29,174
2016-04-02 07:10:00,14,13,34,61,366
2016-04-02 07:20:00,21,22,49,92,552
2016-04-02 07:30:00,25,32,70,127,762
2016-04-02 07:40:00,29,40,70,139,834
2016-04-02 07:50:00,34,40,70,144,864
2016-04-02 08:00:00,25,61,85,171,1026
2016-04-02 08:10:00,48,68,89,205,1230
2016-04-02 08:20:00,51,106,135,292,1752
2016-04-02 08:30:00,65,137,167,369,2214
2016-04-02 08:40:00,91,158,165,414,2484
2016-04-02 08:50:00,117,126,209,452,2712
2016-04-02 09:00:00,171,0,326,497,2982
2016-04-02 09:10:00,250,42,239,531,3186
2016-04-02 09:20:00,244,181,173,598,3588
2016-04-02 09:30:00,120,334,194,648,3888
2016-04-02 09:40:00,254,217,212,683,4098
2016-04-02 09:50:00,278,250,271,799,4794
2016-04-02 10:00:00,291,265,287,843,5058
2016-04-02 10:10:00,287,261,283,831,4986
2016-04-02 10:20:00,277,250,273,800,4800
2016-04-02 10:30:00,288,263,286,837,5022
2016-04-02 10:40:00,307,282,307,896,5376
2016-04-02 10:50:00,396,364,391,1151,6906
2016-04-02 11:00:00,480,446,476,1402,8412
2016-04-02 11:10:00,513,486,513,1512,9072
2016-04-02 11:20:00,433,400,428,1261,7566
2016-04-02 11:30:00,453,421,449,1323,7938
2016-04-02 11:40:00,565,525,553,1643,9858
2016-04-02 11:50:00,626,583,613,1822,10932
2016-04-02 12:00:00,601,566,592,1759,10554
2016-04-02 12:10:00,574,550,573,1697,10182
2016-04-02 12:20:00,614,599,614,1827,10962
2016-04-02 12:30:00,676,656,668,2000,12000
2016-04-02 12:40:00,809,780,798,2387,14322
2016-04-02 12:50:00,863,830,857,2550,15300
2016-04-02 13:00:00,840,808,837,2485,14910
2016-04-02 13:10:00,853,823,849,2525,15150
2016-04-02 13:20:00,882,843,866,2591,15546
2016-04-02 13:30:00,881,852,876,2609,15654
2016-04-02 13:40:00,981,950,966,2897,17382
2016-04-02 13:50:00,806,776,792,2374,14244
2016-04-02 14:00:00,773,744,764,2281,13686
2016-04-02 14:10:00,701,672,695,2068,12408
2016-04-02 14:20:00,701,668,696,2065,12390
2016-04-02 14:30:00,730,698,729,2157,12942
2016-04-02 14:40:00,647,613,640,1900,11400
2016-04-02 14:50:00,593,562,584,1739,10434
2016-04-02 15:00:00,488,459,480,1427,8562
2016-04-02 15:10:00,477,452,470,1399,8394
2016-04-02 15:20:00,403,378,397,1178,7068
2016-04-02 15:30:00,418,393,414,1225,7350
2016-04-02 15:40:00,356,329,348,1033,6198
2016-04-02 15:50:00,353,327,346,1026,6156
2016-04-02 16:00:00,391,365,382,1138,6828
2016-04-02 16:10:00,345,324,338,1007,6042
2016-04-02 16:20:00,295,273,290,858,5148
2016-04-02 16:30:00,281,258,274,813,4878
2016-04-02 16:40:00,414,390,408,1212,7272
2016-04-02 16:50:00,432,411,431,1274,7644
2016-04-02 17:00:00,344,327,341,1012,6072
2016-04-02 17:10:00,319,292,311,922,5532
2016-04-02 17:20:00,254,233,253,740,4440
2016-04-02 17:30:00,210,188,208,606,3636
2016-04-02 17:40:00,225,138,165,528,3168
2016-04-02 17:50:00,142,49,257,448,2688
2016-04-02 18:00:00,100,127,128,355,2130
2016-04-02 18:10:00,89,101,110,300,1800
2016-04-02 18:20:00,56,104,94,254,1524
2016-04-02 18:30:00,61,66,80,207,1242
2016-04-02 18:40:00,37,45,70,152,912
2016-04-02 18:50:00,40,38,76,154,924
2016-04-02 19:00:00,30,24,65,119,714
2016-04-02 19:10:00,23,7,35,65,390
2016-04-02 19:20:00,9,7,11,27,162
2016-04-02 19:30:00,1,2,3,6,36
2016-04-02 19:40:00,0,0,0,0,0
2016-04-02 19:50:00,0,0,0,0,0
2016-04-02 20:00:00,0,0,0,0,0
2016-04-03 06:20:00,0,0,0,0,0
2016-04-03 06:30:00,0,0,0,0,0
2016-04-03 06:40:00,0,0,0,0,0
2016-04-03 06:50:00,0,0,0,0,0
2016-04-03 07:00:00,0,0,0,0,0
2016-04-03 07:10:00,5,4,14,23,138
2016-04-03 07:20:00,16,13,39,68,408
2016-04-03 07:30:00,12,13,37,62,372
2016-04-03 07:40:00,14,13,38,65,390
2016-04-03 07:50:00,11,13,39,63,378
2016-04-03 08:00:00,18,19,49,86,516
2016-04-03 08:10:00,34,18,58,110,660
2016-04-03 08:20:00,26,41,86,153,918
2016-04-03 08:30:00,28,85,110,223,1338
2016-04-03 08:40:00,33,140,151,324,1944
2016-04-03 08:50:00,71,118,177,366,2196
2016-04-03 09:00:00,55,126,157,338,2028
2016-04-03 09:10:00,0,133,139,272,1632
2016-04-03 09:20:00,0,144,146,290,1740
2016-04-03 09:30:00,0,143,149,292,1752
2016-04-03 09:40:00,0,140,149,289,1734
2016-04-03 09:50:00,0,140,146,286,1716
2016-04-03 10:00:00,21,151,165,337,2022
2016-04-03 10:10:00,162,56,267,485,2910
2016-04-03 10:20:00,115,41,299,455,2730
2016-04-03 10:30:00,281,158,191,630,3780
2016-04-03 10:40:00,314,271,312,897,5382
2016-04-03 10:50:00,314,283,303,900,5400
2016-04-03 11:00:00,180,152,170,502,3012
2016-04-03 11:10:00,132,172,151,455,2730
2016-04-03 11:20:00,219,180,177,576,3456
2016-04-03 11:30:00,356,300,298,954,5724
2016-04-03 11:40:00,535,507,529,1571,9426
2016-04-03 11:50:00,441,411,434,1286,7716
2016-04-03 12:00:00,352,328,342,1022,6132
2016-04-03 12:10:00,482,454,474,1410,8460
2016-04-03 12:20:00,496,467,487,1450,8700
2016-04-03 12:30:00,471,442,464,1377,8262
2016-04-03 12:40:00,706,678,697,2081,12486
2016-04-03 12:50:00,852,826,839,2517,15102
2016-04-03 13:00:00,804,777,787,2368,14208
2016-04-03 13:10:00,508,482,497,1487,8922
2016-04-03 13:20:00,336,312,325,973,5838
2016-04-03 13:30:00,336,307,326,969,5814
2016-04-03 13:40:00,347,312,333,992,5952
2016-04-03 13:50:00,306,275,297,878,5268
2016-04-03 14:00:00,277,248,269,794,4764
2016-04-03 14:10:00,239,214,232,685,4110
2016-04-03 14:20:00,200,110,239,549,3294
2016-04-03 14:30:00,200,164,287,651,3906
2016-04-03 14:40:00,248,222,242,712,4272
2016-04-03 14:50:00,228,202,222,652,3912
2016-04-03 15:00:00,162,135,154,451,2706
2016-04-03 15:10:00,56,156,162,374,2244
2016-04-03 15:20:00,124,97,227,448,2688
2016-04-03 15:30:00,147,203,231,581,3486
2016-04-03 15:40:00,222,209,239,670,4020
2016-04-03 15:50:00,143,148,153,444,2664
2016-04-03 16:00:00,103,129,132,364,2184
2016-04-03 16:10:00,94,116,137,347,2082
2016-04-03 16:20:00,196,176,188,560,3360
2016-04-03 16:30:00,166,138,159,463,2778
2016-04-03 16:40:00,116,93,105,314,1884
2016-04-03 16:50:00,67,112,124,303,1818
2016-04-03 17:00:00,25,138,154,317,1902
2016-04-03 17:10:00,19,80,94,193,1158
2016-04-03 17:20:00,34,58,71,163,978
2016-04-03 17:30:00,42,123,111,276,1656
2016-04-03 17:40:00,15,85,105,205,1230
2016-04-03 17:50:00,9,79,85,173,1038
2016-04-03 18:00:00,21,100,113,234,1404
2016-04-03 18:10:00,58,72,90,220,1320
2016-04-03 18:20:00,22,69,87,178,1068
2016-04-03 18:30:00,39,55,56,150,900
2016-04-03 18:40:00,31,46,56,133,798
2016-04-03 18:50:00,20,20,29,69,414
2016-04-03 19:00:00,10,6,17,33,198
2016-04-03 19:10:00,6,10,11,27,162
2016-04-03 19:20:00,1,1,6,8,48
2016-04-03 19:30:00,0,0,0,0,0
2016-04-03 19:40:00,0,0,0,0,0
2016-04-03 19:50:00,0,0,0,0,0
2016-04-03 20:00:00,0,0,0,0,0
2016-04-04 06:10:00,0,0,0,0,0
2016-04-04 06:20:00,0,0,0,0,0
2016-04-04 06:30:00,0,0,0,0,0
2016-04-04 06:40:00,3,1,5,9,54
2016-04-04 06:50:00,8,5,13,26,156
2016-04-04 07:00:00,9,9,19,37,222
2016-04-04 07:10:00,15,18,34,67,402
2016-04-04 07:20:00,14,30,53,97,582
2016-04-04 07:30:00,23,25,64,112,672
2016-04-04 07:40:00,33,21,52,106,636
2016-04-04 07:50:00,28,31,69,128,768
2016-04-04 08:00:00,45,57,86,188,1128
2016-04-04 08:10:00,33,63,92,188,1128
2016-04-04 08:20:00,51,50,90,191,1146
2016-04-04 08:30:00,22,118,121,261,1566
2016-04-04 08:40:00,43,116,131,290,1740
2016-04-04 08:50:00,78,112,141,331,1986
2016-04-04 09:00:00,52,124,144,320,1920
2016-04-04 09:10:00,34,102,108,244,1464
2016-04-04 09:20:00,78,76,89,243,1458
2016-04-04 09:30:00,114,101,182,397,2382
2016-04-04 09:40:00,162,0,317,479,2874
2016-04-04 09:50:00,59,120,179,358,2148
2016-04-04 10:00:00,14,101,116,231,1386
2016-04-04 10:10:00,30,48,72,150,900
2016-04-04 10:20:00,27,123,205,355,2130
2016-04-04 10:30:00,140,94,262,496,2976
2016-04-04 10:40:00,141,48,243,432,2592
2016-04-04 10:50:00,45,124,149,318,1908
2016-04-04 11:00:00,74,164,158,396,2376
2016-04-04 11:10:00,113,144,150,407,2442
2016-04-04 11:20:00,22,137,149,308,1848
2016-04-04 11:30:00,41,139,187,367,2202
2016-04-04 11:40:00,13,133,143,289,1734
2016-04-04 11:50:00,35,120,138,293,1758
2016-04-04 12:00:00,19,131,144,294,1764
2016-04-04 12:10:00,57,108,174,339,2034
2016-04-04 12:20:00,286,204,247,737,4422
2016-04-04 12:30:00,390,352,375,1117,6702
2016-04-04 12:40:00,541,505,532,1578,9468
2016-04-04 12:50:00,581,548,574,1703,10218
2016-04-04 13:00:00,602,568,593,1763,10578
2016-04-04 13:10:00,317,292,309,918,5508
2016-04-04 13:20:00,150,127,135,412,2472
2016-04-04 13:30:00,148,124,139,411,2466
2016-04-04 13:40:00,221,195,212,628,3768
2016-04-04 13:50:00,211,185,203,599,3594
2016-04-04 14:00:00,294,265,286,845,5070
2016-04-04 14:10:00,262,236,259,757,4542
2016-04-04 14:20:00,313,286,306,905,5430
2016-04-04 14:30:00,428,398,419,1245,7470
2016-04-04 14:40:00,307,282,301,890,5340
2016-04-04 14:50:00,346,320,341,1007,6042
2016-04-04 15:00:00,283,261,276,820,4920
2016-04-04 15:10:00,369,345,363,1077,6462
2016-04-04 15:20:00,280,253,274,807,4842
2016-04-04 15:30:00,196,171,190,557,3342
2016-04-04 15:40:00,233,92,216,541,3246
2016-04-04 15:50:00,110,72,202,384,2304
2016-04-04 16:00:00,28,113,116,257,1542
2016-04-04 16:10:00,47,141,208,396,2376
2016-04-04 16:20:00,135,65,259,459,2754
2016-04-04 16:30:00,50,143,154,347,2082
2016-04-04 16:40:00,43,138,161,342,2052
2016-04-04 16:50:00,19,135,145,299,1794
2016-04-04 17:00:00,255,202,221,678,4068
2016-04-04 17:10:00,265,231,254,750,4500
2016-04-04 17:20:00,248,220,238,706,4236
2016-04-04 17:30:00,260,232,249,741,4446
2016-04-04 17:40:00,89,68,81,238,1428
2016-04-04 17:50:00,128,108,172,408,2448
2016-04-04 18:00:00,205,175,154,534,3204
2016-04-04 18:10:00,132,85,199,416,2496
2016-04-04 18:20:00,31,144,178,353,2118
2016-04-04 18:30:00,22,63,89,174,1044
2016-04-04 18:40:00,20,24,48,92,552
2016-04-04 18:50:00,15,14,30,59,354
2016-04-04 19:00:00,7,7,13,27,162
2016-04-04 19:10:00,3,2,4,9,54
2016-04-04 19:20:00,0,0,1,1,6
2016-04-04 19:30:00,0,0,0,0,0
2016-04-04 19:40:00,0,0,0,0,0
2016-04-04 19:50:00,0,0,0,0,0
2016-04-04 20:00:00,0,0,0,0,0
2016-04-05 06:20:00,0,0,0,0,0
2016-04-05 06:30:00,0,0,0,0,0
2016-04-05 06:40:00,0,0,0,0,0
2016-04-05 06:50:00,6,2,7,15,90
2016-04-05 07:00:00,9,2,16,27,162
2016-04-05 07:10:00,7,12,28,47,282
2016-04-05 07:20:00,7,15,33,55,330
2016-04-05 07:30:00,10,16,35,61,366
2016-04-05 07:40:00,9,15,35,59,354
2016-04-05 07:50:00,12,14,38,64,384
2016-04-05 08:00:00,11,9,24,44,264
2016-04-05 08:10:00,12,8,22,42,252
2016-04-05 08:20:00,26,29,64,119,714
2016-04-05 08:30:00,23,62,82,167,1002
2016-04-05 08:40:00,20,60,83,163,978
2016-04-05 08:50:00,19,30,83,132,792
2016-04-05 09:00:00,8,99,110,217,1302
2016-04-05 09:10:00,88,150,162,400,2400
2016-04-05 09:20:00,92,95,208,395,2370
2016-04-05 09:30:00,87,131,192,410,2460
2016-04-05 09:40:00,51,243,154,448,2688
2016-04-05 09:50:00,129,118,193,440,2640
2016-04-05 10:00:00,158,52,282,492,2952
2016-04-05 10:10:00,119,110,189,418,2508
2016-04-05 10:20:00,82,139,147,368,2208
2016-04-05 10:30:00,95,98,178,371,2226
2016-04-05 10:40:00,61,155,160,376,2256
2016-04-05 10:50:00,152,57,251,460,2760
2016-04-05 11:00:00,300,153,114,567,3402
2016-04-05 11:10:00,308,112,129,549,3294
2016-04-05 11:20:00,279,138,154,571,3426
2016-04-05 11:30:00,148,158,214,520,3120
2016-04-05 11:40:00,158,70,208,436,2616
2016-04-05 11:50:00,232,84,228,544,3264
2016-04-05 12:00:00,261,232,254,747,4482
2016-04-05 12:10:00,273,242,261,776,4656
2016-04-05 12:20:00,176,150,166,492,2952
2016-04-05 12:30:00,163,138,154,455,2730
2016-04-05 12:40:00,251,225,243,719,4314
2016-04-05 12:50:00,287,257,276,820,4920
2016-04-05 13:00:00,262,236,252,750,4500
2016-04-05 13:10:00,224,201,217,642,3852
2016-04-05 13:20:00,231,204,220,655,3930
2016-04-05 13:30:00,181,156,171,508,3048
2016-04-05 13:40:00,151,126,142,419,2514
2016-04-05 13:50:00,137,111,129,377,2262
2016-04-05 14:00:00,132,106,126,364,2184
2016-04-05 14:10:00,55,119,145,319,1914
2016-04-05 14:20:00,42,129,176,347,2082
2016-04-05 14:30:00,31,103,114,248,1488
2016-04-05 14:40:00,40,117,129,286,1716
2016-04-05 14:50:00,35,149,174,358,2148
2016-04-05 15:00:00,39,149,162,350,2100
2016-04-05 15:10:00,91,107,136,334,2004
2016-04-05 15:20:00,79,111,94,284,1704
2016-04-05 15:30:00,63,94,89,246,1476
2016-04-05 15:40:00,35,42,77,154,924
2016-04-05 15:50:00,32,53,65,150,900
2016-04-05 16:00:00,22,43,66,131,786
2016-04-05 16:10:00,37,30,59,126,756
2016-04-05 16:20:00,18,63,78,159,954
2016-04-05 16:30:00,29,38,56,123,738
2016-04-05 16:40:00,30,34,49,113,678
2016-04-05 16:50:00,31,55,79,165,990
2016-04-05 17:00:00,19,27,56,102,612
2016-04-05 17:10:00,17,30,53,100,600
2016-04-05 17:20:00,22,30,54,106,636
2016-04-05 17:30:00,18,29,68,115,690
2016-04-05 17:40:00,23,25,74,122,732
2016-04-05 17:50:00,25,40,85,150,900
2016-04-05 18:00:00,32,37,69,138,828
2016-04-05 18:10:00,12,30,49,91,546
2016-04-05 18:20:00,11,19,42,72,432
2016-04-05 18:30:00,17,14,38,69,414
2016-04-05 18:40:00,10,6,19,35,210
2016-04-05 18:50:00,5,1,7,13,78
2016-04-05 19:00:00,5,0,6,11,66
2016-04-05 19:10:00,1,0,1,2,12
2016-04-05 19:20:00,0,0,0,0,0
2016-04-05 19:30:00,0,0,0,0,0
2016-04-05 19:40:00,0,0,0,0,0
2016-04-05 19:50:00,0,0,0,0,0
2016-04-06 06:20:00,0,0,0,0,0
2016-04-06 06:30:00,0,0,0,0,0
2016-04-06 06:40:00,0,0,0,0,0
2016-04-06 06:50:00,0,0,0,0,0
2016-04-06 07:00:00,0,0,0,0,0
2016-04-06 07:10:00,8,1,9,18,108
2016-04-06 07:20:00,18,4,20,42,252
2016-04-06 07:30:00,49,50,78,177,1062
2016-04-06 07:40:00,48,80,99,227,1362
2016-04-06 07:50:00,27,112,121,260,1560
2016-04-06 08:00:00,40,84,109,233,1398
2016-04-06 08:10:00,18,132,154,304,1824
2016-04-06 08:20:00,28,78,102,208,1248
2016-04-06 08:30:00,35,19,49,103,618
2016-04-06 08:40:00,32,14,43,89,534
2016-04-06 08:50:00,65,38,80,183,1098
2016-04-06 09:00:00,71,18,70,159,954
2016-04-06 09:10:00,75,15,82,172,1032
2016-04-06 09:20:00,120,27,123,270,1620
2016-04-06 09:30:00,121,73,200,394,2364
2016-04-06 09:40:00,73,108,162,343,2058
2016-04-06 09:50:00,46,130,142,318,1908
2016-04-06 10:00:00,113,97,144,354,2124
2016-04-06 10:10:00,41,119,149,309,1854
2016-04-06 10:20:00,116,89,183,388,2328
2016-04-06 10:30:00,140,129,147,416,2496
2016-04-06 10:40:00,305,177,141,623,3738
2016-04-06 10:50:00,271,243,258,772,4632
2016-04-06 11:00:00,296,268,284,848,5088
2016-04-06 11:10:00,222,195,208,625,3750
2016-04-06 11:20:00,120,124,132,376,2256
2016-04-06 11:30:00,39,116,134,289,1734
2016-04-06 11:40:00,185,171,197,553,3318
2016-04-06 11:50:00,211,185,202,598,3588
2016-04-06 12:00:00,261,229,247,737,4422
2016-04-06 12:10:00,511,475,500,1486,8916
2016-04-06 12:20:00,777,734,765,2276,13656
2016-04-06 12:30:00,755,713,741,2209,13254
2016-04-06 12:40:00,238,208,225,671,4026
2016-04-06 12:50:00,243,209,220,672,4032
2016-04-06 13:00:00,417,386,402,1205,7230
2016-04-06 13:10:00,807,769,798,2374,14244
2016-04-06 13:20:00,808,777,806,2391,14346
2016-04-06 13:30:00,791,751,780,2322,13932
2016-04-06 13:40:00,908,872,891,2671,16026
2016-04-06 13:50:00,1077,1045,1051,3173,19038
2016-04-06 14:00:00,1064,1023,1043,3130,18780
2016-04-06 14:10:00,1043,995,1024,3062,18372
2016-04-06 14:20:00,322,292,313,927,5562
2016-04-06 14:30:00,562,532,558,1652,9912
2016-04-06 14:40:00,478,447,469,1394,8364
2016-04-06 14:50:00,501,470,490,1461,8766
2016-04-06 15:00:00,969,936,960,2865,17190
2016-04-06 15:10:00,252,226,246,724,4344
2016-04-06 15:20:00,276,248,268,792,4752
2016-04-06 15:30:00,719,683,707,2109,12654
2016-04-06 15:40:00,394,363,382,1139,6834
2016-04-06 15:50:00,252,223,243,718,4308
2016-04-06 16:00:00,150,124,144,418,2508
2016-04-06 16:10:00,173,148,166,487,2922
2016-04-06 16:20:00,94,98,113,305,1830
2016-04-06 16:30:00,221,205,232,658,3948
2016-04-06 16:40:00,42,94,114,250,1500
2016-04-06 16:50:00,30,28,54,112,672
2016-04-06 17:00:00,15,10,25,50,300
2016-04-06 17:10:00,27,30,60,117,702
2016-04-06 17:20:00,31,38,69,138,828
2016-04-06 17:30:00,63,120,150,333,1998
2016-04-06 17:40:00,19,58,73,150,900
2016-04-06 17:50:00,12,13,31,56,336
2016-04-06 18:00:00,5,8,23,36,216
2016-04-06 18:10:00,3,2,6,11,66
2016-04-06 18:20:00,5,5,13,23,138
2016-04-06 18:30:00,2,0,3,5,30
2016-04-06 18:40:00,0,0,0,0,0
2016-04-06 18:50:00,0,0,0,0,0
2016-04-06 19:00:00,0,0,0,0,0
2016-04-06 19:10:00,1,0,1,2,12
2016-04-06 19:20:00,1,0,1,2,12
2016-04-06 19:30:00,0,0,0,0,0
2016-04-06 19:40:00,0,0,0,0,0
2016-04-06 19:50:00,0,0,0,0,0
2016-04-06 20:00:00,0,0,0,0,0
2016-04-06 20:10:00,0,0,0,0,0
2016-04-07 06:00:00,0,0,0,0,0
2016-04-07 06:10:00,0,0,0,0,0
2016-04-07 06:20:00,0,0,0,0,0
2016-04-07 06:30:00,0,0,0,0,0
2016-04-07 06:40:00,0,0,0,0,0
2016-04-07 06:50:00,1,3,4,8,48
2016-04-07 07:00:00,16,13,33,62,372
2016-04-07 07:10:00,40,24,54,118,708
2016-04-07 07:20:00,28,67,78,173,1038
2016-04-07 07:30:00,34,103,113,250,1500
2016-04-07 07:40:00,42,53,86,181,1086
2016-04-07 07:50:00,71,101,166,338,2028
2016-04-07 08:00:00,48,67,98,213,1278
2016-04-07 08:10:00,38,44,67,149,894
2016-04-07 08:20:00,52,42,83,177,1062
2016-04-07 08:30:00,65,93,110,268,1608
2016-04-07 08:40:00,66,97,140,303,1818
2016-04-07 08:50:00,74,68,99,241,1446
2016-04-07 09:00:00,76,55,83,214,1284
2016-04-07 09:10:00,341,312,331,984,5904
2016-04-07 09:20:00,246,219,236,701,4206
2016-04-07 09:30:00,444,414,435,1293,7758
2016-04-07 09:40:00,647,615,638,1900,11400
2016-04-07 09:50:00,715,681,704,2100,12600
2016-04-07 10:00:00,774,741,767,2282,13692
2016-04-07 10:10:00,822,786,810,2418,14508
2016-04-07 10:20:00,890,862,877,2629,15774
2016-04-07 10:30:00,497,474,488,1459,8754
2016-04-07 10:40:00,181,167,195,543,3258
2016-04-07 10:50:00,866,820,848,2534,15204
2016-04-07 11:00:00,1015,976,999,2990,17940
2016-04-07 11:10:00,949,914,944,2807,16842
2016-04-07 11:20:00,483,449,472,1404,8424
2016-04-07 11:30:00,414,378,401,1193,7158
2016-04-07 11:40:00,353,309,350,1012,6072
2016-04-07 11:50:00,851,810,840,2501,15006
2016-04-07 12:00:00,911,861,895,2667,16002
2016-04-07 12:10:00,857,820,846,2523,15138
2016-04-07 12:20:00,1201,1154,1187,3542,21252
2016-04-07 12:30:00,763,723,757,2243,13458
2016-04-07 12:40:00,648,610,637,1895,11370
2016-04-07 12:50:00,351,321,339,1011,6066
2016-04-07 13:00:00,255,228,246,729,4374
2016-04-07 13:10:00,168,134,160,462,2772
2016-04-07 13:20:00,220,197,226,643,3858
2016-04-07 13:30:00,189,164,180,533,3198
2016-04-07 13:40:00,319,293,306,918,5508
2016-04-07 13:50:00,247,221,238,706,4236
2016-04-07 14:00:00,277,251,271,799,4794
2016-04-07 14:10:00,276,145,178,599,3594
2016-04-07 14:20:00,129,131,154,414,2484
2016-04-07 14:30:00,166,175,171,512,3072
2016-04-07 14:40:00,439,412,431,1282,7692
2016-04-07 14:50:00,266,241,257,764,4584
2016-04-07 15:00:00,467,438,454,1359,8154
2016-04-07 15:10:00,434,404,421,1259,7554
2016-04-07 15:20:00,474,445,461,1380,8280
2016-04-07 15:30:00,746,712,730,2188,13128
2016-04-07 15:40:00,650,627,638,1915,11490
2016-04-07 15:50:00,273,246,263,782,4692
2016-04-07 16:00:00,463,441,460,1364,8184
2016-04-07 16:10:00,304,277,294,875,5250
2016-04-07 16:20:00,386,359,379,1124,6744
2016-04-07 16:30:00,349,323,342,1014,6084
2016-04-07 16:40:00,263,236,252,751,4506
2016-04-07 16:50:00,172,149,164,485,2910
2016-04-07 17:00:00,265,241,258,764,4584
2016-04-07 17:10:00,160,131,160,451,2706
2016-04-07 17:20:00,163,140,154,457,2742
2016-04-07 17:30:00,166,144,157,467,2802
2016-04-07 17:40:00,167,144,160,471,2826
2016-04-07 17:50:00,136,142,137,415,2490
2016-04-07 18:00:00,109,127,101,337,2022
2016-04-07 18:10:00,171,141,172,484,2904
2016-04-07 18:20:00,112,133,145,390,2340
2016-04-07 18:30:00,33,90,103,226,1356
2016-04-07 18:40:00,29,46,74,149,894
2016-04-07 18:50:00,31,20,44,95,570
2016-04-07 19:00:00,31,8,37,76,456
2016-04-07 19:10:00,3,0,3,6,36
2016-04-07 19:20:00,0,0,0,0,0
2016-04-07 19:30:00,0,0,0,0,0
2016-04-07 19:40:00,0,0,0,0,0
2016-04-07 19:50:00,0,0,0,0,0
2016-04-07 20:00:00,0,0,0,0,0
2016-04-07 20:10:00,0,0,0,0,0
2016-04-08 06:10:00,0,0,0,0,0
2016-04-08 06:20:00,0,0,0,0,0
2016-04-08 06:30:00,0,0,0,0,0
2016-04-08 06:40:00,0,0,0,0,0
2016-04-08 06:50:00,0,0,0,0,0
2016-04-08 07:00:00,2,2,10,14,84
2016-04-08 07:10:00,9,11,28,48,288
2016-04-08 07:20:00,21,25,56,102,612
2016-04-08 07:30:00,29,46,70,145,870
2016-04-08 07:40:00,30,82,100,212,1272
2016-04-08 07:50:00,73,98,147,318,1908
2016-04-08 08:00:00,103,92,195,390,2340
2016-04-08 08:10:00,117,78,154,349,2094
2016-04-08 08:20:00,4,136,141,281,1686
2016-04-08 08:30:00,104,139,166,409,2454
2016-04-08 08:40:00,86,101,244,431,2586
2016-04-08 08:50:00,160,36,212,408,2448
2016-04-08 09:00:00,185,48,219,452,2712
2016-04-08 09:10:00,376,331,368,1075,6450
2016-04-08 09:20:00,407,372,394,1173,7038
2016-04-08 09:30:00,465,427,455,1347,8082
2016-04-08 09:40:00,474,441,465,1380,8280
2016-04-08 09:50:00,677,642,670,1989,11934
2016-04-08 10:00:00,717,683,706,2106,12636
2016-04-08 10:10:00,697,669,688,2054,12324
2016-04-08 10:20:00,804,769,795,2368,14208
2016-04-08 10:30:00,769,731,758,2258,13548
2016-04-08 10:40:00,919,882,912,2713,16278
2016-04-08 10:50:00,884,845,874,2603,15618
2016-04-08 11:00:00,971,929,963,2863,17178
2016-04-08 11:10:00,928,894,924,2746,16476
2016-04-08 11:20:00,946,914,938,2798,16788
2016-04-08 11:30:00,680,648,667,1995,11970
2016-04-08 11:40:00,752,710,731,2193,13158
2016-04-08 11:50:00,915,874,904,2693,16158
2016-04-08 12:00:00,967,927,949,2843,17058
2016-04-08 12:10:00,492,465,478,1435,8610
2016-04-08 12:20:00,970,937,952,2859,17154
2016-04-08 12:30:00,1167,1131,1141,3439,20634
2016-04-08 12:40:00,1188,1137,1158,3483,20898
2016-04-08 12:50:00,841,802,817,2460,14760
2016-04-08 13:00:00,336,308,326,970,5820
2016-04-08 13:10:00,259,206,256,721,4326
2016-04-08 13:20:00,797,769,786,2352,14112
2016-04-08 13:30:00,1198,1170,1198,3566,21396
2016-04-08 13:40:00,1189,1151,1171,3511,21066
2016-04-08 13:50:00,1177,1143,1165,3485,20910
2016-04-08 14:00:00,871,832,858,2561,15366
2016-04-08 14:10:00,565,532,554,1651,9906
2016-04-08 14:20:00,1206,1163,1188,3557,21342
2016-04-08 14:30:00,957,917,943,2817,16902
2016-04-08 14:40:00,952,917,934,2803,16818
2016-04-08 14:50:00,700,676,688,2064,12384
2016-04-08 15:00:00,615,581,604,1800,10800
2016-04-08 15:10:00,941,900,929,2770,16620
2016-04-08 15:20:00,506,470,493,1469,8814
2016-04-08 15:30:00,435,404,421,1260,7560
2016-04-08 15:40:00,569,535,553,1657,9942
2016-04-08 15:50:00,596,561,583,1740,10440
2016-04-08 16:00:00,232,206,222,660,3960
2016-04-08 16:10:00,168,85,147,400,2400
2016-04-08 16:20:00,167,56,202,425,2550
2016-04-08 16:30:00,267,231,248,746,4476
2016-04-08 16:40:00,421,392,413,1226,7356
2016-04-08 16:50:00,291,270,296,857,5142
2016-04-08 17:00:00,109,70,129,308,1848
2016-04-08 17:10:00,162,147,226,535,3210
2016-04-08 17:20:00,237,214,235,686,4116
2016-04-08 17:30:00,187,163,183,533,3198
2016-04-08 17:40:00,180,154,174,508,3048
2016-04-08 17:50:00,84,97,117,298,1788
2016-04-08 18:00:00,91,73,117,281,1686
2016-04-08 18:10:00,27,121,126,274,1644
2016-04-08 18:20:00,52,54,74,180,1080
2016-04-08 18:30:00,25,28,61,114,684
2016-04-08 18:40:00,16,27,49,92,552
2016-04-08 18:50:00,25,20,47,92,552
2016-04-08 19:00:00,35,38,49,122,732
2016-04-08 19:10:00,13,19,36,68,408
2016-04-08 19:20:00,12,3,15,30,180
2016-04-08 19:30:00,6,2,11,19,114
2016-04-08 19:40:00,1,0,2,3,18
2016-04-08 19:50:00,0,0,0,0,0
2016-04-08 20:00:00,0,0,0,0,0
2016-04-08 20:10:00,0,0,0,0,0
2016-04-08 20:20:00,0,0,0,0,0
2016-04-09 06:00:00,0,0,0,0,0
2016-04-09 06:10:00,0,0,0,0,0
2016-04-09 06:20:00,0,0,0,0,0
2016-04-09 06:30:00,1,1,2,4,24
2016-04-09 06:40:00,8,3,12,23,138
2016-04-09 06:50:00,19,12,38,69,414
2016-04-09 07:00:00,29,23,64,116,696
2016-04-09 07:10:00,41,41,77,159,954
2016-04-09 07:20:00,41,46,73,160,960
2016-04-09 07:30:00,30,51,81,162,972
2016-04-09 07:40:00,30,66,94,190,1140
2016-04-09 07:50:00,16,75,98,189,1134
2016-04-09 08:00:00,60,60,91,211,1266
2016-04-09 08:10:00,54,81,96,231,1386
2016-04-09 08:20:00,58,61,87,206,1236
2016-04-09 08:30:00,47,69,91,207,1242
2016-04-09 08:40:00,35,79,109,223,1338
2016-04-09 08:50:00,114,157,210,481,2886
2016-04-09 09:00:00,364,334,357,1055,6330
2016-04-09 09:10:00,441,415,437,1293,7758
2016-04-09 09:20:00,485,451,476,1412,8472
2016-04-09 09:30:00,484,450,475,1409,8454
2016-04-09 09:40:00,518,486,511,1515,9090
2016-04-09 09:50:00,684,657,675,2016,12096
2016-04-09 10:00:00,645,616,630,1891,11346
2016-04-09 10:10:00,801,766,784,2351,14106
2016-04-09 10:20:00,840,804,829,2473,14838
2016-04-09 10:30:00,649,617,641,1907,11442
2016-04-09 10:40:00,841,784,823,2448,14688
2016-04-09 10:50:00,979,921,956,2856,17136
2016-04-09 11:00:00,863,808,847,2518,15108
2016-04-09 11:10:00,443,406,435,1284,7704
2016-04-09 11:20:00,818,772,808,2398,14388
2016-04-09 11:30:00,1063,1015,1051,3129,18774
2016-04-09 11:40:00,1006,960,995,2961,17766
2016-04-09 11:50:00,1081,1036,1066,3183,19098
2016-04-09 12:00:00,1091,1038,1081,3210,19260
2016-04-09 12:10:00,1084,1033,1079,3196,19176
2016-04-09 12:20:00,1120,1069,1111,3300,19800
2016-04-09 12:30:00,835,798,829,2462,14772
2016-04-09 12:40:00,818,790,811,2419,14514
2016-04-09 12:50:00,667,630,654,1951,11706
2016-04-09 13:00:00,718,681,702,2101,12606
2016-04-09 13:10:00,1054,1011,1036,3101,18606
2016-04-09 13:20:00,1160,1115,1150,3425,20550
2016-04-09 13:30:00,1091,1037,1074,3202,19212
2016-04-09 13:40:00,1071,1019,1052,3142,18852
2016-04-09 13:50:00,815,772,801,2388,14328
2016-04-09 14:00:00,1157,1115,1143,3415,20490
2016-04-09 14:10:00,891,858,881,2630,15780
2016-04-09 14:20:00,1025,999,1025,3049,18294
2016-04-09 14:30:00,928,895,927,2750,16500
2016-04-09 14:40:00,801,777,806,2384,14304
2016-04-09 14:50:00,828,795,823,2446,14676
2016-04-09 15:00:00,868,831,864,2563,15378
2016-04-09 15:10:00,569,542,569,1680,10080
2016-04-09 15:20:00,783,760,784,2327,13962
2016-04-09 15:30:00,881,851,864,2596,15576
2016-04-09 15:40:00,726,696,711,2133,12798
2016-04-09 15:50:00,586,557,581,1724,10344
2016-04-09 16:00:00,559,530,555,1644,9864
2016-04-09 16:10:00,414,387,407,1208,7248
2016-04-09 16:20:00,418,390,410,1218,7308
2016-04-09 16:30:00,456,427,449,1332,7992
2016-04-09 16:40:00,370,343,362,1075,6450
2016-04-09 16:50:00,258,238,256,752,4512
2016-04-09 17:00:00,257,237,253,747,4482
2016-04-09 17:10:00,281,258,277,816,4896
2016-04-09 17:20:00,207,183,203,593,3558
2016-04-09 17:30:00,222,199,219,640,3840
2016-04-09 17:40:00,195,171,187,553,3318
2016-04-09 17:50:00,125,100,117,342,2052
2016-04-09 18:00:00,146,123,141,410,2460
2016-04-09 18:10:00,124,100,118,342,2052
2016-04-09 18:20:00,78,80,97,255,1530
2016-04-09 18:30:00,56,54,70,180,1080
2016-04-09 18:40:00,48,46,51,145,870
2016-04-09 18:50:00,20,27,74,121,726
2016-04-09 19:00:00,22,30,47,99,594
2016-04-09 19:10:00,23,15,42,80,480
2016-04-09 19:20:00,11,16,34,61,366
2016-04-09 19:30:00,6,11,28,45,270
2016-04-09 19:40:00,9,3,13,25,150
2016-04-09 19:50:00,1,0,2,3,18
2016-04-09 20:00:00,0,0,0,0,0
2016-04-09 20:10:00,0,0,0,0,0
2016-04-09 20:20:00,0,0,0,0,0
2016-04-10 06:00:00,0,0,0,0,0
2016-04-10 06:10:00,0,0,0,0,0
2016-04-10 06:20:00,0,0,0,0,0
2016-04-10 06:30:00,0,0,0,0,0
2016-04-10 06:40:00,3,2,7,12,72
2016-04-10 06:50:00,9,4,18,31,186
2016-04-10 07:00:00,21,10,36,67,402
2016-04-10 07:10:00,21,25,72,118,708
2016-04-10 07:20:00,29,47,78,154,924
2016-04-10 07:30:00,4,82,94,180,1080
2016-04-10 07:40:00,12,83,104,199,1194
2016-04-10 07:50:00,40,82,105,227,1362
2016-04-10 08:00:00,0,135,141,276,1656
2016-04-10 08:10:00,5,152,164,321,1926
2016-04-10 08:20:00,61,134,178,373,2238
2016-04-10 08:30:00,149,18,285,452,2712
2016-04-10 08:40:00,192,42,288,522,3132
2016-04-10 08:50:00,285,159,143,587,3522
2016-04-10 09:00:00,292,193,161,646,3876
2016-04-10 09:10:00,296,267,285,848,5088
2016-04-10 09:20:00,363,329,350,1042,6252
2016-04-10 09:30:00,434,393,421,1248,7488
2016-04-10 09:40:00,533,497,527,1557,9342
2016-04-10 09:50:00,569,539,574,1682,10092
2016-04-10 10:00:00,659,631,666,1956,11736
2016-04-10 10:10:00,697,670,697,2064,12384
2016-04-10 10:20:00,697,661,694,2052,12312
2016-04-10 10:30:00,667,621,659,1947,11682
2016-04-10 10:40:00,599,569,594,1762,10572
2016-04-10 10:50:00,644,620,645,1909,11454
2016-04-10 11:00:00,715,687,714,2116,12696
2016-04-10 11:10:00,616,573,614,1803,10818
2016-04-10 11:20:00,621,579,613,1813,10878
2016-04-10 11:30:00,598,554,584,1736,10416
2016-04-10 11:40:00,567,524,551,1642,9852
2016-04-10 11:50:00,546,506,530,1582,9492
2016-04-10 12:00:00,538,496,524,1558,9348
2016-04-10 12:10:00,593,544,577,1714,10284
2016-04-10 12:20:00,677,633,672,1982,11892
2016-04-10 12:30:00,655,620,655,1930,11580
2016-04-10 12:40:00,605,579,601,1785,10710
2016-04-10 12:50:00,717,687,714,2118,12708
2016-04-10 13:00:00,634,604,631,1869,11214
2016-04-10 13:10:00,651,618,649,1918,11508
2016-04-10 13:20:00,740,708,742,2190,13140
2016-04-10 13:30:00,857,821,861,2539,15234
2016-04-10 13:40:00,927,890,928,2745,16470
2016-04-10 13:50:00,985,949,981,2915,17490
2016-04-10 14:00:00,816,791,814,2421,14526
2016-04-10 14:10:00,860,836,865,2561,15366
2016-04-10 14:20:00,1005,986,1018,3009,18054
2016-04-10 14:30:00,928,903,944,2775,16650
2016-04-10 14:40:00,867,837,879,2583,15498
2016-04-10 14:50:00,692,664,698,2054,12324
2016-04-10 15:00:00,826,796,827,2449,14694
2016-04-10 15:10:00,847,827,849,2523,15138
2016-04-10 15:20:00,730,708,730,2168,13008
2016-04-10 15:30:00,837,805,835,2477,14862
2016-04-10 15:40:00,504,476,495,1475,8850
2016-04-10 15:50:00,445,416,438,1299,7794
2016-04-10 16:00:00,501,470,495,1466,8796
2016-04-10 16:10:00,732,706,740,2178,13068
2016-04-10 16:20:00,638,607,638,1883,11298
2016-04-10 16:30:00,592,565,591,1748,10488
2016-04-10 16:40:00,363,341,362,1066,6396
2016-04-10 16:50:00,284,264,285,833,4998
2016-04-10 17:00:00,292,272,293,857,5142
2016-04-10 17:10:00,225,203,223,651,3906
2016-04-10 17:20:00,183,157,177,517,3102
2016-04-10 17:30:00,160,135,154,449,2694
2016-04-10 17:40:00,74,92,293,459,2754
2016-04-10 17:50:00,133,32,280,445,2670
2016-04-10 18:00:00,143,22,290,455,2730
2016-04-10 18:10:00,174,0,327,501,3006
2016-04-10 18:20:00,143,55,289,487,2922
2016-04-10 18:30:00,128,215,171,514,3084
2016-04-10 18:40:00,138,70,218,426,2556
2016-04-10 18:50:00,15,139,150,304,1824
2016-04-10 19:00:00,16,86,99,201,1206
2016-04-10 19:10:00,23,32,71,126,756
2016-04-10 19:20:00,13,31,52,96,576
2016-04-10 19:30:00,12,15,41,68,408
2016-04-10 19:40:00,8,9,25,42,252
2016-04-10 19:50:00,6,1,10,17,102
2016-04-10 20:00:00,0,0,1,1,6
2016-04-10 20:10:00,0,0,0,0,0
2016-04-10 20:20:00,0,0,0,0,0
2016-04-10 20:30:00,0,0,0,0,0
2016-04-11 05:50:00,0,0,0,0,0
2016-04-11 06:00:00,0,0,0,0,0
2016-04-11 06:10:00,0,0,0,0,0
2016-04-11 06:20:00,0,0,0,0,0
2016-04-11 06:30:00,5,1,5,11,66
2016-04-11 06:40:00,9,2,13,24,144
2016-04-11 06:50:00,13,4,20,37,222
2016-04-11 07:00:00,17,9,25,51,306
2016-04-11 07:10:00,8,19,38,65,390
2016-04-11 07:20:00,12,22,51,85,510
2016-04-11 07:30:00,25,30,55,110,660
2016-04-11 07:40:00,15,15,96,126,756
2016-04-11 07:50:00,31,44,60,135,810
2016-04-11 08:00:00,28,52,61,141,846
2016-04-11 08:10:00,27,45,75,147,882
2016-04-11 08:20:00,34,38,75,147,882
2016-04-11 08:30:00,31,48,72,151,906
2016-04-11 08:40:00,159,148,143,450,2700
2016-04-11 08:50:00,319,294,311,924,5544
2016-04-11 09:00:00,413,385,406,1204,7224
2016-04-11 09:10:00,477,450,474,1401,8406
2016-04-11 09:20:00,542,511,543,1596,9576
2016-04-11 09:30:00,610,584,611,1805,10830
2016-04-11 09:40:00,681,651,681,2013,12078
2016-04-11 09:50:00,736,719,742,2197,13182
2016-04-11 10:00:00,779,773,793,2345,14070
2016-04-11 10:10:00,835,818,839,2492,14952
2016-04-11 10:20:00,895,857,887,2639,15834
2016-04-11 10:30:00,919,879,912,2710,16260
2016-04-11 10:40:00,942,905,938,2785,16710
2016-04-11 10:50:00,966,932,960,2858,17148
2016-04-11 11:00:00,997,964,973,2934,17604
2016-04-11 11:10:00,1012,985,1005,3002,18012
2016-04-11 11:20:00,1034,1007,1028,3069,18414
2016-04-11 11:30:00,1052,1021,1046,3119,18714
2016-04-11 11:40:00,1067,1035,1061,3163,18978
2016-04-11 11:50:00,1078,1048,1077,3203,19218
2016-04-11 12:00:00,1104,1067,1076,3247,19482
2016-04-11 12:10:00,1109,1083,1078,3270,19620
2016-04-11 12:20:00,1098,1078,1093,3269,19614
2016-04-11 12:30:00,1104,1079,1100,3283,19698
2016-04-11 12:40:00,1109,1083,1105,3297,19782
2016-04-11 12:50:00,1112,1083,1106,3301,19806
2016-04-11 13:00:00,1107,1071,1102,3280,19680
2016-04-11 13:10:00,1110,1072,1106,3288,19728
2016-04-11 13:20:00,1108,1067,1103,3278,19668
2016-04-11 13:30:00,1104,1073,1098,3275,19650
2016-04-11 13:40:00,1098,1072,1089,3259,19554
2016-04-11 13:50:00,1085,1062,1082,3229,19374
2016-04-11 14:00:00,1072,1043,1067,3182,19092
2016-04-11 14:10:00,1066,1043,1065,3174,19044
2016-04-11 14:20:00,1049,1025,1047,3121,18726
2016-04-11 14:30:00,1033,1013,1031,3077,18462
2016-04-11 14:40:00,1008,992,1006,3006,18036
2016-04-11 14:50:00,989,966,983,2938,17628
2016-04-11 15:00:00,958,932,951,2841,17046
2016-04-11 15:10:00,921,897,912,2730,16380
2016-04-11 15:20:00,889,865,880,2634,15804
2016-04-11 15:30:00,844,824,840,2508,15048
2016-04-11 15:40:00,815,793,807,2415,14490
2016-04-11 15:50:00,768,744,762,2274,13644
2016-04-11 16:00:00,726,700,722,2148,12888
2016-04-11 16:10:00,677,656,671,2004,12024
2016-04-11 16:20:00,628,606,626,1860,11160
2016-04-11 16:30:00,584,561,579,1724,10344
2016-04-11 16:40:00,540,521,533,1594,9564
2016-04-11 16:50:00,484,465,478,1427,8562
2016-04-11 17:00:00,433,411,425,1269,7614
2016-04-11 17:10:00,378,351,373,1102,6612
2016-04-11 17:20:00,317,293,311,921,5526
2016-04-11 17:30:00,267,241,258,766,4596
2016-04-11 17:40:00,218,195,212,625,3750
2016-04-11 17:50:00,181,176,188,545,3270
2016-04-11 18:00:00,132,167,152,451,2706
2016-04-11 18:10:00,118,129,104,351,2106
2016-04-11 18:20:00,54,110,92,256,1536
2016-04-11 18:30:00,34,68,79,181,1086
2016-04-11 18:40:00,30,37,68,135,810
2016-04-11 18:50:00,25,21,67,113,678
2016-04-11 19:00:00,32,15,47,94,564
2016-04-11 19:10:00,22,13,41,76,456
2016-04-11 19:20:00,12,13,35,60,360
2016-04-11 19:30:00,12,10,23,45,270
2016-04-11 19:40:00,9,6,15,30,180
2016-04-11 19:50:00,4,3,7,14,84
2016-04-11 20:00:00,0,0,0,0,0
2016-04-11 20:10:00,0,0,0,0,0
2016-04-11 20:20:00,0,0,0,0,0
2016-04-12 05:50:00,0,0,0,0,0
2016-04-12 06:00:00,0,0,0,0,0
2016-04-12 06:10:00,0,0,0,0,0
2016-04-12 06:20:00,1,1,2,4,24
2016-04-12 06:30:00,5,5,11,21,126
2016-04-12 06:40:00,11,10,23,44,264
2016-04-12 06:50:00,16,14,38,68,408
2016-04-12 07:00:00,21,24,49,94,564
2016-04-12 07:10:00,19,21,70,110,660
2016-04-12 07:20:00,31,20,52,103,618
2016-04-12 07:30:00,34,18,56,108,648
2016-04-12 07:40:00,30,43,74,147,882
2016-04-12 07:50:00,34,54,88,176,1056
2016-04-12 08:00:00,50,59,107,216,1296
2016-04-12 08:10:00,83,144,149,376,2256
2016-04-12 08:20:00,134,107,170,411,2466
2016-04-12 08:30:00,173,5,315,493,2958
2016-04-12 08:40:00,244,93,234,571,3426
2016-04-12 08:50:00,227,93,218,538,3228
2016-04-12 09:00:00,28,143,161,332,1992
2016-04-12 09:10:00,20,107,115,242,1452
2016-04-12 09:20:00,36,80,115,231,1386
2016-04-12 09:30:00,161,109,185,455,2730
2016-04-12 09:40:00,319,259,245,823,4938
2016-04-12 09:50:00,438,413,426,1277,7662
2016-04-12 10:00:00,398,373,388,1159,6954
2016-04-12 10:10:00,296,267,286,849,5094
2016-04-12 10:20:00,227,201,220,648,3888
2016-04-12 10:30:00,172,145,149,466,2796
2016-04-12 10:40:00,86,143,139,368,2208
2016-04-12 10:50:00,44,125,146,315,1890
2016-04-12 11:00:00,68,111,146,325,1950
2016-04-12 11:10:00,132,39,247,418,2508
2016-04-12 11:20:00,83,123,158,364,2184
2016-04-12 11:30:00,117,155,140,412,2472
2016-04-12 11:40:00,68,130,163,361,2166
2016-04-12 11:50:00,51,124,135,310,1860
2016-04-12 12:00:00,44,143,154,341,2046
2016-04-12 12:10:00,149,83,242,474,2844
2016-04-12 12:20:00,208,68,251,527,3162
2016-04-12 12:30:00,323,294,316,933,5598
2016-04-12 12:40:00,276,249,270,795,4770
2016-04-12 12:50:00,294,266,285,845,5070
2016-04-12 13:00:00,281,252,273,806,4836
2016-04-12 13:10:00,287,259,278,824,4944
2016-04-12 13:20:00,245,219,237,701,4206
2016-04-12 13:30:00,204,182,198,584,3504
2016-04-12 13:40:00,299,175,118,592,3552
2016-04-12 13:50:00,273,220,224,717,4302
2016-04-12 14:00:00,257,228,250,735,4410
2016-04-12 14:10:00,251,225,246,722,4332
2016-04-12 14:20:00,248,220,240,708,4248
2016-04-12 14:30:00,220,193,214,627,3762
2016-04-12 14:40:00,186,159,192,537,3222
2016-04-12 14:50:00,155,74,174,403,2418
2016-04-12 15:00:00,164,3,304,471,2826
2016-04-12 15:10:00,175,0,315,490,2940
2016-04-12 15:20:00,214,74,241,529,3174
2016-04-12 15:30:00,221,200,220,641,3846
2016-04-12 15:40:00,196,163,212,571,3426
2016-04-12 15:50:00,200,181,168,549,3294
2016-04-12 16:00:00,121,174,143,438,2628
2016-04-12 16:10:00,0,141,147,288,1728
2016-04-12 16:20:00,0,131,138,269,1614
2016-04-12 16:30:00,22,109,114,245,1470
2016-04-12 16:40:00,32,82,106,220,1320
2016-04-12 16:50:00,7,85,101,193,1158
2016-04-12 17:00:00,29,59,77,165,990
2016-04-12 17:10:00,9,76,92,177,1062
2016-04-12 17:20:00,27,49,73,149,894
2016-04-12 17:30:00,40,30,65,135,810
2016-04-12 17:40:00,46,35,77,158,948
2016-04-12 17:50:00,42,58,85,185,1110
2016-04-12 18:00:00,25,88,104,217,1302
2016-04-12 18:10:00,26,98,111,235,1410
2016-04-12 18:20:00,3,84,88,175,1050
2016-04-12 18:30:00,29,71,92,192,1152
2016-04-12 18:40:00,24,30,64,118,708
2016-04-12 18:50:00,13,29,47,89,534
2016-04-12 19:00:00,11,22,43,76,456
2016-04-12 19:10:00,17,12,37,66,396
2016-04-12 19:20:00,15,7,23,45,270
2016-04-12 19:30:00,8,2,11,21,126
2016-04-12 19:40:00,2,0,3,5,30
2016-04-12 19:50:00,0,0,0,0,0
2016-04-12 20:00:00,0,0,0,0,0
2016-04-12 20:10:00,0,0,0,0,0
2016-04-12 20:20:00,0,0,0,0,0
2016-04-13 05:50:00,0,0,0,0,0
2016-04-13 06:00:00,0,0,0,0,0
2016-04-13 06:10:00,0,0,0,0,0
2016-04-13 06:20:00,0,0,0,0,0
2016-04-13 06:30:00,0,0,0,0,0
2016-04-13 06:40:00,2,0,3,5,30
2016-04-13 06:50:00,5,0,7,12,72
2016-04-13 07:00:00,10,2,12,24,144
2016-04-13 07:10:00,18,11,33,62,372
2016-04-13 07:20:00,25,18,46,89,534
2016-04-13 07:30:00,28,15,45,88,528
2016-04-13 07:40:00,23,23,66,112,672
2016-04-13 07:50:00,31,40,70,141,846
2016-04-13 08:00:00,18,62,84,164,984
2016-04-13 08:10:00,33,47,83,163,978
2016-04-13 08:20:00,36,52,85,173,1038
2016-04-13 08:30:00,23,69,115,207,1242
2016-04-13 08:40:00,21,98,117,236,1416
2016-04-13 08:50:00,3,136,143,282,1692
2016-04-13 09:00:00,0,142,142,284,1704
2016-04-13 09:10:00,34,124,136,294,1764
2016-04-13 09:20:00,14,133,135,282,1692
2016-04-13 09:30:00,14,136,145,295,1770
2016-04-13 09:40:00,66,130,147,343,2058
2016-04-13 09:50:00,143,134,192,469,2814
2016-04-13 10:00:00,296,262,298,856,5136
2016-04-13 10:10:00,459,426,448,1333,7998
2016-04-13 10:20:00,448,412,436,1296,7776
2016-04-13 10:30:00,452,416,440,1308,7848
2016-04-13 10:40:00,430,397,419,1246,7476
2016-04-13 10:50:00,431,399,422,1252,7512
2016-04-13 11:00:00,458,424,449,1331,7986
2016-04-13 11:10:00,551,519,545,1615,9690
2016-04-13 11:20:00,468,438,461,1367,8202
2016-04-13 11:30:00,352,318,341,1011,6066
2016-04-13 11:40:00,299,267,287,853,5118
2016-04-13 11:50:00,335,302,324,961,5766
2016-04-13 12:00:00,313,281,302,896,5376
2016-04-13 12:10:00,238,210,226,674,4044
2016-04-13 12:20:00,258,195,185,638,3828
2016-04-13 12:30:00,275,247,265,787,4722
2016-04-13 12:40:00,304,277,297,878,5268
2016-04-13 12:50:00,328,298,317,943,5658
2016-04-13 13:00:00,349,318,338,1005,6030
2016-04-13 13:10:00,349,318,340,1007,6042
2016-04-13 13:20:00,355,320,343,1018,6108
2016-04-13 13:30:00,386,352,376,1114,6684
2016-04-13 13:40:00,380,349,371,1100,6600
2016-04-13 13:50:00,373,342,361,1076,6456
2016-04-13 14:00:00,382,351,370,1103,6618
2016-04-13 14:10:00,342,310,331,983,5898
2016-04-13 14:20:00,257,227,245,729,4374
2016-04-13 14:30:00,207,181,197,585,3510
2016-04-13 14:40:00,224,80,234,538,3228
2016-04-13 14:50:00,203,93,254,550,3300
2016-04-13 15:00:00,267,129,139,535,3210
2016-04-13 15:10:00,159,165,172,496,2976
2016-04-13 15:20:00,245,119,194,558,3348
2016-04-13 15:30:00,250,221,238,709,4254
2016-04-13 15:40:00,296,268,284,848,5088
2016-04-13 15:50:00,277,253,272,802,4812
2016-04-13 16:00:00,237,212,230,679,4074
2016-04-13 16:10:00,207,165,228,600,3600
2016-04-13 16:20:00,208,181,201,590,3540
2016-04-13 16:30:00,212,185,205,602,3612
2016-04-13 16:40:00,193,179,220,592,3552
2016-04-13 16:50:00,192,159,212,563,3378
2016-04-13 17:00:00,197,118,235,550,3300
2016-04-13 17:10:00,183,168,178,529,3174
2016-04-13 17:20:00,181,99,207,487,2922
2016-04-13 17:30:00,166,0,294,460,2760
2016-04-13 17:40:00,134,163,164,461,2766
2016-04-13 17:50:00,126,112,231,469,2814
2016-04-13 18:00:00,151,110,237,498,2988
2016-04-13 18:10:00,193,179,165,537,3222
2016-04-13 18:20:00,184,199,160,543,3258
2016-04-13 18:30:00,135,186,165,486,2916
2016-04-13 18:40:00,54,145,166,365,2190
2016-04-13 18:50:00,11,120,129,260,1560
2016-04-13 19:00:00,13,86,96,195,1170
2016-04-13 19:10:00,30,44,58,132,792
2016-04-13 19:20:00,10,20,42,72,432
2016-04-13 19:30:00,9,4,15,28,168
2016-04-13 19:40:00,0,0,1,1,6
2016-04-13 19:50:00,0,0,0,0,0
2016-04-13 20:00:00,0,0,0,0,0
2016-04-13 20:10:00,0,0,0,0,0
2016-04-13 20:20:00,0,0,0,0,0
2016-04-13 20:30:00,0,0,0,0,0
2016-04-14 05:50:00,0,0,0,0,0
2016-04-14 06:00:00,0,0,0,0,0
2016-04-14 06:10:00,0,0,0,0,0
2016-04-14 06:20:00,0,0,0,0,0
2016-04-14 06:30:00,1,0,2,3,18
2016-04-14 06:40:00,8,3,13,24,144
2016-04-14 06:50:00,22,16,38,76,456
2016-04-14 07:00:00,36,36,66,138,828
2016-04-14 07:10:00,18,20,86,124,744
2016-04-14 07:20:00,25,53,80,158,948
2016-04-14 07:30:00,35,73,102,210,1260
2016-04-14 07:40:00,0,132,140,272,1632
2016-04-14 07:50:00,0,137,145,282,1692
2016-04-14 08:00:00,35,55,87,177,1062
2016-04-14 08:10:00,30,32,63,125,750
2016-04-14 08:20:00,24,26,78,128,768
2016-04-14 08:30:00,22,23,49,94,564
2016-04-14 08:40:00,24,28,60,112,672
2016-04-14 08:50:00,32,46,77,155,930
2016-04-14 09:00:00,37,41,74,152,912
2016-04-14 09:10:00,31,94,114,239,1434
2016-04-14 09:20:00,94,134,180,408,2448
2016-04-14 09:30:00,350,306,310,966,5796
2016-04-14 09:40:00,387,355,376,1118,6708
2016-04-14 09:50:00,494,462,485,1441,8646
2016-04-14 10:00:00,377,347,367,1091,6546
2016-04-14 10:10:00,822,781,811,2414,14484
2016-04-14 10:20:00,873,839,869,2581,15486
2016-04-14 10:30:00,602,568,595,1765,10590
2016-04-14 10:40:00,861,823,856,2540,15240
2016-04-14 10:50:00,1046,1014,1041,3101,18606
2016-04-14 11:00:00,633,605,624,1862,11172
2016-04-14 11:10:00,725,691,716,2132,12792
2016-04-14 11:20:00,777,745,775,2297,13782
2016-04-14 11:30:00,1064,1026,1056,3146,18876
2016-04-14 11:40:00,1056,1013,1041,3110,18660
2016-04-14 11:50:00,937,894,916,2747,16482
2016-04-14 12:00:00,766,737,750,2253,13518
2016-04-14 12:10:00,948,922,932,2802,16812
2016-04-14 12:20:00,1142,1109,1112,3363,20178
2016-04-14 12:30:00,1034,980,1008,3022,18132
2016-04-14 12:40:00,168,141,158,467,2802
2016-04-14 12:50:00,77,71,87,235,1410
2016-04-14 13:00:00,53,57,82,192,1152
2016-04-14 13:10:00,41,118,135,294,1764
2016-04-14 13:20:00,53,111,156,320,1920
2016-04-14 13:30:00,92,111,150,353,2118
2016-04-14 13:40:00,186,84,229,499,2994
2016-04-14 13:50:00,340,308,329,977,5862
2016-04-14 14:00:00,510,471,497,1478,8868
2016-04-14 14:10:00,350,319,339,1008,6048
2016-04-14 14:20:00,591,560,576,1727,10362
2016-04-14 14:30:00,380,356,372,1108,6648
2016-04-14 14:40:00,294,271,289,854,5124
2016-04-14 14:50:00,260,238,253,751,4506
2016-04-14 15:00:00,225,200,217,642,3852
2016-04-14 15:10:00,209,182,201,592,3552
2016-04-14 15:20:00,279,249,269,797,4782
2016-04-14 15:30:00,289,260,279,828,4968
2016-04-14 15:40:00,308,280,298,886,5316
2016-04-14 15:50:00,329,301,321,951,5706
2016-04-14 16:00:00,192,168,188,548,3288
2016-04-14 16:10:00,421,398,418,1237,7422
2016-04-14 16:20:00,662,637,658,1957,11742
2016-04-14 16:30:00,596,567,587,1750,10500
2016-04-14 16:40:00,542,510,533,1585,9510
2016-04-14 16:50:00,479,451,472,1402,8412
2016-04-14 17:00:00,277,251,270,798,4788
2016-04-14 17:10:00,392,366,386,1144,6864
2016-04-14 17:20:00,308,288,309,905,5430
2016-04-14 17:30:00,251,232,255,738,4428
2016-04-14 17:40:00,249,225,248,722,4332
2016-04-14 17:50:00,181,177,205,563,3378
2016-04-14 18:00:00,68,128,155,351,2106
2016-04-14 18:10:00,175,134,171,480,2880
2016-04-14 18:20:00,79,144,161,384,2304
2016-04-14 18:30:00,32,151,165,348,2088
2016-04-14 18:40:00,19,118,127,264,1584
2016-04-14 18:50:00,46,53,71,170,1020
2016-04-14 19:00:00,28,24,61,113,678
2016-04-14 19:10:00,36,20,60,116,696
2016-04-14 19:20:00,19,11,35,65,390
2016-04-14 19:30:00,8,5,12,25,150
2016-04-14 19:40:00,10,14,16,40,240
2016-04-14 19:50:00,3,1,5,9,54
2016-04-14 20:00:00,0,0,0,0,0
2016-04-14 20:10:00,0,0,0,0,0
2016-04-14 20:20:00,0,0,0,0,0
2016-04-15 05:40:00,0,0,0,0,0
2016-04-15 05:50:00,0,0,0,0,0
2016-04-15 06:00:00,0,0,0,0,0
2016-04-15 06:10:00,0,0,0,0,0
2016-04-15 06:20:00,0,0,0,0,0
2016-04-15 06:30:00,4,1,4,9,54
2016-04-15 06:40:00,11,6,17,34,204
2016-04-15 06:50:00,11,4,15,30,180
2016-04-15 07:00:00,18,24,45,87,522
2016-04-15 07:10:00,21,25,50,96,576
2016-04-15 07:20:00,30,72,90,192,1152
2016-04-15 07:30:00,31,43,69,143,858
2016-04-15 07:40:00,11,112,121,244,1464
2016-04-15 07:50:00,143,135,188,466,2796
2016-04-15 08:00:00,134,161,129,424,2544
2016-04-15 08:10:00,165,25,275,465,2790
2016-04-15 08:20:00,100,71,225,396,2376
2016-04-15 08:30:00,12,65,102,179,1074
2016-04-15 08:40:00,12,104,116,232,1392
2016-04-15 08:50:00,59,88,161,308,1848
2016-04-15 09:00:00,101,56,237,394,2364
2016-04-15 09:10:00,28,64,89,181,1086
2016-04-15 09:20:00,17,30,52,99,594
2016-04-15 09:30:00,31,53,76,160,960
2016-04-15 09:40:00,18,81,94,193,1158
2016-04-15 09:50:00,27,52,81,160,960
2016-04-15 10:00:00,9,16,36,61,366
2016-04-15 10:10:00,16,26,44,86,516
2016-04-15 10:20:00,54,123,139,316,1896
2016-04-15 10:30:00,414,390,407,1211,7266
2016-04-15 10:40:00,706,681,702,2089,12534
2016-04-15 10:50:00,538,512,537,1587,9522
2016-04-15 11:00:00,527,505,530,1562,9372
2016-04-15 11:10:00,540,511,539,1590,9540
2016-04-15 11:20:00,576,538,569,1683,10098
2016-04-15 11:30:00,786,755,787,2328,13968
2016-04-15 11:40:00,906,877,907,2690,16140
2016-04-15 11:50:00,984,948,988,2920,17520
2016-04-15 12:00:00,962,932,963,2857,17142
2016-04-15 12:10:00,862,840,862,2564,15384
2016-04-15 12:20:00,400,379,396,1175,7050
2016-04-15 12:30:00,356,334,350,1040,6240
2016-04-15 12:40:00,484,456,474,1414,8484
2016-04-15 12:50:00,434,404,426,1264,7584
2016-04-15 13:00:00,600,558,587,1745,10470
2016-04-15 13:10:00,518,486,506,1510,9060
2016-04-15 13:20:00,841,806,829,2476,14856
2016-04-15 13:30:00,600,569,589,1758,10548
2016-04-15 13:40:00,890,859,873,2622,15732
2016-04-15 13:50:00,681,662,686,2029,12174
2016-04-15 14:00:00,527,506,528,1561,9366
2016-04-15 14:10:00,441,417,430,1288,7728
2016-04-15 14:20:00,294,272,288,854,5124
2016-04-15 14:30:00,407,382,398,1187,7122
2016-04-15 14:40:00,356,330,346,1032,6192
2016-04-15 14:50:00,657,636,650,1943,11658
2016-04-15 15:00:00,666,639,651,1956,11736
2016-04-15 15:10:00,369,342,358,1069,6414
2016-04-15 15:20:00,239,212,230,681,4086
2016-04-15 15:30:00,222,195,213,630,3780
2016-04-15 15:40:00,239,211,228,678,4068
2016-04-15 15:50:00,256,203,202,661,3966
2016-04-15 16:00:00,264,237,254,755,4530
2016-04-15 16:10:00,311,259,254,824,4944
2016-04-15 16:20:00,471,438,460,1369,8214
2016-04-15 16:30:00,489,458,476,1423,8538
2016-04-15 16:40:00,494,472,492,1458,8748
2016-04-15 16:50:00,447,414,437,1298,7788
2016-04-15 17:00:00,400,369,391,1160,6960
2016-04-15 17:10:00,342,316,338,996,5976
2016-04-15 17:20:00,280,260,281,821,4926
2016-04-15 17:30:00,259,235,256,750,4500
2016-04-15 17:40:00,200,178,199,577,3462
2016-04-15 17:50:00,209,185,209,603,3618
2016-04-15 18:00:00,181,156,175,512,3072
2016-04-15 18:10:00,152,26,276,454,2724
2016-04-15 18:20:00,115,103,183,401,2406
2016-04-15 18:30:00,33,92,112,237,1422
2016-04-15 18:40:00,20,26,81,127,762
2016-04-15 18:50:00,28,32,58,118,708
2016-04-15 19:00:00,22,20,40,82,492
2016-04-15 19:10:00,22,27,23,72,432
2016-04-15 19:20:00,13,16,15,44,264
2016-04-15 19:30:00,6,8,12,26,156
2016-04-15 19:40:00,6,8,9,23,138
2016-04-15 19:50:00,2,4,5,11,66
2016-04-15 20:00:00,0,0,0,0,0
2016-04-15 20:10:00,0,0,0,0,0
2016-04-15 20:20:00,0,0,0,0,0
2016-04-15 20:30:00,0,0,0,0,0
2016-04-16 05:50:00,0,0,0,0,0
2016-04-16 06:00:00,0,0,0,0,0
2016-04-16 06:10:00,0,0,0,0,0
2016-04-16 06:20:00,0,0,0,0,0
2016-04-16 06:30:00,0,0,0,0,0
2016-04-16 06:40:00,0,0,0,0,0
2016-04-16 06:50:00,0,0,0,0,0
2016-04-16 07:00:00,0,0,0,0,0
2016-04-16 07:10:00,4,2,9,15,90
2016-04-16 07:20:00,8,3,16,27,162
2016-04-16 07:30:00,14,7,26,47,282
2016-04-16 07:40:00,23,11,36,70,420
2016-04-16 07:50:00,11,11,31,53,318
2016-04-16 08:00:00,8,11,34,53,318
2016-04-16 08:10:00,11,17,41,69,414
2016-04-16 08:20:00,18,20,55,93,558
2016-04-16 08:30:00,28,56,83,167,1002
2016-04-16 08:40:00,53,114,185,352,2112
2016-04-16 08:50:00,264,228,270,762,4572
2016-04-16 09:00:00,308,279,301,888,5328
2016-04-16 09:10:00,295,269,290,854,5124
2016-04-16 09:20:00,162,128,130,420,2520
2016-04-16 09:30:00,215,240,241,696,4176
2016-04-16 09:40:00,353,332,349,1034,6204
2016-04-16 09:50:00,157,169,212,538,3228
2016-04-16 10:00:00,227,199,233,659,3954
2016-04-16 10:10:00,233,207,227,667,4002
2016-04-16 10:20:00,250,225,250,725,4350
2016-04-16 10:30:00,260,235,259,754,4524
2016-04-16 10:40:00,248,228,262,738,4428
2016-04-16 10:50:00,276,255,275,806,4836
2016-04-16 11:00:00,276,260,283,819,4914
2016-04-16 11:10:00,92,229,231,552,3312
2016-04-16 11:20:00,214,207,244,665,3990
2016-04-16 11:30:00,139,174,135,448,2688
2016-04-16 11:40:00,203,179,249,631,3786
2016-04-16 11:50:00,192,171,190,553,3318
2016-04-16 12:00:00,198,175,195,568,3408
2016-04-16 12:10:00,199,170,221,590,3540
2016-04-16 12:20:00,226,204,221,651,3906
2016-04-16 12:30:00,429,403,423,1255,7530
2016-04-16 12:40:00,493,467,487,1447,8682
2016-04-16 12:50:00,771,750,768,2289,13734
2016-04-16 13:00:00,351,326,344,1021,6126
2016-04-16 13:10:00,283,261,280,824,4944
2016-04-16 13:20:00,255,218,232,705,4230
2016-04-16 13:30:00,287,261,281,829,4974
2016-04-16 13:40:00,281,255,274,810,4860
2016-04-16 13:50:00,265,238,259,762,4572
2016-04-16 14:00:00,230,205,224,659,3954
2016-04-16 14:10:00,245,205,257,707,4242
2016-04-16 14:20:00,413,392,411,1216,7296
2016-04-16 14:30:00,156,131,150,437,2622
2016-04-16 14:40:00,77,170,142,389,2334
2016-04-16 14:50:00,128,146,173,447,2682
2016-04-16 15:00:00,111,88,168,367,2202
2016-04-16 15:10:00,58,51,70,179,1074
2016-04-16 15:20:00,39,41,55,135,810
2016-04-16 15:30:00,54,44,81,179,1074
2016-04-16 15:40:00,219,99,249,567,3402
2016-04-16 15:50:00,196,152,192,540,3240
2016-04-16 16:00:00,314,279,328,921,5526
2016-04-16 16:10:00,295,272,286,853,5118
2016-04-16 16:20:00,633,606,603,1842,11052
2016-04-16 16:30:00,473,449,467,1389,8334
2016-04-16 16:40:00,247,224,242,713,4278
2016-04-16 16:50:00,438,409,433,1280,7680
2016-04-16 17:00:00,370,346,366,1082,6492
2016-04-16 17:10:00,224,219,239,682,4092
2016-04-16 17:20:00,349,323,340,1012,6072
2016-04-16 17:30:00,294,268,285,847,5082
2016-04-16 17:40:00,239,214,229,682,4092
2016-04-16 17:50:00,196,174,191,561,3366
2016-04-16 18:00:00,159,143,166,468,2808
2016-04-16 18:10:00,135,116,135,386,2316
2016-04-16 18:20:00,78,101,112,291,1746
2016-04-16 18:30:00,30,77,86,193,1158
2016-04-16 18:40:00,40,58,56,154,924
2016-04-16 18:50:00,31,36,61,128,768
2016-04-16 19:00:00,29,28,46,103,618
2016-04-16 19:10:00,20,28,40,88,528
2016-04-16 19:20:00,11,17,34,62,372
2016-04-16 19:30:00,14,9,25,48,288
2016-04-16 19:40:00,19,6,28,53,318
2016-04-16 19:50:00,11,2,10,23,138
2016-04-16 20:00:00,3,0,4,7,42
2016-04-16 20:10:00,0,0,0,0,0
2016-04-16 20:20:00,0,0,0,0,0
2016-04-16 20:30:00,0,0,0,0,0
2016-04-17 05:40:00,0,0,0,0,0
2016-04-17 05:50:00,0,0,0,0,0
2016-04-17 06:00:00,0,0,0,0,0
2016-04-17 06:10:00,0,1,0,1,6
2016-04-17 06:20:00,0,0,0,0,0
2016-04-17 06:30:00,13,2,12,27,162
2016-04-17 06:40:00,29,4,36,69,414
2016-04-17 06:50:00,16,7,21,44,264
2016-04-17 07:00:00,29,31,63,123,738
2016-04-17 07:10:00,24,110,121,255,1530
2016-04-17 07:20:00,54,98,95,247,1482
2016-04-17 07:30:00,100,88,132,320,1920
2016-04-17 07:40:00,81,101,132,314,1884
2016-04-17 07:50:00,43,125,140,308,1848
2016-04-17 08:00:00,163,156,209,528,3168
2016-04-17 08:10:00,184,139,207,530,3180
2016-04-17 08:20:00,154,173,169,496,2976
2016-04-17 08:30:00,77,141,141,359,2154
2016-04-17 08:40:00,188,195,206,589,3534
2016-04-17 08:50:00,144,133,150,427,2562
2016-04-17 09:00:00,301,275,294,870,5220
2016-04-17 09:10:00,308,281,299,888,5328
2016-04-17 09:20:00,223,201,215,639,3834
2016-04-17 09:30:00,235,207,225,667,4002
2016-04-17 09:40:00,221,195,211,627,3762
2016-04-17 09:50:00,365,334,355,1054,6324
2016-04-17 10:00:00,294,266,284,844,5064
2016-04-17 10:10:00,277,249,267,793,4758
2016-04-17 10:20:00,307,279,295,881,5286
2016-04-17 10:30:00,422,389,413,1224,7344
2016-04-17 10:40:00,438,404,428,1270,7620
2016-04-17 10:50:00,327,297,315,939,5634
2016-04-17 11:00:00,255,229,249,733,4398
2016-04-17 11:10:00,340,313,336,989,5934
2016-04-17 11:20:00,418,388,411,1217,7302
2016-04-17 11:30:00,642,610,634,1886,11316
2016-04-17 11:40:00,1260,1210,1246,3716,22296
2016-04-17 11:50:00,353,322,343,1018,6108
2016-04-17 12:00:00,200,172,190,562,3372
2016-04-17 12:10:00,184,39,250,473,2838
2016-04-17 12:20:00,205,124,165,494,2964
2016-04-17 12:30:00,287,217,251,755,4530
2016-04-17 12:40:00,308,282,297,887,5322
2016-04-17 12:50:00,275,247,268,790,4740
2016-04-17 13:00:00,309,278,294,881,5286
2016-04-17 13:10:00,444,415,432,1291,7746
2016-04-17 13:20:00,501,475,493,1469,8814
2016-04-17 13:30:00,601,574,592,1767,10602
2016-04-17 13:40:00,927,896,921,2744,16464
2016-04-17 13:50:00,735,698,725,2158,12948
2016-04-17 14:00:00,672,631,662,1965,11790
2016-04-17 14:10:00,414,386,409,1209,7254
2016-04-17 14:20:00,368,339,360,1067,6402
2016-04-17 14:30:00,432,406,426,1264,7584
2016-04-17 14:40:00,424,394,413,1231,7386
2016-04-17 14:50:00,424,393,412,1229,7374
2016-04-17 15:00:00,370,340,361,1071,6426
2016-04-17 15:10:00,306,277,297,880,5280
2016-04-17 15:20:00,271,246,263,780,4680
2016-04-17 15:30:00,366,341,363,1070,6420
2016-04-17 15:40:00,297,272,290,859,5154
2016-04-17 15:50:00,261,238,252,751,4506
2016-04-17 16:00:00,262,236,252,750,4500
2016-04-17 16:10:00,316,290,308,914,5484
2016-04-17 16:20:00,210,112,249,571,3426
2016-04-17 16:30:00,180,63,226,469,2814
2016-04-17 16:40:00,113,108,161,382,2292
2016-04-17 16:50:00,66,152,151,369,2214
2016-04-17 17:00:00,118,161,157,436,2616
2016-04-17 17:10:00,153,171,180,504,3024
2016-04-17 17:20:00,196,167,191,554,3324
2016-04-17 17:30:00,376,358,382,1116,6696
2016-04-17 17:40:00,326,299,324,949,5694
2016-04-17 17:50:00,213,192,214,619,3714
2016-04-17 18:00:00,143,120,140,403,2418
2016-04-17 18:10:00,64,136,155,355,2130
2016-04-17 18:20:00,97,116,143,356,2136
2016-04-17 18:30:00,43,87,106,236,1416
2016-04-17 18:40:00,29,62,84,175,1050
2016-04-17 18:50:00,30,89,98,217,1302
2016-04-17 19:00:00,45,46,76,167,1002
2016-04-17 19:10:00,26,39,72,137,822
2016-04-17 19:20:00,33,38,59,130,780
2016-04-17 19:30:00,13,28,48,89,534
2016-04-17 19:40:00,10,16,34,60,360
2016-04-17 19:50:00,12,13,33,58,348
2016-04-17 20:00:00,7,3,9,19,114
2016-04-17 20:10:00,0,0,1,1,6
2016-04-17 20:20:00,0,0,0,0,0
2016-04-17 20:30:00,0,0,0,0,0
2016-04-17 20:40:00,0,0,0,0,0
2016-04-18 05:30:00,0,0,0,0,0
2016-04-18 05:40:00,0,0,0,0,0
2016-04-18 05:50:00,0,0,0,0,0
2016-04-18 06:00:00,0,0,0,0,0
2016-04-18 06:10:00,2,1,3,6,36
2016-04-18 06:20:00,7,3,9,19,114
2016-04-18 06:30:00,13,5,17,35,210
2016-04-18 06:40:00,17,9,26,52,312
2016-04-18 06:50:00,38,45,69,152,912
2016-04-18 07:00:00,37,42,73,152,912
2016-04-18 07:10:00,31,15,48,94,564
2016-04-18 07:20:00,17,24,47,88,528
2016-04-18 07:30:00,14,22,49,85,510
2016-04-18 07:40:00,10,21,47,78,468
2016-04-18 07:50:00,18,25,49,92,552
2016-04-18 08:00:00,19,58,80,157,942
2016-04-18 08:10:00,42,42,81,165,990
2016-04-18 08:20:00,42,47,79,168,1008
2016-04-18 08:30:00,19,73,86,178,1068
2016-04-18 08:40:00,50,80,89,219,1314
2016-04-18 08:50:00,26,106,113,245,1470
2016-04-18 09:00:00,19,109,115,243,1458
2016-04-18 09:10:00,74,120,141,335,2010
2016-04-18 09:20:00,112,113,172,397,2382
2016-04-18 09:30:00,114,112,158,384,2304
2016-04-18 09:40:00,167,45,280,492,2952
2016-04-18 09:50:00,214,183,230,627,3762
2016-04-18 10:00:00,285,229,224,738,4428
2016-04-18 10:10:00,289,263,284,836,5016
2016-04-18 10:20:00,300,273,290,863,5178
2016-04-18 10:30:00,330,305,319,954,5724
2016-04-18 10:40:00,326,300,318,944,5664
2016-04-18 10:50:00,322,296,314,932,5592
2016-04-18 11:00:00,318,287,307,912,5472
2016-04-18 11:10:00,328,294,312,934,5604
2016-04-18 11:20:00,388,354,378,1120,6720
2016-04-18 11:30:00,421,391,416,1228,7368
2016-04-18 11:40:00,455,422,446,1323,7938
2016-04-18 11:50:00,416,387,410,1213,7278
2016-04-18 12:00:00,344,316,338,998,5988
2016-04-18 12:10:00,237,211,230,678,4068
2016-04-18 12:20:00,198,137,159,494,2964
2016-04-18 12:30:00,269,149,137,555,3330
2016-04-18 12:40:00,268,97,221,586,3516
2016-04-18 12:50:00,295,200,183,678,4068
2016-04-18 13:00:00,239,213,232,684,4104
2016-04-18 13:10:00,384,357,378,1119,6714
2016-04-18 13:20:00,523,497,520,1540,9240
2016-04-18 13:30:00,309,284,304,897,5382
2016-04-18 13:40:00,213,187,205,605,3630
2016-04-18 13:50:00,304,278,293,875,5250
2016-04-18 14:00:00,335,305,325,965,5790
2016-04-18 14:10:00,215,190,208,613,3678
2016-04-18 14:20:00,403,373,395,1171,7026
2016-04-18 14:30:00,493,461,480,1434,8604
2016-04-18 14:40:00,646,615,630,1891,11346
2016-04-18 14:50:00,761,725,747,2233,13398
2016-04-18 15:00:00,595,560,582,1737,10422
2016-04-18 15:10:00,257,231,250,738,4428
2016-04-18 15:20:00,296,270,289,855,5130
2016-04-18 15:30:00,530,499,526,1555,9330
2016-04-18 15:40:00,418,383,409,1210,7260
2016-04-18 15:50:00,302,277,298,877,5262
2016-04-18 16:00:00,286,263,285,834,5004
2016-04-18 16:10:00,177,152,171,500,3000
2016-04-18 16:20:00,187,161,187,535,3210
2016-04-18 16:30:00,162,138,158,458,2748
2016-04-18 16:40:00,54,134,141,329,1974
2016-04-18 16:50:00,264,241,264,769,4614
2016-04-18 17:00:00,225,198,222,645,3870
2016-04-18 17:10:00,58,112,153,323,1938
2016-04-18 17:20:00,95,116,144,355,2130
2016-04-18 17:30:00,31,77,87,195,1170
2016-04-18 17:40:00,21,39,57,117,702
2016-04-18 17:50:00,59,140,157,356,2136
2016-04-18 18:00:00,50,75,132,257,1542
2016-04-18 18:10:00,43,49,77,169,1014
2016-04-18 18:20:00,41,50,77,168,1008
2016-04-18 18:30:00,59,99,112,270,1620
2016-04-18 18:40:00,48,59,79,186,1116
2016-04-18 18:50:00,29,25,46,100,600
2016-04-18 19:00:00,9,6,12,27,162
2016-04-18 19:10:00,18,25,38,81,486
2016-04-18 19:20:00,12,13,19,44,264
2016-04-18 19:30:00,23,25,54,102,612
2016-04-18 19:40:00,3,2,5,10,60
2016-04-18 19:50:00,4,2,5,11,66
2016-04-18 20:00:00,1,0,1,2,12
2016-04-18 20:10:00,0,0,0,0,0
2016-04-18 20:20:00,0,0,0,0,0
2016-04-18 20:30:00,0,0,0,0,0
2016-04-18 20:40:00,0,0,0,0,0
2016-04-19 05:30:00,0,0,0,0,0
2016-04-19 05:40:00,0,0,0,0,0
2016-04-19 05:50:00,0,0,0,0,0
2016-04-19 06:00:00,1,0,1,2,12
2016-04-19 06:10:00,6,2,3,11,66
2016-04-19 06:20:00,12,4,10,26,156
2016-04-19 06:30:00,18,6,20,44,264
2016-04-19 06:40:00,30,7,35,72,432
2016-04-19 06:50:00,31,20,50,101,606
2016-04-19 07:00:00,39,59,76,174,1044
2016-04-19 07:10:00,29,9,40,78,468
2016-04-19 07:20:00,66,58,88,212,1272
2016-04-19 07:30:00,40,31,66,137,822
2016-04-19 07:40:00,47,106,130,283,1698
2016-04-19 07:50:00,100,136,171,407,2442
2016-04-19 08:00:00,124,78,183,385,2310
2016-04-19 08:10:00,125,132,162,419,2514
2016-04-19 08:20:00,195,161,202,558,3348
2016-04-19 08:30:00,170,146,160,476,2856
2016-04-19 08:40:00,324,302,316,942,5652
2016-04-19 08:50:00,404,374,394,1172,7032
2016-04-19 09:00:00,413,385,402,1200,7200
2016-04-19 09:10:00,387,359,377,1123,6738
2016-04-19 09:20:00,488,459,476,1423,8538
2016-04-19 09:30:00,597,565,584,1746,10476
2016-04-19 09:40:00,602,574,590,1766,10596
2016-04-19 09:50:00,681,649,667,1997,11982
2016-04-19 10:00:00,841,805,826,2472,14832
2016-04-19 10:10:00,666,633,655,1954,11724
2016-04-19 10:20:00,752,709,737,2198,13188
2016-04-19 10:30:00,863,822,852,2537,15222
2016-04-19 10:40:00,1039,1001,1028,3068,18408
2016-04-19 10:50:00,830,792,819,2441,14646
2016-04-19 11:00:00,1023,971,1005,2999,17994
2016-04-19 11:10:00,983,934,964,2881,17286
2016-04-19 11:20:00,780,735,761,2276,13656
2016-04-19 11:30:00,633,594,615,1842,11052
2016-04-19 11:40:00,1206,1154,1186,3546,21276
2016-04-19 11:50:00,908,860,889,2657,15942
2016-04-19 12:00:00,1190,1127,1168,3485,20910
2016-04-19 12:10:00,1153,1106,1139,3398,20388
2016-04-19 12:20:00,1167,1123,1153,3443,20658
2016-04-19 12:30:00,882,843,871,2596,15576
2016-04-19 12:40:00,1076,1046,1072,3194,19164
2016-04-19 12:50:00,1162,1120,1148,3430,20580
2016-04-19 13:00:00,1158,1121,1145,3424,20544
2016-04-19 13:10:00,1121,1089,1115,3325,19950
2016-04-19 13:20:00,1185,1153,1182,3520,21120
2016-04-19 13:30:00,1168,1132,1162,3462,20772
2016-04-19 13:40:00,1042,1007,1019,3068,18408
2016-04-19 13:50:00,1077,1034,1051,3162,18972
2016-04-19 14:00:00,1113,1062,1087,3262,19572
2016-04-19 14:10:00,1127,1080,1102,3309,19854
2016-04-19 14:20:00,1122,1081,1101,3304,19824
2016-04-19 14:30:00,1064,1035,1054,3153,18918
2016-04-19 14:40:00,1091,1062,1076,3229,19374
2016-04-19 15:00:00,988,948,967,2903,17418
2016-04-19 15:10:00,950,912,937,2799,16794
2016-04-19 15:20:00,684,651,671,2006,12036
2016-04-19 15:30:00,398,368,386,1152,6912
2016-04-19 15:40:00,495,463,482,1440,8640
2016-04-19 15:50:00,377,354,371,1102,6612
2016-04-19 16:00:00,207,182,199,588,3528
2016-04-19 16:10:00,282,256,271,809,4854
2016-04-19 16:20:00,226,200,216,642,3852
2016-04-19 16:30:00,228,204,224,656,3936
2016-04-19 16:40:00,430,402,430,1262,7572
2016-04-19 16:50:00,572,541,561,1674,10044
2016-04-19 17:00:00,517,490,506,1513,9078
2016-04-19 17:10:00,363,337,352,1052,6312
2016-04-19 17:20:00,305,283,296,884,5304
2016-04-19 17:30:00,178,157,169,504,3024
2016-04-19 17:40:00,154,74,161,389,2334
2016-04-19 17:50:00,150,62,157,369,2214
2016-04-19 18:00:00,146,47,164,357,2142
2016-04-19 18:10:00,133,102,128,363,2178
2016-04-19 18:20:00,72,82,96,250,1500
2016-04-19 18:30:00,67,86,74,227,1362
2016-04-19 18:40:00,60,115,104,279,1674
2016-04-19 18:50:00,53,93,89,235,1410
2016-04-19 19:00:00,81,92,70,243,1458
2016-04-19 19:10:00,67,58,77,202,1212
2016-04-19 19:20:00,39,25,58,122,732
2016-04-19 19:30:00,24,18,43,85,510
2016-04-19 19:40:00,19,10,31,60,360
2016-04-19 19:50:00,15,10,19,44,264
2016-04-19 20:00:00,4,5,5,14,84
2016-04-19 20:10:00,1,0,1,2,12
2016-04-19 20:20:00,0,0,0,0,0
2016-04-19 20:30:00,0,0,0,0,0
2016-04-19 20:40:00,0,0,0,0,0
2016-04-20 05:30:00,0,0,0,0,0
2016-04-20 05:40:00,0,0,0,0,0
2016-04-20 05:50:00,0,0,0,0,0
2016-04-20 06:00:00,1,1,3,5,30
2016-04-20 06:10:00,5,2,12,19,114
2016-04-20 06:20:00,9,6,18,33,198
2016-04-20 06:30:00,16,8,24,48,288
2016-04-20 06:40:00,20,9,31,60,360
2016-04-20 06:50:00,22,12,39,73,438
2016-04-20 07:00:00,22,24,46,92,552
2016-04-20 07:10:00,21,27,70,118,708
2016-04-20 07:20:00,28,47,63,138,828
2016-04-20 07:30:00,33,47,71,151,906
2016-04-20 07:40:00,18,64,82,164,984
2016-04-20 07:50:00,13,76,91,180,1080
2016-04-20 08:00:00,15,84,92,191,1146
2016-04-20 08:10:00,133,81,205,419,2514
2016-04-20 08:20:00,123,112,143,378,2268
2016-04-20 08:30:00,295,243,237,775,4650
2016-04-20 08:40:00,362,338,353,1053,6318
2016-04-20 08:50:00,431,402,425,1258,7548
2016-04-20 09:00:00,496,462,487,1445,8670
2016-04-20 09:10:00,559,526,552,1637,9822
2016-04-20 09:20:00,627,597,618,1842,11052
2016-04-20 09:30:00,693,662,690,2045,12270
2016-04-20 09:40:00,749,715,746,2210,13260
2016-04-20 09:50:00,799,760,791,2350,14100
2016-04-20 10:00:00,856,811,844,2511,15066
2016-04-20 10:10:00,896,855,886,2637,15822
2016-04-20 10:20:00,924,884,915,2723,16338
2016-04-20 10:30:00,957,903,947,2807,16842
2016-04-20 10:40:00,990,917,979,2886,17316
2016-04-20 10:50:00,1009,955,998,2962,17772
2016-04-20 11:00:00,1025,989,1018,3032,18192
2016-04-20 11:10:00,1046,1004,1042,3092,18552
2016-04-20 11:20:00,1064,1020,1060,3144,18864
2016-04-20 11:30:00,1074,1037,1073,3184,19104
2016-04-20 11:40:00,1091,1041,1085,3217,19302
2016-04-20 11:50:00,1107,1049,1094,3250,19500
2016-04-20 12:00:00,1111,1071,1098,3280,19680
2016-04-20 12:10:00,1115,1078,1109,3302,19812
2016-04-20 12:20:00,1121,1087,1122,3330,19980
2016-04-20 12:30:00,1133,1099,1132,3364,20184
2016-04-20 12:40:00,1132,1099,1133,3364,20184
2016-04-20 12:50:00,1138,1087,1130,3355,20130
2016-04-20 13:00:00,1128,1093,1123,3344,20064
2016-04-20 13:10:00,1126,1094,1120,3340,20040
2016-04-20 13:20:00,1120,1086,1122,3328,19968
2016-04-20 13:30:00,1121,1077,1113,3311,19866
2016-04-20 13:40:00,1110,1065,1099,3274,19644
2016-04-20 13:50:00,1097,1061,1092,3250,19500
2016-04-20 14:00:00,1087,1057,1075,3219,19314
2016-04-20 14:10:00,1075,1043,1062,3180,19080
2016-04-20 14:20:00,1055,1018,1046,3119,18714
2016-04-20 14:30:00,1042,1002,1032,3076,18456
2016-04-20 14:40:00,1019,983,1011,3013,18078
2016-04-20 14:50:00,991,970,1000,2961,17766
2016-04-20 15:00:00,963,927,964,2854,17124
2016-04-20 15:10:00,922,901,926,2749,16494
2016-04-20 15:20:00,888,866,889,2643,15858
2016-04-20 15:30:00,842,823,841,2506,15036
2016-04-20 15:40:00,818,789,812,2419,14514
2016-04-20 15:50:00,781,731,772,2284,13704
2016-04-20 16:00:00,735,695,725,2155,12930
2016-04-20 16:10:00,685,651,681,2017,12102
2016-04-20 16:20:00,645,611,639,1895,11370
2016-04-20 16:30:00,592,563,586,1741,10446
2016-04-20 16:40:00,545,515,538,1598,9588
2016-04-20 16:50:00,497,469,491,1457,8742
2016-04-20 17:00:00,445,418,438,1301,7806
2016-04-20 17:10:00,387,366,385,1138,6828
2016-04-20 17:20:00,338,318,338,994,5964
2016-04-20 17:30:00,292,268,290,850,5100
2016-04-20 17:40:00,262,235,256,753,4518
2016-04-20 17:50:00,231,209,228,668,4008
2016-04-20 18:00:00,192,171,188,551,3306
2016-04-20 18:10:00,144,128,146,418,2508
2016-04-20 18:20:00,130,119,77,326,1956
2016-04-20 18:30:00,66,67,74,207,1242
2016-04-20 18:40:00,44,43,61,148,888
2016-04-20 18:50:00,23,23,79,125,750
2016-04-20 19:00:00,18,17,85,120,720
2016-04-20 19:10:00,17,33,53,103,618
2016-04-20 19:20:00,21,27,39,87,522
2016-04-20 19:30:00,22,17,33,72,432
2016-04-20 19:40:00,13,14,31,58,348
2016-04-20 19:50:00,12,11,19,42,252
2016-04-20 20:00:00,9,6,12,27,162
2016-04-20 20:10:00,3,1,4,8,48
2016-04-20 20:20:00,0,0,0,0,0
2016-04-20 20:30:00,0,0,0,0,0
2016-04-20 20:40:00,0,0,0,0,0
2016-04-21 05:30:00,0,0,0,0,0
2016-04-21 05:40:00,0,0,0,0,0
2016-04-21 05:50:00,0,0,0,0,0
2016-04-21 06:00:00,1,1,1,3,18
2016-04-21 06:10:00,3,3,11,17,102
2016-04-21 06:20:00,10,7,16,33,198
2016-04-21 06:30:00,11,12,28,51,306
2016-04-21 06:40:00,16,13,37,66,396
2016-04-21 06:50:00,22,16,43,81,486
2016-04-21 07:00:00,31,19,50,100,600
2016-04-21 07:10:00,34,29,66,129,774
2016-04-21 07:20:00,48,29,77,154,924
2016-04-21 07:30:00,69,18,83,170,1020
2016-04-21 07:40:00,59,43,89,191,1146
2016-04-21 07:50:00,48,70,96,214,1284
2016-04-21 08:00:00,61,82,86,229,1374
2016-04-21 08:10:00,153,155,168,476,2856
2016-04-21 08:20:00,154,153,208,515,3090
2016-04-21 08:30:00,268,229,303,800,4800
2016-04-21 08:40:00,366,335,354,1055,6330
2016-04-21 08:50:00,432,394,418,1244,7464
2016-04-21 09:00:00,493,455,482,1430,8580
2016-04-21 09:10:00,561,518,543,1622,9732
2016-04-21 09:20:00,625,592,615,1832,10992
2016-04-21 09:30:00,688,657,679,2024,12144
2016-04-21 09:40:00,734,700,725,2159,12954
2016-04-21 09:50:00,786,748,771,2305,13830
2016-04-21 10:00:00,815,786,810,2411,14466
2016-04-21 10:10:00,651,622,644,1917,11502
2016-04-21 10:20:00,600,575,587,1762,10572
2016-04-21 10:30:00,595,569,582,1746,10476
2016-04-21 10:40:00,899,874,885,2658,15948
2016-04-21 10:50:00,842,828,829,2499,14994
2016-04-21 11:00:00,769,747,750,2266,13596
2016-04-21 11:10:00,864,830,848,2542,15252
2016-04-21 11:20:00,980,939,962,2881,17286
2016-04-21 11:30:00,1114,1067,1097,3278,19668
2016-04-21 11:40:00,799,762,789,2350,14100
2016-04-21 11:50:00,578,543,567,1688,10128
2016-04-21 12:00:00,1161,1103,1136,3400,20400
2016-04-21 12:10:00,705,660,688,2053,12318
2016-04-21 12:20:00,347,320,339,1006,6036
2016-04-21 12:30:00,369,343,362,1074,6444
2016-04-21 12:40:00,328,299,319,946,5676
2016-04-21 12:50:00,331,299,321,951,5706
2016-04-21 13:00:00,371,339,362,1072,6432
2016-04-21 13:10:00,437,404,426,1267,7602
2016-04-21 13:20:00,337,309,329,975,5850
2016-04-21 13:30:00,246,219,239,704,4224
2016-04-21 13:40:00,291,263,285,839,5034
2016-04-21 13:50:00,408,374,399,1181,7086
2016-04-21 14:00:00,377,346,368,1091,6546
2016-04-21 14:10:00,296,271,288,855,5130
2016-04-21 14:20:00,208,186,202,596,3576
2016-04-21 14:30:00,125,103,118,346,2076
2016-04-21 14:40:00,48,127,140,315,1890
2016-04-21 14:50:00,59,142,144,345,2070
2016-04-21 15:00:00,243,131,208,582,3492
2016-04-21 15:10:00,330,302,323,955,5730
2016-04-21 15:20:00,298,270,291,859,5154
2016-04-21 15:30:00,309,282,302,893,5358
2016-04-21 15:40:00,211,187,203,601,3606
2016-04-21 15:50:00,214,189,204,607,3642
2016-04-21 16:00:00,193,169,187,549,3294
2016-04-21 16:10:00,153,129,145,427,2562
2016-04-21 16:20:00,197,175,191,563,3378
2016-04-21 16:30:00,124,102,120,346,2076
2016-04-21 16:40:00,100,94,63,257,1542
2016-04-21 16:50:00,105,113,138,356,2136
2016-04-21 17:00:00,107,125,148,380,2280
2016-04-21 17:10:00,14,147,182,343,2058
2016-04-21 17:20:00,132,126,238,496,2976
2016-04-21 17:30:00,178,155,173,506,3036
2016-04-21 17:40:00,118,100,136,354,2124
2016-04-21 17:50:00,46,75,77,198,1188
2016-04-21 18:00:00,32,71,67,170,1020
2016-04-21 18:10:00,34,53,64,151,906
2016-04-21 18:20:00,14,8,23,45,270
2016-04-21 18:30:00,8,11,27,46,276
2016-04-21 18:40:00,22,25,60,107,642
2016-04-21 18:50:00,13,23,44,80,480
2016-04-21 19:00:00,15,8,26,49,294
2016-04-21 19:10:00,26,34,60,120,720
2016-04-21 19:20:00,25,24,50,99,594
2016-04-21 19:30:00,19,24,47,90,540
2016-04-21 19:40:00,20,14,55,89,534
2016-04-21 19:50:00,11,5,14,30,180
2016-04-21 20:00:00,4,4,5,13,78
2016-04-21 20:10:00,0,1,0,1,6
2016-04-21 20:20:00,0,0,0,0,0
2016-04-21 20:30:00,0,0,0,0,0
2016-04-21 20:40:00,0,0,0,0,0
2016-04-22 05:20:00,0,0,0,0,0
2016-04-22 05:30:00,0,0,0,0,0
2016-04-22 05:40:00,0,0,0,0,0
2016-04-22 05:50:00,0,0,0,0,0
2016-04-22 06:00:00,1,0,2,3,18
2016-04-22 06:10:00,7,1,7,15,90
2016-04-22 06:20:00,13,2,14,29,174
2016-04-22 06:30:00,19,2,20,41,246
2016-04-22 06:40:00,19,7,29,55,330
2016-04-22 06:50:00,24,8,39,71,426
2016-04-22 07:00:00,23,16,49,88,528
2016-04-22 07:10:00,24,32,56,112,672
2016-04-22 07:20:00,29,30,70,129,774
2016-04-22 07:30:00,34,39,70,143,858
2016-04-22 07:40:00,46,35,74,155,930
2016-04-22 07:50:00,56,22,69,147,882
2016-04-22 08:00:00,84,75,136,295,1770
2016-04-22 08:10:00,247,120,179,546,3276
2016-04-22 08:20:00,242,199,194,635,3810
2016-04-22 08:30:00,297,280,299,876,5256
2016-04-22 08:40:00,380,356,379,1115,6690
2016-04-22 08:50:00,445,417,445,1307,7842
2016-04-22 09:00:00,514,484,507,1505,9030
2016-04-22 09:10:00,583,550,576,1709,10254
2016-04-22 09:20:00,642,616,640,1898,11388
2016-04-22 09:30:00,707,675,706,2088,12528
2016-04-22 09:40:00,760,726,760,2246,13476
2016-04-22 09:50:00,816,771,808,2395,14370
2016-04-22 10:00:00,865,824,854,2543,15258
2016-04-22 10:10:00,901,863,892,2656,15936
2016-04-22 10:20:00,925,894,926,2745,16470
2016-04-22 10:30:00,950,921,952,2823,16938
2016-04-22 10:40:00,978,942,977,2897,17382
2016-04-22 10:50:00,995,964,1001,2960,17760
2016-04-22 11:00:00,1023,978,1020,3021,18126
2016-04-22 11:10:00,1018,1008,1050,3076,18456
2016-04-22 11:20:00,1057,1023,1047,3127,18762
2016-04-22 11:30:00,1056,1036,1067,3159,18954
2016-04-22 11:40:00,1083,1050,1075,3208,19248
2016-04-22 11:50:00,1083,1057,1097,3237,19422
2016-04-22 12:00:00,1095,1070,1089,3254,19524
2016-04-22 12:10:00,1100,1083,1102,3285,19710
2016-04-22 12:20:00,1107,1092,1111,3310,19860
2016-04-22 12:30:00,1117,1087,1120,3324,19944
2016-04-22 12:40:00,1125,1094,1124,3343,20058
2016-04-22 12:50:00,1138,1094,1126,3358,20148
2016-04-22 13:00:00,1138,1099,1123,3360,20160
2016-04-22 13:10:00,1130,1094,1125,3349,20094
2016-04-22 13:20:00,1128,1100,1119,3347,20082
2016-04-22 13:30:00,1113,1086,1108,3307,19842
2016-04-22 13:40:00,1112,1099,1107,3318,19908
2016-04-22 13:50:00,1113,1093,1100,3306,19836
2016-04-22 14:00:00,1107,1065,1095,3267,19602
2016-04-22 14:10:00,1096,1051,1081,3228,19368
2016-04-22 14:20:00,1078,1029,1064,3171,19026
2016-04-22 14:30:00,1074,1032,1061,3167,19002
2016-04-22 14:40:00,1043,1023,1040,3106,18636
2016-04-22 14:50:00,1005,993,1012,3010,18060
2016-04-22 15:00:00,899,881,903,2683,16098
2016-04-22 15:10:00,895,873,891,2659,15954
2016-04-22 15:20:00,876,840,868,2584,15504
2016-04-22 15:30:00,870,836,865,2571,15426
2016-04-22 15:40:00,834,803,836,2473,14838
2016-04-22 15:50:00,778,753,785,2316,13896
2016-04-22 16:00:00,742,717,740,2199,13194
2016-04-22 16:10:00,694,677,702,2073,12438
2016-04-22 16:20:00,664,643,666,1973,11838
2016-04-22 16:30:00,603,580,602,1785,10710
2016-04-22 16:40:00,558,534,555,1647,9882
2016-04-22 16:50:00,545,516,542,1603,9618
2016-04-22 17:00:00,474,450,474,1398,8388
2016-04-22 17:10:00,407,382,400,1189,7134
2016-04-22 17:20:00,347,325,341,1013,6078
2016-04-22 17:30:00,136,126,132,394,2364
2016-04-22 17:40:00,227,209,226,662,3972
2016-04-22 17:50:00,294,273,289,856,5136
2016-04-22 18:00:00,201,179,198,578,3468
2016-04-22 18:10:00,186,142,115,443,2658
2016-04-22 18:20:00,50,134,155,339,2034
2016-04-22 18:30:00,17,93,110,220,1320
2016-04-22 18:40:00,18,59,77,154,924
2016-04-22 18:50:00,19,21,85,125,750
2016-04-22 19:00:00,23,20,77,120,720
2016-04-22 19:10:00,27,28,50,105,630
2016-04-22 19:20:00,26,26,39,91,546
2016-04-22 19:30:00,24,11,42,77,462
2016-04-22 19:40:00,16,13,35,64,384
2016-04-22 19:50:00,14,9,25,48,288
2016-04-22 20:00:00,10,4,17,31,186
2016-04-22 20:10:00,5,2,7,14,84
2016-04-22 20:20:00,0,0,0,0,0
2016-04-22 20:30:00,0,0,0,0,0
2016-04-22 20:40:00,0,0,0,0,0
2016-04-22 20:50:00,0,0,0,0,0
2016-04-23 05:20:00,0,0,0,0,0
2016-04-23 05:30:00,0,0,0,0,0
2016-04-23 05:40:00,0,0,0,0,0
2016-04-23 05:50:00,0,0,0,0,0
2016-04-23 06:00:00,4,1,10,15,90
2016-04-23 06:10:00,11,5,18,34,204
2016-04-23 06:20:00,11,10,30,51,306
2016-04-23 06:30:00,12,20,49,81,486
2016-04-23 06:40:00,26,27,52,105,630
2016-04-23 06:50:00,19,20,79,118,708
2016-04-23 07:00:00,1,1,126,128,768
2016-04-23 07:10:00,33,34,66,133,798
2016-04-23 07:20:00,31,51,70,152,912
2016-04-23 07:30:00,23,55,81,159,954
2016-04-23 07:40:00,14,70,92,176,1056
2016-04-23 07:50:00,19,68,90,177,1062
2016-04-23 08:00:00,55,134,168,357,2142
2016-04-23 08:10:00,181,105,292,578,3468
2016-04-23 08:20:00,232,171,292,695,4170
2016-04-23 08:30:00,313,287,304,904,5424
2016-04-23 08:40:00,420,395,413,1228,7368
2016-04-23 08:50:00,250,227,245,722,4332
2016-04-23 09:00:00,322,291,314,927,5562
2016-04-23 09:10:00,585,546,572,1703,10218
2016-04-23 09:20:00,639,607,630,1876,11256
2016-04-23 09:30:00,670,641,659,1970,11820
2016-04-23 09:40:00,700,661,690,2051,12306
2016-04-23 09:50:00,817,776,807,2400,14400
2016-04-23 10:00:00,606,580,597,1783,10698
2016-04-23 10:10:00,959,942,951,2852,17112
2016-04-23 10:20:00,830,789,819,2438,14628
2016-04-23 10:30:00,992,947,978,2917,17502
2016-04-23 10:40:00,1056,1011,1036,3103,18618
2016-04-23 10:50:00,969,926,953,2848,17088
2016-04-23 11:00:00,942,901,927,2770,16620
2016-04-23 11:10:00,1056,1024,1051,3131,18786
2016-04-23 11:20:00,1120,1092,1106,3318,19908
2016-04-23 11:30:00,457,436,448,1341,8046
2016-04-23 11:40:00,60,52,87,199,1194
2016-04-23 11:50:00,28,100,125,253,1518
2016-04-23 12:00:00,251,300,327,878,5268
2016-04-23 12:10:00,1257,1212,1234,3703,22218
2016-04-23 12:20:00,409,381,397,1187,7122
2016-04-23 12:30:00,196,173,189,558,3348
2016-04-23 12:40:00,888,851,879,2618,15708
2016-04-23 12:50:00,1254,1221,1232,3707,22242
2016-04-23 13:00:00,1189,1162,1170,3521,21126
2016-04-23 13:10:00,918,896,900,2714,16284
2016-04-23 13:20:00,225,202,218,645,3870
2016-04-23 13:30:00,93,72,83,248,1488
2016-04-23 13:40:00,154,131,144,429,2574
2016-04-23 13:50:00,239,213,229,681,4086
2016-04-23 14:00:00,345,316,333,994,5964
2016-04-23 14:10:00,441,412,436,1289,7734
2016-04-23 14:20:00,516,491,512,1519,9114
2016-04-23 14:30:00,754,729,754,2237,13422
2016-04-23 14:40:00,815,790,817,2422,14532
2016-04-23 14:50:00,678,660,681,2019,12114
2016-04-23 15:00:00,737,720,748,2205,13230
2016-04-23 15:10:00,521,497,520,1538,9228
2016-04-23 15:20:00,661,643,659,1963,11778
2016-04-23 15:30:00,955,930,950,2835,17010
2016-04-23 15:40:00,884,872,889,2645,15870
2016-04-23 15:50:00,808,784,812,2404,14424
2016-04-23 16:00:00,682,659,688,2029,12174
2016-04-23 16:10:00,707,683,706,2096,12576
2016-04-23 16:20:00,674,648,672,1994,11964
2016-04-23 16:30:00,605,582,602,1789,10734
2016-04-23 16:40:00,535,516,530,1581,9486
2016-04-23 16:50:00,464,442,455,1361,8166
2016-04-23 17:00:00,420,398,416,1234,7404
2016-04-23 17:10:00,461,431,454,1346,8076
2016-04-23 17:20:00,382,357,376,1115,6690
2016-04-23 17:30:00,341,320,342,1003,6018
2016-04-23 17:40:00,276,256,273,805,4830
2016-04-23 17:50:00,186,163,180,529,3174
2016-04-23 18:00:00,158,131,150,439,2634
2016-04-23 18:10:00,111,92,102,305,1830
2016-04-23 18:20:00,74,56,69,199,1194
2016-04-23 18:30:00,21,16,47,84,504
2016-04-23 18:40:00,14,11,20,45,270
2016-04-23 18:50:00,20,10,38,68,408
2016-04-23 19:00:00,35,14,56,105,630
2016-04-23 19:10:00,27,50,57,134,804
2016-04-23 19:20:00,19,28,52,99,594
2016-04-23 19:30:00,11,14,36,61,366
2016-04-23 19:40:00,12,16,36,64,384
2016-04-23 19:50:00,13,14,30,57,342
2016-04-23 20:00:00,10,7,22,39,234
2016-04-23 20:10:00,7,2,11,20,120
2016-04-23 20:20:00,0,0,0,0,0
2016-04-23 20:30:00,0,0,0,0,0
2016-04-23 20:40:00,0,0,0,0,0
2016-04-23 20:50:00,0,0,0,0,0
2016-04-24 05:20:00,0,0,0,0,0
2016-04-24 05:30:00,0,0,0,0,0
2016-04-24 05:40:00,1,0,1,2,12
2016-04-24 05:50:00,1,0,2,3,18
2016-04-24 06:00:00,4,1,8,13,78
2016-04-24 06:10:00,15,12,37,64,384
2016-04-24 06:20:00,14,13,34,61,366
2016-04-24 06:30:00,22,23,50,95,570
2016-04-24 06:40:00,24,26,52,102,612
2016-04-24 06:50:00,25,32,77,134,804
2016-04-24 07:00:00,17,62,87,166,996
2016-04-24 07:10:00,27,67,97,191,1146
2016-04-24 07:20:00,26,83,108,217,1302
2016-04-24 07:30:00,32,96,112,240,1440
2016-04-24 07:40:00,38,93,116,247,1482
2016-04-24 07:50:00,32,101,122,255,1530
2016-04-24 08:00:00,2,146,150,298,1788
2016-04-24 08:10:00,138,184,222,544,3264
2016-04-24 08:20:00,242,266,252,760,4560
2016-04-24 08:30:00,286,258,280,824,4944
2016-04-24 08:40:00,416,388,410,1214,7284
2016-04-24 08:50:00,478,452,474,1404,8424
2016-04-24 09:00:00,538,505,528,1571,9426
2016-04-24 09:10:00,590,555,582,1727,10362
2016-04-24 09:20:00,646,616,639,1901,11406
2016-04-24 09:30:00,732,697,734,2163,12978
2016-04-24 09:40:00,773,739,773,2285,13710
2016-04-24 09:50:00,744,713,733,2190,13140
2016-04-24 10:00:00,766,729,762,2257,13542
2016-04-24 10:10:00,771,743,775,2289,13734
2016-04-24 10:20:00,624,604,628,1856,11136
2016-04-24 10:30:00,402,382,404,1188,7128
2016-04-24 10:40:00,398,374,394,1166,6996
2016-04-24 10:50:00,477,453,477,1407,8442
2016-04-24 11:00:00,220,193,213,626,3756
2016-04-24 11:10:00,216,189,209,614,3684
2016-04-24 11:20:00,293,255,342,890,5340
2016-04-24 11:30:00,261,240,265,766,4596
2016-04-24 11:40:00,837,812,842,2491,14946
2016-04-24 11:50:00,963,931,958,2852,17112
2016-04-24 12:00:00,1059,1032,1065,3156,18936
2016-04-24 12:10:00,1161,1147,1191,3499,20994
2016-04-24 12:20:00,1226,1206,1242,3674,22044
2016-04-24 12:30:00,922,915,938,2775,16650
2016-04-24 12:40:00,856,846,868,2570,15420
2016-04-24 12:50:00,244,178,242,664,3984
2016-04-24 13:00:00,73,113,150,336,2016
2016-04-24 13:10:00,395,348,403,1146,6876
2016-04-24 13:20:00,1060,991,1046,3097,18582
2016-04-24 13:30:00,1083,1014,1063,3160,18960
2016-04-24 13:40:00,912,863,907,2682,16092
2016-04-24 13:50:00,970,924,966,2860,17160
2016-04-24 14:00:00,684,641,675,2000,12000
2016-04-24 14:10:00,742,715,731,2188,13128
2016-04-24 14:20:00,770,748,760,2278,13668
2016-04-24 14:30:00,553,528,541,1622,9732
2016-04-24 14:40:00,194,169,184,547,3282
2016-04-24 14:50:00,367,338,356,1061,6366
2016-04-24 15:00:00,690,654,674,2018,12108
2016-04-24 15:10:00,261,235,252,748,4488
2016-04-24 15:20:00,51,39,64,154,924
2016-04-24 15:30:00,14,4,19,37,222
2016-04-24 15:40:00,48,27,68,143,858
2016-04-24 15:50:00,23,8,34,65,390
2016-04-24 16:00:00,20,32,57,109,654
2016-04-24 16:10:00,174,143,173,490,2940
2016-04-24 16:20:00,504,476,500,1480,8880
2016-04-24 16:30:00,713,680,703,2096,12576
2016-04-24 16:40:00,629,588,617,1834,11004
2016-04-24 16:50:00,464,432,456,1352,8112
2016-04-24 17:00:00,389,357,382,1128,6768
2016-04-24 17:10:00,383,347,372,1102,6612
2016-04-24 17:20:00,59,62,83,204,1224
2016-04-24 17:30:00,43,48,59,150,900
2016-04-24 17:40:00,37,45,69,151,906
2016-04-24 17:50:00,81,55,135,271,1626
2016-04-24 18:00:00,27,14,43,84,504
2016-04-24 18:10:00,37,43,74,154,924
2016-04-24 18:20:00,44,140,193,377,2262
2016-04-24 18:30:00,20,136,147,303,1818
2016-04-24 18:40:00,29,84,100,213,1278
2016-04-24 18:50:00,61,75,82,218,1308
2016-04-24 19:00:00,58,105,102,265,1590
2016-04-24 19:10:00,32,82,89,203,1218
2016-04-24 19:20:00,36,50,68,154,924
2016-04-24 19:30:00,17,21,43,81,486
2016-04-24 19:40:00,6,9,26,41,246
2016-04-24 19:50:00,6,3,15,24,144
2016-04-24 20:00:00,4,1,9,14,84
2016-04-24 20:10:00,2,1,3,6,36
2016-04-24 20:20:00,0,0,0,0,0
2016-04-24 20:30:00,0,0,0,0,0
2016-04-24 20:40:00,0,0,0,0,0
2016-04-24 20:50:00,0,0,0,0,0
2016-04-25 05:10:00,0,0,0,0,0
2016-04-25 05:20:00,0,0,0,0,0
2016-04-25 05:30:00,0,0,0,0,0
2016-04-25 05:40:00,0,0,0,0,0
2016-04-25 05:50:00,1,0,2,3,18
2016-04-25 06:00:00,6,3,10,19,114
2016-04-25 06:10:00,8,9,27,44,264
2016-04-25 06:20:00,11,22,45,78,468
2016-04-25 06:30:00,28,34,72,134,804
2016-04-25 06:40:00,34,78,102,214,1284
2016-04-25 06:50:00,1,143,145,289,1734
2016-04-25 07:00:00,7,130,135,272,1632
2016-04-25 07:10:00,55,78,102,235,1410
2016-04-25 07:20:00,36,95,119,250,1500
2016-04-25 07:30:00,62,149,173,384,2304
2016-04-25 07:40:00,146,107,223,476,2856
2016-04-25 07:50:00,69,119,237,425,2550
2016-04-25 08:00:00,5,147,158,310,1860
2016-04-25 08:10:00,103,117,207,427,2562
2016-04-25 08:20:00,288,210,282,780,4680
2016-04-25 08:30:00,325,301,321,947,5682
2016-04-25 08:40:00,278,254,272,804,4824
2016-04-25 08:50:00,270,246,264,780,4680
2016-04-25 09:00:00,529,497,524,1550,9300
2016-04-25 09:10:00,688,656,679,2023,12138
2016-04-25 09:20:00,529,498,519,1546,9276
2016-04-25 09:30:00,625,587,614,1826,10956
2016-04-25 09:40:00,802,766,791,2359,14154
2016-04-25 09:50:00,745,711,736,2192,13152
2016-04-25 10:00:00,828,798,818,2444,14664
2016-04-25 10:10:00,800,773,793,2366,14196
2016-04-25 10:20:00,845,811,836,2492,14952
2016-04-25 10:30:00,799,763,791,2353,14118
2016-04-25 10:40:00,303,273,294,870,5220
2016-04-25 10:50:00,384,352,375,1111,6666
2016-04-25 11:00:00,623,581,611,1815,10890
2016-04-25 11:10:00,840,802,827,2469,14814
2016-04-25 11:20:00,958,913,942,2813,16878
2016-04-25 11:30:00,1067,1033,1056,3156,18936
2016-04-25 11:40:00,728,692,715,2135,12810
2016-04-25 11:50:00,1034,996,1020,3050,18300
2016-04-25 12:00:00,352,327,344,1023,6138
2016-04-25 12:10:00,326,297,318,941,5646
2016-04-25 12:20:00,736,701,729,2166,12996
2016-04-25 12:30:00,476,443,468,1387,8322
2016-04-25 12:40:00,358,329,351,1038,6228
2016-04-25 12:50:00,419,392,412,1223,7338
2016-04-25 13:00:00,764,743,759,2266,13596
2016-04-25 13:10:00,904,883,895,2682,16092
2016-04-25 13:20:00,264,242,257,763,4578
2016-04-25 13:30:00,382,354,371,1107,6642
2016-04-25 13:40:00,326,295,314,935,5610
2016-04-25 13:50:00,563,532,552,1647,9882
2016-04-25 14:00:00,945,907,925,2777,16662
2016-04-25 14:10:00,707,684,693,2084,12504
2016-04-25 14:20:00,715,690,701,2106,12636
2016-04-25 14:30:00,567,545,560,1672,10032
2016-04-25 14:40:00,501,477,493,1471,8826
2016-04-25 14:50:00,318,294,308,920,5520
2016-04-25 15:00:00,360,330,349,1039,6234
2016-04-25 15:10:00,567,535,559,1661,9966
2016-04-25 15:20:00,334,304,323,961,5766
2016-04-25 15:30:00,344,315,333,992,5952
2016-04-25 15:40:00,425,401,413,1239,7434
2016-04-25 15:50:00,300,277,290,867,5202
2016-04-25 16:00:00,295,272,288,855,5130
2016-04-25 16:10:00,215,194,207,616,3696
2016-04-25 16:20:00,213,191,209,613,3678
2016-04-25 16:30:00,93,78,102,273,1638
2016-04-25 16:40:00,390,361,378,1129,6774
2016-04-25 16:50:00,262,237,255,754,4524
2016-04-25 17:00:00,228,205,220,653,3918
2016-04-25 17:10:00,174,152,167,493,2958
2016-04-25 17:20:00,196,174,190,560,3360
2016-04-25 17:30:00,166,145,161,472,2832
2016-04-25 17:40:00,207,184,202,593,3558
2016-04-25 17:50:00,204,180,197,581,3486
2016-04-25 18:00:00,175,149,167,491,2946
2016-04-25 18:10:00,258,232,252,742,4452
2016-04-25 18:20:00,216,190,209,615,3690
2016-04-25 18:30:00,144,120,136,400,2400
2016-04-25 18:40:00,112,123,162,397,2382
2016-04-25 18:50:00,79,99,112,290,1740
2016-04-25 19:00:00,34,36,66,136,816
2016-04-25 19:10:00,47,83,100,230,1380
2016-04-25 19:20:00,15,29,46,90,540
2016-04-25 19:30:00,14,4,19,37,222
2016-04-25 19:40:00,11,5,18,34,204
2016-04-25 19:50:00,8,4,15,27,162
2016-04-25 20:00:00,3,4,9,16,96
2016-04-25 20:10:00,0,1,2,3,18
2016-04-25 20:20:00,0,0,0,0,0
2016-04-25 20:30:00,0,0,0,0,0
2016-04-25 20:40:00,0,0,0,0,0
2016-04-25 20:50:00,0,0,0,0,0
2016-04-26 05:20:00,0,0,0,0,0
2016-04-26 05:30:00,0,0,0,0,0
2016-04-26 05:40:00,0,0,0,0,0
2016-04-26 05:50:00,0,0,0,0,0
2016-04-26 06:00:00,0,0,0,0,0
2016-04-26 06:10:00,0,0,0,0,0
2016-04-26 06:20:00,1,0,2,3,18
2016-04-26 06:30:00,6,0,7,13,78
2016-04-26 06:40:00,8,0,10,18,108
2016-04-26 06:50:00,15,1,13,29,174
2016-04-26 07:00:00,28,13,41,82,492
2016-04-26 07:10:00,37,29,68,134,804
2016-04-26 07:20:00,53,46,75,174,1044
2016-04-26 07:30:00,47,42,74,163,978
2016-04-26 07:40:00,34,29,61,124,744
2016-04-26 07:50:00,40,15,55,110,660
2016-04-26 08:00:00,15,4,18,37,222
2016-04-26 08:10:00,42,38,72,152,912
2016-04-26 08:20:00,58,88,109,255,1530
2016-04-26 08:30:00,35,73,92,200,1200
2016-04-26 08:40:00,34,40,64,138,828
2016-04-26 08:50:00,64,42,84,190,1140
2016-04-26 09:00:00,51,98,122,271,1626
2016-04-26 09:10:00,130,61,225,416,2496
2016-04-26 09:20:00,53,72,95,220,1320
2016-04-26 09:30:00,116,67,136,319,1914
2016-04-26 09:40:00,142,64,152,358,2148
2016-04-26 09:50:00,191,79,156,426,2556
2016-04-26 10:00:00,204,172,182,558,3348
2016-04-26 10:10:00,278,251,267,796,4776
2016-04-26 10:20:00,304,228,219,751,4506
2016-04-26 10:30:00,167,131,156,454,2724
2016-04-26 10:40:00,158,57,243,458,2748
2016-04-26 10:50:00,221,87,243,551,3306
2016-04-26 11:00:00,184,98,180,462,2772
2016-04-26 11:10:00,26,133,149,308,1848
2016-04-26 11:20:00,185,150,173,508,3048
2016-04-26 11:30:00,265,202,267,734,4404
2016-04-26 11:40:00,227,200,221,648,3888
2016-04-26 11:50:00,220,195,213,628,3768
2016-04-26 12:00:00,213,187,206,606,3636
2016-04-26 12:10:00,365,335,359,1059,6354
2016-04-26 12:20:00,402,372,393,1167,7002
2016-04-26 12:30:00,419,387,407,1213,7278
2016-04-26 12:40:00,232,204,223,659,3954
2016-04-26 12:50:00,257,229,249,735,4410
2016-04-26 13:00:00,315,285,307,907,5442
2016-04-26 13:10:00,378,346,368,1092,6552
2016-04-26 13:20:00,598,562,586,1746,10476
2016-04-26 13:30:00,662,630,656,1948,11688
2016-04-26 13:40:00,529,496,519,1544,9264
2016-04-26 13:50:00,516,480,505,1501,9006
2016-04-26 14:00:00,416,380,405,1201,7206
2016-04-26 14:10:00,323,287,309,919,5514
2016-04-26 14:20:00,509,466,493,1468,8808
2016-04-26 14:30:00,293,260,281,834,5004
2016-04-26 14:40:00,179,152,170,501,3006
2016-04-26 14:50:00,169,112,207,488,2928
2016-04-26 15:00:00,126,53,299,478,2868
2016-04-26 15:10:00,240,179,215,634,3804
2016-04-26 15:20:00,237,207,227,671,4026
2016-04-26 15:30:00,422,391,413,1226,7356
2016-04-26 15:40:00,343,314,332,989,5934
2016-04-26 15:50:00,416,384,404,1204,7224
2016-04-26 16:00:00,495,463,480,1438,8628
2016-04-26 16:10:00,304,276,294,874,5244
2016-04-26 16:20:00,117,146,159,422,2532
2016-04-26 16:30:00,47,115,140,302,1812
2016-04-26 16:40:00,101,70,110,281,1686
2016-04-26 16:50:00,282,219,237,738,4428
2016-04-26 17:00:00,189,166,186,541,3246
2016-04-26 17:10:00,315,290,313,918,5508
2016-04-26 17:20:00,343,321,338,1002,6012
2016-04-26 17:30:00,401,373,396,1170,7020
2016-04-26 17:40:00,306,278,298,882,5292
2016-04-26 17:50:00,281,253,275,809,4854
2016-04-26 18:00:00,227,201,221,649,3894
2016-04-26 18:10:00,182,155,175,512,3072
2016-04-26 18:20:00,232,205,225,662,3972
2016-04-26 18:30:00,239,211,231,681,4086
2016-04-26 18:40:00,57,57,85,199,1194
2016-04-26 18:50:00,40,21,57,118,708
2016-04-26 19:00:00,25,27,65,117,702
2016-04-26 19:10:00,48,52,81,181,1086
2016-04-26 19:20:00,34,32,61,127,762
2016-04-26 19:30:00,16,10,27,53,318
2016-04-26 19:40:00,19,21,45,85,510
2016-04-26 19:50:00,11,17,36,64,384
2016-04-26 20:00:00,6,6,30,42,252
2016-04-26 20:10:00,5,2,11,18,108
2016-04-26 20:20:00,3,2,5,10,60
2016-04-26 20:30:00,0,0,0,0,0
2016-04-26 20:40:00,0,0,0,0,0
2016-04-26 20:50:00,0,0,0,0,0
2016-04-27 05:30:00,0,0,0,0,0
2016-04-27 05:40:00,0,0,0,0,0
2016-04-27 05:50:00,0,0,0,0,0
2016-04-27 06:00:00,0,0,0,0,0
2016-04-27 06:10:00,0,0,0,0,0
2016-04-27 06:20:00,0,0,0,0,0
2016-04-27 06:30:00,16,0,14,30,180
2016-04-27 06:40:00,23,2,23,48,288
2016-04-27 06:50:00,35,14,50,99,594
2016-04-27 07:00:00,49,19,68,136,816
2016-04-27 07:10:00,46,45,81,172,1032
2016-04-27 07:20:00,30,10,39,79,474
2016-04-27 07:30:00,27,13,45,85,510
2016-04-27 07:40:00,25,10,38,73,438
2016-04-27 07:50:00,24,9,35,68,408
2016-04-27 08:00:00,35,19,50,104,624
2016-04-27 08:10:00,41,34,73,148,888
2016-04-27 08:20:00,75,42,94,211,1266
2016-04-27 08:30:00,79,65,102,246,1476
2016-04-27 08:40:00,37,96,104,237,1422
2016-04-27 08:50:00,61,58,92,211,1266
2016-04-27 09:00:00,109,61,240,410,2460
2016-04-27 09:10:00,254,176,144,574,3444
2016-04-27 09:20:00,291,182,143,616,3696
2016-04-27 09:30:00,159,132,147,438,2628
2016-04-27 09:40:00,115,75,230,420,2520
2016-04-27 09:50:00,69,81,124,274,1644
2016-04-27 10:00:00,93,81,203,377,2262
2016-04-27 10:10:00,205,157,194,556,3336
2016-04-27 10:20:00,119,132,162,413,2478
2016-04-27 10:30:00,136,70,213,419,2514
2016-04-27 10:40:00,293,183,240,716,4296
2016-04-27 10:50:00,364,337,357,1058,6348
2016-04-27 11:00:00,407,374,396,1177,7062
2016-04-27 11:10:00,745,698,729,2172,13032
2016-04-27 11:20:00,929,872,911,2712,16272
2016-04-27 11:30:00,1145,1091,1127,3363,20178
2016-04-27 11:40:00,833,794,817,2444,14664
2016-04-27 11:50:00,1008,964,991,2963,17778
2016-04-27 12:00:00,1077,1037,1065,3179,19074
2016-04-27 12:10:00,932,899,923,2754,16524
2016-04-27 12:20:00,908,880,914,2702,16212
2016-04-27 12:30:00,1022,987,1025,3034,18204
2016-04-27 12:40:00,726,695,722,2143,12858
2016-04-27 12:50:00,1093,1059,1093,3245,19470
2016-04-27 13:00:00,830,796,825,2451,14706
2016-04-27 13:10:00,624,592,617,1833,10998
2016-04-27 13:20:00,1200,1163,1194,3557,21342
2016-04-27 13:30:00,1142,1113,1136,3391,20346
2016-04-27 13:40:00,1167,1143,1158,3468,20808
2016-04-27 13:50:00,1080,1044,1068,3192,19152
2016-04-27 14:00:00,1194,1144,1179,3517,21102
2016-04-27 14:10:00,1117,1061,1100,3278,19668
2016-04-27 14:20:00,1137,1085,1124,3346,20076
2016-04-27 14:30:00,815,776,806,2397,14382
2016-04-27 14:40:00,1076,1025,1055,3156,18936
2016-04-27 14:50:00,1203,1157,1181,3541,21246
2016-04-27 15:00:00,900,870,886,2656,15936
2016-04-27 15:10:00,907,877,892,2676,16056
2016-04-27 15:20:00,562,533,551,1646,9876
2016-04-27 15:30:00,241,215,233,689,4134
2016-04-27 15:40:00,241,167,147,555,3330
2016-04-27 15:50:00,245,156,176,577,3462
2016-04-27 16:00:00,131,73,201,405,2430
2016-04-27 16:10:00,175,70,160,405,2430
2016-04-27 16:20:00,27,84,107,218,1308
2016-04-27 16:30:00,39,24,60,123,738
2016-04-27 16:40:00,19,69,84,172,1032
2016-04-27 16:50:00,25,61,77,163,978
2016-04-27 17:00:00,25,61,77,163,978
2016-04-27 17:10:00,23,97,122,242,1452
2016-04-27 17:20:00,31,118,150,299,1794
2016-04-27 17:30:00,52,123,151,326,1956
2016-04-27 17:40:00,69,148,157,374,2244
2016-04-27 17:50:00,9,134,143,286,1716
2016-04-27 18:00:00,17,114,124,255,1530
2016-04-27 18:10:00,81,63,147,291,1746
2016-04-27 18:20:00,19,118,122,259,1554
2016-04-27 18:30:00,17,112,121,250,1500
2016-04-27 18:40:00,5,131,135,271,1626
2016-04-27 18:50:00,23,99,120,242,1452
2016-04-27 19:00:00,33,65,90,188,1128
2016-04-27 19:10:00,58,60,85,203,1218
2016-04-27 19:20:00,27,66,80,173,1038
2016-04-27 19:30:00,15,67,83,165,990
2016-04-27 19:40:00,17,24,48,89,534
2016-04-27 19:50:00,10,8,24,42,252
2016-04-27 20:00:00,12,8,25,45,270
2016-04-27 20:10:00,7,2,13,22,132
2016-04-27 20:20:00,0,0,0,0,0
2016-04-27 20:30:00,0,0,0,0,0
2016-04-27 20:40:00,0,0,0,0,0
2016-04-27 20:50:00,0,0,0,0,0
2016-04-28 05:10:00,0,0,0,0,0
2016-04-28 05:20:00,0,0,0,0,0
2016-04-28 05:30:00,0,0,0,0,0
2016-04-28 05:40:00,0,0,0,0,0
2016-04-28 05:50:00,4,2,4,10,60
2016-04-28 06:00:00,7,1,10,18,108
2016-04-28 06:10:00,10,4,14,28,168
2016-04-28 06:20:00,11,9,24,44,264
2016-04-28 06:30:00,17,14,40,71,426
2016-04-28 06:40:00,31,14,43,88,528
2016-04-28 06:50:00,32,19,51,102,612
2016-04-28 07:00:00,15,15,88,118,708
2016-04-28 07:10:00,5,6,115,126,756
2016-04-28 07:20:00,30,42,70,142,852
2016-04-28 07:30:00,34,47,76,157,942
2016-04-28 07:40:00,27,85,105,217,1302
2016-04-28 07:50:00,27,142,157,326,1956
2016-04-28 08:00:00,48,132,154,334,2004
2016-04-28 08:10:00,30,87,103,220,1320
2016-04-28 08:20:00,1,84,95,180,1080
2016-04-28 08:30:00,20,63,84,167,1002
2016-04-28 08:40:00,29,39,72,140,840
2016-04-28 08:50:00,54,74,98,226,1356
2016-04-28 09:00:00,55,62,90,207,1242
2016-04-28 09:10:00,89,121,172,382,2292
2016-04-28 09:20:00,241,152,161,554,3324
2016-04-28 09:30:00,102,79,203,384,2304
2016-04-28 09:40:00,42,109,174,325,1950
2016-04-28 09:50:00,125,34,258,417,2502
2016-04-28 10:00:00,33,87,109,229,1374
2016-04-28 10:10:00,28,61,88,177,1062
2016-04-28 10:20:00,27,46,72,145,870
2016-04-28 10:30:00,41,55,85,181,1086
2016-04-28 10:40:00,94,105,167,366,2196
2016-04-28 10:50:00,315,262,245,822,4932
2016-04-28 11:00:00,603,567,594,1764,10584
2016-04-28 11:10:00,834,792,820,2446,14676
2016-04-28 11:20:00,629,591,618,1838,11028
2016-04-28 11:30:00,783,745,770,2298,13788
2016-04-28 11:40:00,526,498,520,1544,9264
2016-04-28 11:50:00,1066,1036,1069,3171,19026
2016-04-28 12:00:00,1164,1126,1157,3447,20682
2016-04-28 12:10:00,972,933,961,2866,17196
2016-04-28 12:20:00,814,777,801,2392,14352
2016-04-28 12:30:00,926,895,914,2735,16410
2016-04-28 12:40:00,978,949,967,2894,17364
2016-04-28 12:50:00,820,791,812,2423,14538
2016-04-28 13:00:00,1145,1103,1141,3389,20334
2016-04-28 13:10:00,1058,1033,1065,3156,18936
2016-04-28 13:20:00,1051,1015,1039,3105,18630
2016-04-28 13:30:00,928,889,913,2730,16380
2016-04-28 13:40:00,1112,1068,1094,3274,19644
2016-04-28 13:50:00,836,807,823,2466,14796
2016-04-28 14:00:00,868,838,856,2562,15372
2016-04-28 14:10:00,1026,993,1012,3031,18186
2016-04-28 14:20:00,1133,1097,1121,3351,20106
2016-04-28 14:30:00,1079,1044,1071,3194,19164
2016-04-28 14:40:00,995,966,997,2958,17748
2016-04-28 14:50:00,1021,983,1012,3016,18096
2016-04-28 15:00:00,924,894,910,2728,16368
2016-04-28 15:10:00,954,926,941,2821,16926
2016-04-28 15:20:00,960,933,947,2840,17040
2016-04-28 15:30:00,569,546,559,1674,10044
2016-04-28 15:40:00,647,616,634,1897,11382
2016-04-28 15:50:00,298,270,287,855,5130
2016-04-28 16:00:00,249,222,240,711,4266
2016-04-28 16:10:00,207,181,199,587,3522
2016-04-28 16:20:00,218,193,211,622,3732
2016-04-28 16:30:00,157,134,151,442,2652
2016-04-28 16:40:00,164,141,158,463,2778
2016-04-28 16:50:00,219,177,169,565,3390
2016-04-28 17:00:00,209,188,206,603,3618
2016-04-28 17:10:00,410,390,411,1211,7266
2016-04-28 17:20:00,458,430,456,1344,8064
2016-04-28 17:30:00,243,214,236,693,4158
2016-04-28 17:40:00,134,110,128,372,2232
2016-04-28 17:50:00,113,90,107,310,1860
2016-04-28 18:00:00,73,64,79,216,1296
2016-04-28 18:10:00,31,23,45,99,594
2016-04-28 18:20:00,20,10,34,64,384
2016-04-28 18:30:00,7,1,10,18,108
2016-04-28 18:40:00,0,0,1,1,6
2016-04-28 18:50:00,0,0,0,0,0
2016-04-28 19:00:00,0,0,0,0,0
2016-04-28 19:10:00,0,0,0,0,0
2016-04-28 19:20:00,0,0,0,0,0
2016-04-28 19:30:00,0,0,0,0,0
2016-04-28 19:40:00,0,0,0,0,0
2016-04-28 19:50:00,5,4,7,16,96
2016-04-28 20:00:00,24,3,27,54,324
2016-04-28 20:10:00,14,7,23,44,264
2016-04-28 20:20:00,17,4,20,41,246
2016-04-28 20:30:00,1,0,2,3,18
2016-04-28 20:40:00,0,0,0,0,0
2016-04-28 20:50:00,0,0,0,0,0
2016-04-28 21:00:00,0,0,0,0,0
2016-04-29 05:00:00,0,0,0,0,0
2016-04-29 05:10:00,0,0,0,0,0
2016-04-29 05:20:00,0,0,0,0,0
2016-04-29 05:30:00,0,0,0,0,0
2016-04-29 05:40:00,0,0,0,0,0
2016-04-29 05:50:00,5,0,6,11,66
2016-04-29 06:00:00,10,3,13,26,156
2016-04-29 06:10:00,14,7,22,43,258
2016-04-29 06:20:00,21,9,35,65,390
2016-04-29 06:30:00,29,10,44,83,498
2016-04-29 06:40:00,43,10,50,103,618
2016-04-29 06:50:00,26,16,80,122,732
2016-04-29 07:00:00,38,32,69,139,834
2016-04-29 07:10:00,49,36,77,162,972
2016-04-29 07:20:00,43,52,92,187,1122
2016-04-29 07:30:00,38,73,105,216,1296
2016-04-29 07:40:00,48,77,99,224,1344
2016-04-29 07:50:00,94,84,150,328,1968
2016-04-29 08:00:00,206,123,219,548,3288
2016-04-29 08:10:00,160,136,149,445,2670
2016-04-29 08:20:00,241,217,234,692,4152
2016-04-29 08:30:00,176,152,167,495,2970
2016-04-29 08:40:00,172,147,163,482,2892
2016-04-29 08:50:00,351,321,340,1012,6072
2016-04-29 09:00:00,572,540,565,1677,10062
2016-04-29 09:10:00,619,587,615,1821,10926
2016-04-29 09:20:00,686,654,680,2020,12120
2016-04-29 09:30:00,717,688,713,2118,12708
2016-04-29 09:40:00,765,725,752,2242,13452
2016-04-29 09:50:00,785,750,777,2312,13872
2016-04-29 10:00:00,886,853,884,2623,15738
2016-04-29 10:10:00,906,872,899,2677,16062
2016-04-29 10:20:00,903,856,889,2648,15888
2016-04-29 10:30:00,917,876,895,2688,16128
2016-04-29 10:40:00,922,890,911,2723,16338
2016-04-29 10:50:00,865,831,853,2549,15294
2016-04-29 11:00:00,829,805,818,2452,14712
2016-04-29 11:10:00,805,778,788,2371,14226
2016-04-29 11:20:00,469,443,458,1370,8220
2016-04-29 11:30:00,840,805,828,2473,14838
2016-04-29 11:40:00,777,746,768,2291,13746
2016-04-29 11:50:00,953,922,942,2817,16902
2016-04-29 12:00:00,1033,995,1010,3038,18228
2016-04-29 12:10:00,485,453,471,1409,8454
2016-04-29 12:20:00,693,661,671,2025,12150
2016-04-29 12:30:00,869,841,852,2562,15372
2016-04-29 12:40:00,934,911,918,2763,16578
2016-04-29 12:50:00,872,853,864,2589,15534
2016-04-29 13:00:00,717,696,708,2121,12726
2016-04-29 13:10:00,658,635,658,1951,11706
2016-04-29 13:20:00,537,510,533,1580,9480
2016-04-29 13:30:00,407,382,398,1187,7122
2016-04-29 13:40:00,355,329,344,1028,6168
2016-04-29 13:50:00,325,294,312,931,5586
2016-04-29 14:00:00,363,336,352,1051,6306
2016-04-29 14:10:00,293,270,284,847,5082
2016-04-29 14:20:00,248,224,240,712,4272
2016-04-29 14:30:00,167,142,160,469,2814
2016-04-29 14:40:00,165,141,156,462,2772
2016-04-29 14:50:00,197,172,186,555,3330
2016-04-29 15:00:00,242,216,230,688,4128
2016-04-29 15:10:00,232,207,225,664,3984
2016-04-29 15:20:00,202,181,196,579,3474
2016-04-29 15:30:00,147,126,137,410,2460
2016-04-29 15:40:00,39,117,132,288,1728
2016-04-29 15:50:00,46,42,83,171,1026
2016-04-29 16:00:00,32,37,63,132,792
2016-04-29 16:10:00,18,8,31,57,342
2016-04-29 16:20:00,37,29,62,128,768
2016-04-29 16:30:00,38,49,80,167,1002
2016-04-29 16:40:00,24,69,93,186,1116
2016-04-29 16:50:00,25,60,84,169,1014
2016-04-29 17:00:00,36,24,60,120,720
2016-04-29 17:10:00,35,17,54,106,636
2016-04-29 17:20:00,30,38,69,137,822
2016-04-29 17:30:00,28,29,59,116,696
2016-04-29 17:40:00,29,7,42,78,468
2016-04-29 17:50:00,29,20,51,100,600
2016-04-29 18:00:00,30,24,59,113,678
2016-04-29 18:10:00,15,12,33,60,360
2016-04-29 18:20:00,13,11,29,53,318
2016-04-29 18:30:00,9,10,26,45,270
2016-04-29 18:40:00,8,5,23,36,216
2016-04-29 18:50:00,11,5,20,36,216
2016-04-29 19:00:00,11,18,38,67,402
2016-04-29 19:10:00,7,15,34,56,336
2016-04-29 19:20:00,10,8,24,42,252
2016-04-29 19:30:00,9,9,24,42,252
2016-04-29 19:40:00,11,5,18,34,204
2016-04-29 19:50:00,9,3,12,24,144
2016-04-29 20:00:00,3,1,5,9,54
2016-04-29 20:10:00,0,0,0,0,0
2016-04-29 20:20:00,0,0,0,0,0
2016-04-29 20:30:00,0,0,0,0,0
2016-04-29 20:40:00,0,0,0,0,0
2016-04-29 20:50:00,0,0,0,0,0
2016-04-29 21:00:00,0,0,0,0,0
2016-04-30 05:20:00,0,0,0,0,0
2016-04-30 05:30:00,0,0,0,0,0
2016-04-30 05:40:00,0,0,0,0,0
2016-04-30 05:50:00,0,0,0,0,0
2016-04-30 06:00:00,1,0,1,2,12
2016-04-30 06:10:00,3,0,5,8,48
2016-04-30 06:20:00,12,6,17,35,210
2016-04-30 06:30:00,10,15,13,38,228
2016-04-30 06:40:00,15,6,18,39,234
2016-04-30 06:50:00,13,5,16,34,204
2016-04-30 07:00:00,13,13,32,58,348
2016-04-30 07:10:00,12,22,46,80,480
2016-04-30 07:20:00,11,21,47,79,474
2016-04-30 07:30:00,12,17,47,76,456
2016-04-30 07:40:00,9,11,28,48,288
2016-04-30 07:50:00,8,10,26,44,264
2016-04-30 08:00:00,17,23,44,84,504
2016-04-30 08:10:00,27,21,56,104,624
2016-04-30 08:20:00,9,73,87,169,1014
2016-04-30 08:30:00,10,103,116,229,1374
2016-04-30 08:40:00,24,90,110,224,1344
2016-04-30 08:50:00,23,52,77,152,912
2016-04-30 09:00:00,26,67,92,185,1110
2016-04-30 09:10:00,13,86,101,200,1200
2016-04-30 09:20:00,38,111,123,272,1632
2016-04-30 09:30:00,24,81,95,200,1200
2016-04-30 09:40:00,21,120,128,269,1614
2016-04-30 09:50:00,34,211,161,406,2436
2016-04-30 10:00:00,196,123,151,470,2820
2016-04-30 10:10:00,233,229,249,711,4266
2016-04-30 10:20:00,429,400,416,1245,7470
2016-04-30 10:30:00,346,318,336,1000,6000
2016-04-30 10:40:00,257,228,247,732,4392
2016-04-30 10:50:00,141,98,141,380,2280
2016-04-30 11:00:00,77,75,87,239,1434
2016-04-30 11:10:00,54,52,79,185,1110
2016-04-30 11:20:00,33,71,97,201,1206
2016-04-30 11:30:00,38,99,117,254,1524
2016-04-30 11:40:00,70,84,131,285,1710
2016-04-30 11:50:00,72,85,100,257,1542
2016-04-30 12:00:00,36,62,90,188,1128
2016-04-30 12:10:00,51,90,112,253,1518
2016-04-30 12:20:00,100,115,153,368,2208
2016-04-30 12:30:00,193,52,258,503,3018
2016-04-30 12:40:00,309,271,296,876,5256
2016-04-30 12:50:00,564,511,544,1619,9714
2016-04-30 13:00:00,472,433,453,1358,8148
2016-04-30 13:10:00,358,322,346,1026,6156
2016-04-30 13:20:00,338,301,325,964,5784
2016-04-30 13:30:00,401,364,392,1157,6942
2016-04-30 13:40:00,382,348,375,1105,6630
2016-04-30 13:50:00,389,356,381,1126,6756
2016-04-30 14:00:00,477,441,470,1388,8328
2016-04-30 14:10:00,475,437,464,1376,8256
2016-04-30 14:20:00,391,354,379,1124,6744
2016-04-30 14:30:00,404,370,394,1168,7008
2016-04-30 14:40:00,436,402,425,1263,7578
2016-04-30 14:50:00,401,371,391,1163,6978
2016-04-30 15:00:00,357,329,349,1035,6210
2016-04-30 15:10:00,330,303,322,955,5730
2016-04-30 15:20:00,312,284,305,901,5406
2016-04-30 15:30:00,328,300,320,948,5688
2016-04-30 15:40:00,327,299,319,945,5670
2016-04-30 15:50:00,241,216,233,690,4140
2016-04-30 16:00:00,165,141,155,461,2766
2016-04-30 16:10:00,318,289,310,917,5502
2016-04-30 16:20:00,332,301,324,957,5742
2016-04-30 16:30:00,287,254,279,820,4920
2016-04-30 16:40:00,191,164,182,537,3222
2016-04-30 16:50:00,208,120,177,505,3030
2016-04-30 17:00:00,186,5,313,504,3024
2016-04-30 17:10:00,117,83,198,398,2388
2016-04-30 17:20:00,63,155,175,393,2358
2016-04-30 17:30:00,128,184,169,481,2886
2016-04-30 17:40:00,125,85,196,406,2436
2016-04-30 17:50:00,76,130,151,357,2142
2016-04-30 18:00:00,96,133,169,398,2388
2016-04-30 18:10:00,109,81,199,389,2334
2016-04-30 18:20:00,36,152,205,393,2358
2016-04-30 18:30:00,32,156,200,388,2328
2016-04-30 18:40:00,45,155,161,361,2166
2016-04-30 18:50:00,0,150,157,307,1842
2016-04-30 19:00:00,0,138,137,275,1650
2016-04-30 19:10:00,23,114,117,254,1524
2016-04-30 19:20:00,49,79,94,222,1332
2016-04-30 19:30:00,15,85,96,196,1176
2016-04-30 19:40:00,1,88,95,184,1104
2016-04-30 19:50:00,21,59,82,162,972
2016-04-30 20:00:00,33,34,68,135,810
2016-04-30 20:10:00,25,19,73,117,702
2016-04-30 20:20:00,18,11,41,70,420
2016-04-30 20:30:00,10,5,15,30,180
2016-04-30 20:40:00,2,1,2,5,30
2016-04-30 20:50:00,0,0,0,0,0
2016-04-30 21:00:00,0,0,0,0,0
2016-04-30 21:10:00,0,0,0,0,0
2016-05-01 05:00:00,0,0,0,0,0
2016-05-01 05:10:00,0,0,0,0,0
2016-05-01 05:20:00,0,0,0,0,0
2016-05-01 05:30:00,0,0,0,0,0
2016-05-01 05:40:00,0,0,0,0,0
2016-05-01 05:50:00,1,0,2,3,18
2016-05-01 06:00:00,4,1,6,11,66
2016-05-01 06:10:00,8,1,11,20,120
2016-05-01 06:20:00,11,3,17,31,186
2016-05-01 06:30:00,16,10,31,57,342
2016-05-01 06:40:00,20,20,48,88,528
2016-05-01 06:50:00,26,21,48,95,570
2016-05-01 07:00:00,30,16,51,97,582
2016-05-01 07:10:00,25,35,64,124,744
2016-05-01 07:20:00,31,46,79,156,936
2016-05-01 07:30:00,12,71,89,172,1032
2016-05-01 07:40:00,26,83,108,217,1302
2016-05-01 07:50:00,125,59,273,457,2742
2016-05-01 08:00:00,172,152,288,612,3672
2016-05-01 08:10:00,268,239,274,781,4686
2016-05-01 08:20:00,328,306,324,958,5748
2016-05-01 08:30:00,389,368,385,1142,6852
2016-05-01 08:40:00,448,428,446,1322,7932
2016-05-01 08:50:00,510,488,506,1504,9024
2016-05-01 09:00:00,575,545,575,1695,10170
2016-05-01 09:10:00,639,607,633,1879,11274
2016-05-01 09:20:00,698,667,686,2051,12306
2016-05-01 09:30:00,747,716,740,2203,13218
2016-05-01 09:40:00,769,732,758,2259,13554
2016-05-01 09:50:00,845,804,840,2489,14934
2016-05-01 10:00:00,887,852,875,2614,15684
2016-05-01 10:10:00,923,882,906,2711,16266
2016-05-01 10:20:00,900,852,887,2639,15834
2016-05-01 10:30:00,969,930,966,2865,17190
2016-05-01 10:40:00,984,959,987,2930,17580
2016-05-01 10:50:00,1004,978,1002,2984,17904
2016-05-01 11:00:00,1034,992,1032,3058,18348
2016-05-01 11:10:00,958,948,986,2892,17352
2016-05-01 11:20:00,1068,1039,1067,3174,19044
2016-05-01 11:30:00,1071,1059,1077,3207,19242
2016-05-01 11:40:00,1074,1073,1093,3240,19440
2016-05-01 11:50:00,1091,1082,1103,3276,19656
2016-05-01 12:00:00,1114,1083,1110,3307,19842
2016-05-01 12:10:00,1124,1088,1122,3334,20004
2016-05-01 12:20:00,1127,1093,1131,3351,20106
2016-05-01 12:30:00,1142,1101,1131,3374,20244
2016-05-01 12:40:00,1148,1111,1127,3386,20316
2016-05-01 12:50:00,1148,1115,1136,3399,20394
2016-05-01 13:00:00,1150,1107,1136,3393,20358
2016-05-01 13:10:00,1142,1106,1128,3376,20256
2016-05-01 13:20:00,1140,1099,1123,3362,20172
2016-05-01 13:30:00,1134,1091,1122,3347,20082
2016-05-01 13:40:00,1127,1084,1105,3316,19896
2016-05-01 13:50:00,1107,1076,1099,3282,19692
2016-05-01 14:00:00,1096,1071,1094,3261,19566
2016-05-01 14:10:00,1084,1052,1083,3219,19314
2016-05-01 14:20:00,1073,1035,1069,3177,19062
2016-05-01 14:30:00,1066,1028,1048,3142,18852
2016-05-01 14:40:00,1048,1010,1035,3093,18558
2016-05-01 14:50:00,1021,987,1007,3015,18090
2016-05-01 15:00:00,1000,968,984,2952,17712
2016-05-01 15:10:00,777,747,761,2285,13710
2016-05-01 15:20:00,829,801,822,2452,14712
2016-05-01 15:30:00,880,857,877,2614,15684
2016-05-01 15:40:00,824,796,811,2431,14586
2016-05-01 15:50:00,716,684,712,2112,12672
2016-05-01 16:00:00,733,699,728,2160,12960
2016-05-01 16:10:00,721,684,713,2118,12708
2016-05-01 16:20:00,681,645,669,1995,11970
2016-05-01 16:30:00,641,614,630,1885,11310
2016-05-01 16:40:00,593,570,583,1746,10476
2016-05-01 16:50:00,550,525,542,1617,9702
2016-05-01 17:00:00,493,464,486,1443,8658
2016-05-01 17:10:00,430,399,420,1249,7494
2016-05-01 17:20:00,392,359,381,1132,6792
2016-05-01 17:30:00,358,322,348,1028,6168
2016-05-01 17:40:00,336,301,327,964,5784
2016-05-01 17:50:00,283,254,278,815,4890
2016-05-01 18:00:00,220,196,215,631,3786
2016-05-01 18:10:00,195,171,189,555,3330
2016-05-01 18:20:00,150,126,145,421,2526
2016-05-01 18:30:00,111,89,107,307,1842
2016-05-01 18:40:00,63,73,87,223,1338
2016-05-01 18:50:00,29,73,73,175,1050
2016-05-01 19:00:00,39,50,52,141,846
2016-05-01 19:10:00,18,25,74,117,702
2016-05-01 19:20:00,25,28,48,101,606
2016-05-01 19:30:00,27,24,52,103,618
2016-05-01 19:40:00,25,28,53,106,636
2016-05-01 19:50:00,25,18,48,91,546
2016-05-01 20:00:00,19,17,45,81,486
2016-05-01 20:10:00,14,10,30,54,324
2016-05-01 20:20:00,6,5,8,19,114
2016-05-01 20:30:00,2,2,2,6,36
2016-05-01 20:40:00,0,0,0,0,0
2016-05-01 20:50:00,0,0,0,0,0
2016-05-01 21:00:00,0,0,0,0,0
2016-05-02 05:00:00,0,0,0,0,0
2016-05-02 05:10:00,0,0,0,0,0
2016-05-02 05:20:00,0,0,0,0,0
2016-05-02 05:30:00,0,0,0,0,0
2016-05-02 05:40:00,1,0,2,3,18
2016-05-02 05:50:00,5,2,8,15,90
2016-05-02 06:00:00,11,3,14,28,168
2016-05-02 06:10:00,16,6,22,44,264
2016-05-02 06:20:00,16,11,32,59,354
2016-05-02 06:30:00,25,10,35,70,420
2016-05-02 06:40:00,23,16,48,87,522
2016-05-02 06:50:00,22,27,69,118,708
2016-05-02 07:00:00,33,53,64,150,900
2016-05-02 07:10:00,10,76,95,181,1086
2016-05-02 07:20:00,39,75,104,218,1308
2016-05-02 07:30:00,30,103,114,247,1482
2016-05-02 07:40:00,6,123,128,257,1542
2016-05-02 07:50:00,89,107,161,357,2142
2016-05-02 08:00:00,272,166,180,618,3708
2016-05-02 08:10:00,237,211,231,679,4074
2016-05-02 08:20:00,318,297,317,932,5592
2016-05-02 08:30:00,356,332,353,1041,6246
2016-05-02 08:40:00,440,414,437,1291,7746
2016-05-02 08:50:00,514,482,509,1505,9030
2016-05-02 09:00:00,572,539,571,1682,10092
2016-05-02 09:10:00,633,605,632,1870,11220
2016-05-02 09:20:00,677,649,672,1998,11988
2016-05-02 09:30:00,723,692,715,2130,12780
2016-05-02 09:40:00,798,766,787,2351,14106
2016-05-02 09:50:00,833,800,818,2451,14706
2016-05-02 10:00:00,857,825,851,2533,15198
2016-05-02 10:10:00,911,875,890,2676,16056
2016-05-02 10:20:00,934,890,923,2747,16482
2016-05-02 10:30:00,953,911,944,2808,16848
2016-05-02 10:40:00,986,948,983,2917,17502
2016-05-02 10:50:00,1013,969,1008,2990,17940
2016-05-02 11:00:00,1030,986,1022,3038,18228
2016-05-02 11:10:00,1050,1008,1038,3096,18576
2016-05-02 11:20:00,1057,1014,1047,3118,18708
2016-05-02 11:30:00,1065,1024,1056,3145,18870
2016-05-02 11:40:00,1107,1061,1095,3263,19578
2016-05-02 11:50:00,1108,1069,1096,3273,19638
2016-05-02 12:00:00,1123,1078,1111,3312,19872
2016-05-02 12:10:00,1106,1072,1096,3274,19644
2016-05-02 12:20:00,1139,1091,1129,3359,20154
2016-05-02 12:30:00,1142,1090,1126,3358,20148
2016-05-02 12:40:00,1150,1099,1131,3380,20280
2016-05-02 12:50:00,1143,1086,1126,3355,20130
2016-05-02 13:00:00,1139,1091,1124,3354,20124
2016-05-02 13:10:00,1121,1087,1119,3327,19962
2016-05-02 13:20:00,1129,1085,1119,3333,19998
2016-05-02 13:30:00,1136,1089,1118,3343,20058
2016-05-02 13:40:00,1089,1036,1073,3198,19188
2016-05-02 13:50:00,1097,1056,1084,3237,19422
2016-05-02 14:00:00,1087,1048,1077,3212,19272
2016-05-02 14:10:00,1080,1033,1066,3179,19074
2016-05-02 14:20:00,1060,1021,1045,3126,18756
2016-05-02 14:30:00,1036,996,1032,3064,18384
2016-05-02 14:40:00,1005,966,994,2965,17790
2016-05-02 14:50:00,966,940,971,2877,17262
2016-05-02 15:00:00,919,888,914,2721,16326
2016-05-02 15:10:00,918,885,907,2710,16260
2016-05-02 15:20:00,854,823,847,2524,15144
2016-05-02 15:30:00,792,763,790,2345,14070
2016-05-02 15:40:00,782,755,782,2319,13914
2016-05-02 15:50:00,734,698,724,2156,12936
2016-05-02 16:00:00,668,635,660,1963,11778
2016-05-02 16:10:00,615,578,601,1794,10764
2016-05-02 16:20:00,551,518,542,1611,9666
2016-05-02 16:30:00,537,501,526,1564,9384
2016-05-02 16:40:00,500,465,490,1455,8730
2016-05-02 16:50:00,467,435,454,1356,8136
2016-05-02 17:00:00,434,403,423,1260,7560
2016-05-02 17:10:00,375,344,365,1084,6504
2016-05-02 17:20:00,272,246,266,784,4704
2016-05-02 17:30:00,191,167,187,545,3270
2016-05-02 17:40:00,185,159,180,524,3144
2016-05-02 17:50:00,165,133,166,464,2784
2016-05-02 18:00:00,47,149,169,365,2190
2016-05-02 18:10:00,39,140,153,332,1992
2016-05-02 18:20:00,76,85,140,301,1806
2016-05-02 18:30:00,49,90,114,253,1518
2016-05-02 18:40:00,48,74,89,211,1266
2016-05-02 18:50:00,63,77,70,210,1260
2016-05-02 19:00:00,41,74,76,191,1146
2016-05-02 19:10:00,62,69,34,165,990
2016-05-02 19:20:00,47,45,54,146,876
2016-05-02 19:30:00,31,24,74,129,774
2016-05-02 19:40:00,34,28,48,110,660
2016-05-02 19:50:00,30,14,43,87,522
2016-05-02 20:00:00,21,11,29,61,366
2016-05-02 20:10:00,10,10,20,40,240
2016-05-02 20:20:00,9,1,10,20,120
2016-05-02 20:30:00,1,1,2,4,24
2016-05-02 20:40:00,0,0,0,0,0
2016-05-02 20:50:00,0,0,0,0,0
2016-05-02 21:00:00,0,0,0,0,0
2016-05-03 04:50:00,0,0,0,0,0
2016-05-03 05:00:00,0,0,0,0,0
2016-05-03 05:10:00,0,0,0,0,0
2016-05-03 05:20:00,0,0,0,0,0
2016-05-03 05:30:00,1,0,2,3,18
2016-05-03 05:40:00,10,1,12,23,138
2016-05-03 05:50:00,17,2,18,37,222
2016-05-03 06:00:00,23,4,28,55,330
2016-05-03 06:10:00,30,6,41,77,462
2016-05-03 06:20:00,41,20,50,111,666
2016-05-03 06:30:00,48,37,77,162,972
2016-05-03 06:40:00,58,68,93,219,1314
2016-05-03 06:50:00,50,60,91,201,1206
2016-05-03 07:00:00,67,47,89,203,1218
2016-05-03 07:10:00,110,39,119,268,1608
2016-05-03 07:20:00,81,80,148,309,1854
2016-05-03 07:30:00,65,151,154,370,2220
2016-05-03 07:40:00,54,137,168,359,2154
2016-05-03 07:50:00,177,32,278,487,2922
2016-05-03 08:00:00,107,80,206,393,2358
2016-05-03 08:10:00,55,248,196,499,2994
2016-05-03 08:20:00,85,194,224,503,3018
2016-05-03 08:30:00,188,165,182,535,3210
2016-05-03 08:40:00,155,132,147,434,2604
2016-05-03 08:50:00,141,124,181,446,2676
2016-05-03 09:00:00,188,170,157,515,3090
2016-05-03 09:10:00,83,124,140,347,2082
2016-05-03 09:20:00,46,73,89,208,1248
2016-05-03 09:30:00,52,107,123,282,1692
2016-05-03 09:40:00,87,131,147,365,2190
2016-05-03 09:50:00,201,112,171,484,2904
2016-05-03 10:00:00,123,124,157,404,2424
2016-05-03 10:10:00,19,124,135,278,1668
2016-05-03 10:20:00,41,38,75,154,924
2016-05-03 10:30:00,40,102,110,252,1512
2016-05-03 10:40:00,70,54,104,228,1368
2016-05-03 10:50:00,22,6,28,56,336
2016-05-03 11:00:00,74,35,90,199,1194
2016-05-03 11:10:00,29,15,44,88,528
2016-05-03 11:20:00,53,57,93,203,1218
2016-05-03 11:30:00,26,132,146,304,1824
2016-05-03 11:40:00,187,55,245,487,2922
2016-05-03 11:50:00,106,118,206,430,2580
2016-05-03 12:00:00,255,227,246,728,4368
2016-05-03 12:10:00,324,294,319,937,5622
2016-05-03 12:20:00,311,283,307,901,5406
2016-05-03 12:30:00,316,291,310,917,5502
2016-05-03 12:40:00,153,129,147,429,2574
2016-05-03 12:50:00,253,226,247,726,4356
2016-05-03 13:00:00,363,340,363,1066,6396
2016-05-03 13:10:00,365,340,362,1067,6402
2016-05-03 13:20:00,434,406,430,1270,7620
2016-05-03 13:30:00,490,463,490,1443,8658
2016-05-03 13:40:00,464,436,460,1360,8160
2016-05-03 13:50:00,411,381,404,1196,7176
2016-05-03 14:00:00,405,377,397,1179,7074
2016-05-03 14:10:00,368,346,362,1076,6456
2016-05-03 14:20:00,386,358,380,1124,6744
2016-05-03 14:30:00,454,425,447,1326,7956
2016-05-03 14:40:00,399,371,392,1162,6972
2016-05-03 14:50:00,412,382,403,1197,7182
2016-05-03 15:00:00,744,709,734,2187,13122
2016-05-03 15:10:00,644,614,638,1896,11376
2016-05-03 15:20:00,606,594,605,1805,10830
2016-05-03 15:30:00,603,586,594,1783,10698
2016-05-03 15:40:00,514,496,510,1520,9120
2016-05-03 15:50:00,289,270,284,843,5058
2016-05-03 16:00:00,127,104,123,354,2124
2016-05-03 16:10:00,213,57,222,492,2952
2016-05-03 16:20:00,259,233,255,747,4482
2016-05-03 16:30:00,429,402,425,1256,7536
2016-05-03 16:40:00,530,501,524,1555,9330
2016-05-03 16:50:00,207,182,200,589,3534
2016-05-03 17:00:00,171,147,166,484,2904
2016-05-03 17:10:00,222,199,218,639,3834
2016-05-03 17:20:00,160,136,154,450,2700
2016-05-03 17:30:00,260,233,251,744,4464
2016-05-03 17:40:00,249,222,242,713,4278
2016-05-03 17:50:00,139,117,129,385,2310
2016-05-03 18:00:00,145,122,139,406,2436
2016-05-03 18:10:00,188,157,156,501,3006
2016-05-03 18:20:00,126,129,144,399,2394
2016-05-03 18:30:00,103,78,131,312,1872
2016-05-03 18:40:00,70,54,100,224,1344
2016-05-03 18:50:00,63,76,90,229,1374
2016-05-03 19:00:00,59,76,89,224,1344
2016-05-03 19:10:00,18,77,94,189,1134
2016-05-03 19:20:00,38,56,67,161,966
2016-05-03 19:30:00,49,47,61,157,942
2016-05-03 19:40:00,34,22,71,127,762
2016-05-03 19:50:00,38,11,49,98,588
2016-05-03 20:00:00,30,10,45,85,510
2016-05-03 20:10:00,19,7,28,54,324
2016-05-03 20:20:00,12,3,17,32,192
2016-05-03 20:30:00,6,1,8,15,90
2016-05-03 20:40:00,0,0,1,1,6
2016-05-03 20:50:00,0,0,0,0,0
2016-05-03 21:00:00,0,0,0,0,0
2016-05-03 21:10:00,0,0,0,0,0
2016-05-04 04:50:00,0,0,0,0,0
2016-05-04 05:00:00,0,0,0,0,0
2016-05-04 05:10:00,0,0,0,0,0
2016-05-04 05:20:00,0,0,0,0,0
2016-05-04 05:30:00,1,0,1,2,12
2016-05-04 05:40:00,5,2,7,14,84
2016-05-04 05:50:00,11,3,14,28,168
2016-05-04 06:00:00,13,7,21,41,246
2016-05-04 06:10:00,19,9,30,58,348
2016-05-04 06:20:00,18,14,39,71,426
2016-05-04 06:30:00,22,21,46,89,534
2016-05-04 06:40:00,30,26,62,118,708
2016-05-04 06:50:00,61,20,54,135,810
2016-05-04 07:00:00,44,44,81,169,1014
2016-05-04 07:10:00,31,74,94,199,1194
2016-05-04 07:20:00,34,108,120,262,1572
2016-05-04 07:30:00,30,123,132,285,1710
2016-05-04 07:40:00,44,127,146,317,1902
2016-05-04 07:50:00,81,148,185,414,2484
2016-05-04 08:00:00,91,134,148,373,2238
2016-05-04 08:10:00,268,243,265,776,4656
2016-05-04 08:20:00,277,214,239,730,4380
2016-05-04 08:30:00,202,192,167,561,3366
2016-05-04 08:40:00,269,239,258,766,4596
2016-05-04 08:50:00,308,278,296,882,5292
2016-05-04 09:00:00,605,566,596,1767,10602
2016-05-04 09:10:00,666,630,658,1954,11724
2016-05-04 09:20:00,713,682,703,2098,12588
2016-05-04 09:30:00,770,737,762,2269,13614
2016-05-04 09:40:00,786,748,778,2312,13872
2016-05-04 09:50:00,857,820,847,2524,15144
2016-05-04 10:00:00,885,852,874,2611,15666
2016-05-04 10:10:00,911,871,901,2683,16098
2016-05-04 10:20:00,943,900,938,2781,16686
2016-05-04 10:30:00,966,924,963,2853,17118
2016-05-04 10:40:00,989,950,989,2928,17568
2016-05-04 10:50:00,1015,985,1005,3005,18030
2016-05-04 11:00:00,1037,999,1018,3054,18324
2016-05-04 11:10:00,1057,1009,1044,3110,18660
2016-05-04 11:20:00,1062,1020,1058,3140,18840
2016-05-04 11:30:00,1081,1030,1073,3184,19104
2016-05-04 11:40:00,1097,1042,1082,3221,19326
2016-05-04 11:50:00,1108,1060,1087,3255,19530
2016-05-04 12:00:00,1113,1070,1098,3281,19686
2016-05-04 12:10:00,1115,1074,1103,3292,19752
2016-05-04 12:20:00,1127,1071,1110,3308,19848
2016-05-04 12:30:00,1134,1078,1116,3328,19968
2016-05-04 12:40:00,1135,1089,1112,3336,20016
2016-05-04 12:50:00,1115,1091,1112,3318,19908
2016-05-04 13:00:00,1119,1088,1114,3321,19926
2016-05-04 13:10:00,1127,1081,1113,3321,19926
2016-05-04 13:20:00,1124,1078,1103,3305,19830
2016-05-04 13:30:00,1106,1068,1097,3271,19626
2016-05-04 13:40:00,1106,1075,1096,3277,19662
2016-05-04 13:50:00,1109,1068,1098,3275,19650
2016-05-04 14:00:00,1077,1068,1092,3237,19422
2016-05-04 14:10:00,1029,1004,1028,3061,18366
2016-05-04 14:20:00,1069,1036,1064,3169,19014
2016-05-04 14:30:00,1044,1016,1032,3092,18552
2016-05-04 14:40:00,1012,981,997,2990,17940
2016-05-04 14:50:00,991,952,972,2915,17490
2016-05-04 15:00:00,966,912,951,2829,16974
2016-05-04 15:10:00,934,884,915,2733,16398
2016-05-04 15:20:00,893,854,876,2623,15738
2016-05-04 15:30:00,862,833,847,2542,15252
2016-05-04 15:40:00,830,803,817,2450,14700
2016-05-04 15:50:00,785,754,765,2304,13824
2016-05-04 16:00:00,745,716,727,2188,13128
2016-05-04 16:10:00,705,675,689,2069,12414
2016-05-04 16:20:00,658,632,647,1937,11622
2016-05-04 16:30:00,601,578,591,1770,10620
2016-05-04 16:40:00,568,545,556,1669,10014
2016-05-04 16:50:00,529,507,519,1555,9330
2016-05-04 17:00:00,486,455,477,1418,8508
2016-05-04 17:10:00,447,405,430,1282,7692
2016-05-04 17:20:00,399,371,397,1167,7002
2016-05-04 17:30:00,354,334,361,1049,6294
2016-05-04 17:40:00,315,303,328,946,5676
2016-05-04 17:50:00,271,248,267,786,4716
2016-05-04 18:00:00,226,205,223,654,3924
2016-05-04 18:10:00,182,163,179,524,3144
2016-05-04 18:20:00,122,137,141,400,2400
2016-05-04 18:30:00,107,91,115,313,1878
2016-05-04 18:40:00,72,66,81,219,1314
2016-05-04 18:50:00,43,47,69,159,954
2016-05-04 19:00:00,26,21,65,112,672
2016-05-04 19:10:00,12,11,97,120,720
2016-05-04 19:20:00,29,24,55,108,648
2016-05-04 19:30:00,25,17,47,89,534
2016-05-04 19:40:00,19,19,39,77,462
2016-05-04 19:50:00,18,17,30,65,390
2016-05-04 20:00:00,19,6,28,53,318
2016-05-04 20:10:00,12,7,21,40,240
2016-05-04 20:20:00,7,5,12,24,144
2016-05-04 20:30:00,2,2,5,9,54
2016-05-04 20:40:00,0,0,0,0,0
2016-05-04 20:50:00,0,0,0,0,0
2016-05-04 21:00:00,0,0,0,0,0
2016-05-04 21:10:00,0,0,0,0,0
2016-05-05 04:50:00,0,0,0,0,0
2016-05-05 05:00:00,0,0,0,0,0
2016-05-05 05:10:00,0,0,0,0,0
2016-05-05 05:20:00,0,0,0,0,0
2016-05-05 05:30:00,2,0,6,8,48
2016-05-05 05:40:00,5,3,17,25,150
2016-05-05 05:50:00,14,5,20,39,234
2016-05-05 06:00:00,15,9,30,54,324
2016-05-05 06:10:00,13,16,40,69,414
2016-05-05 06:20:00,16,18,47,81,486
2016-05-05 06:30:00,22,22,50,94,564
2016-05-05 06:40:00,25,27,53,105,630
2016-05-05 06:50:00,25,28,73,126,756
2016-05-05 07:00:00,30,54,69,153,918
2016-05-05 07:10:00,16,79,90,185,1110
2016-05-05 07:20:00,29,76,94,199,1194
2016-05-05 07:30:00,17,84,110,211,1266
2016-05-05 07:40:00,31,144,177,352,2112
2016-05-05 07:50:00,152,100,256,508,3048
2016-05-05 08:00:00,240,203,217,660,3960
2016-05-05 08:10:00,281,254,274,809,4854
2016-05-05 08:20:00,335,309,329,973,5838
2016-05-05 08:30:00,411,384,405,1200,7200
2016-05-05 08:40:00,459,435,457,1351,8106
2016-05-05 08:50:00,529,506,523,1558,9348
2016-05-05 09:00:00,584,556,580,1720,10320
2016-05-05 09:10:00,657,630,655,1942,11652
2016-05-05 09:20:00,711,664,701,2076,12456
2016-05-05 09:30:00,722,668,701,2091,12546
2016-05-05 09:40:00,821,756,800,2377,14262
2016-05-05 09:50:00,820,774,802,2396,14376
2016-05-05 10:00:00,836,795,823,2454,14724
2016-05-05 10:10:00,881,844,877,2602,15612
2016-05-05 10:20:00,931,886,918,2735,16410
2016-05-05 10:30:00,958,910,942,2810,16860
2016-05-05 10:40:00,977,935,973,2885,17310
2016-05-05 10:50:00,998,948,990,2936,17616
2016-05-05 11:00:00,1020,973,1007,3000,18000
2016-05-05 11:10:00,860,819,855,2534,15204
2016-05-05 11:20:00,1042,996,1034,3072,18432
2016-05-05 11:30:00,1056,1015,1049,3120,18720
2016-05-05 11:40:00,1071,1029,1066,3166,18996
2016-05-05 11:50:00,1084,1038,1079,3201,19206
2016-05-05 12:00:00,1084,1034,1083,3201,19206
2016-05-05 12:10:00,1092,1040,1094,3226,19356
2016-05-05 12:20:00,1094,1044,1095,3233,19398
2016-05-05 12:30:00,1093,1048,1090,3231,19386
2016-05-05 12:40:00,1101,1063,1100,3264,19584
2016-05-05 12:50:00,1118,1056,1110,3284,19704
2016-05-05 13:00:00,1122,1084,1113,3319,19914
2016-05-05 13:10:00,1033,1001,1023,3057,18342
2016-05-05 13:20:00,928,902,929,2759,16554
2016-05-05 13:30:00,1077,1041,1072,3190,19140
2016-05-05 13:40:00,1095,1056,1084,3235,19410
2016-05-05 13:50:00,1086,1033,1075,3194,19164
2016-05-05 14:00:00,1100,1037,1082,3219,19314
2016-05-05 14:10:00,1082,1027,1071,3180,19080
2016-05-05 14:20:00,1073,1016,1057,3146,18876
2016-05-05 14:30:00,920,873,909,2702,16212
2016-05-05 14:40:00,918,868,907,2693,16158
2016-05-05 14:50:00,976,923,961,2860,17160
2016-05-05 15:00:00,954,918,960,2832,16992
2016-05-05 15:10:00,924,875,920,2719,16314
2016-05-05 15:20:00,877,840,871,2588,15528
2016-05-05 15:30:00,845,817,845,2507,15042
2016-05-05 15:40:00,813,781,810,2404,14424
2016-05-05 15:50:00,768,737,766,2271,13626
2016-05-05 16:00:00,723,693,721,2137,12822
2016-05-05 16:10:00,687,659,687,2033,12198
2016-05-05 16:20:00,641,611,637,1889,11334
2016-05-05 16:30:00,584,554,579,1717,10302
2016-05-05 16:40:00,563,526,557,1646,9876
2016-05-05 16:50:00,517,485,512,1514,9084
2016-05-05 17:00:00,464,437,456,1357,8142
2016-05-05 17:10:00,419,396,415,1230,7380
2016-05-05 17:20:00,391,365,383,1139,6834
2016-05-05 17:30:00,354,329,348,1031,6186
2016-05-05 17:40:00,317,293,315,925,5550
2016-05-05 17:50:00,268,246,271,785,4710
2016-05-05 18:00:00,229,202,222,653,3918
2016-05-05 18:10:00,190,162,182,534,3204
2016-05-05 18:20:00,111,139,152,402,2412
2016-05-05 18:30:00,33,138,152,323,1938
2016-05-05 18:40:00,51,84,91,226,1356
2016-05-05 18:50:00,65,21,80,166,996
2016-05-05 19:00:00,43,19,57,119,714
2016-05-05 19:10:00,38,22,63,123,738
2016-05-05 19:20:00,40,12,55,107,642
2016-05-05 19:30:00,35,20,45,100,600
2016-05-05 19:40:00,30,19,40,89,534
2016-05-05 19:50:00,28,13,33,74,444
2016-05-05 20:00:00,16,18,19,53,318
2016-05-05 20:10:00,14,9,19,42,252
2016-05-05 20:20:00,8,8,7,23,138
2016-05-05 20:30:00,2,2,4,8,48
2016-05-05 20:40:00,0,0,0,0,0
2016-05-05 20:50:00,0,0,0,0,0
2016-05-05 21:00:00,0,0,0,0,0
2016-05-05 21:10:00,0,0,0,0,0
2016-05-06 04:50:00,0,0,0,0,0
2016-05-06 05:00:00,0,0,0,0,0
2016-05-06 05:10:00,0,0,0,0,0
2016-05-06 05:20:00,0,0,0,0,0
2016-05-06 05:30:00,2,1,3,6,36
2016-05-06 05:40:00,8,1,8,17,102
2016-05-06 05:50:00,16,1,17,34,204
2016-05-06 06:00:00,25,3,23,51,306
2016-05-06 06:10:00,23,6,35,64,384
2016-05-06 06:20:00,20,15,38,73,438
2016-05-06 06:30:00,25,24,39,88,528
2016-05-06 06:40:00,30,30,48,108,648
2016-05-06 06:50:00,24,22,82,128,768
2016-05-06 07:00:00,43,48,56,147,882
2016-05-06 07:10:00,47,62,63,172,1032
2016-05-06 07:20:00,52,64,80,196,1176
2016-05-06 07:30:00,68,71,84,223,1338
2016-05-06 07:40:00,95,75,202,372,2232
2016-05-06 07:50:00,223,137,195,555,3330
2016-05-06 08:00:00,273,211,209,693,4158
2016-05-06 08:10:00,242,223,242,707,4242
2016-05-06 08:20:00,262,242,257,761,4566
2016-05-06 08:30:00,351,329,348,1028,6168
2016-05-06 08:40:00,429,402,422,1253,7518
2016-05-06 08:50:00,491,456,479,1426,8556
2016-05-06 09:00:00,414,378,401,1193,7158
2016-05-06 09:10:00,536,504,528,1568,9408
2016-05-06 09:20:00,564,532,559,1655,9930
2016-05-06 09:30:00,683,648,678,2009,12054
2016-05-06 09:40:00,695,657,691,2043,12258
2016-05-06 09:50:00,740,704,730,2174,13044
2016-05-06 10:00:00,826,796,821,2443,14658
2016-05-06 10:10:00,878,843,863,2584,15504
2016-05-06 10:20:00,894,873,885,2652,15912
2016-05-06 10:30:00,871,849,869,2589,15534
2016-05-06 10:40:00,928,899,933,2760,16560
2016-05-06 10:50:00,954,917,957,2828,16968
2016-05-06 11:00:00,839,791,829,2459,14754
2016-05-06 11:10:00,990,947,989,2926,17556
2016-05-06 11:20:00,995,950,992,2937,17622
2016-05-06 11:30:00,1041,1006,1037,3084,18504
2016-05-06 11:40:00,1061,1026,1065,3152,18912
2016-05-06 11:50:00,1023,999,1026,3048,18288
2016-05-06 12:00:00,996,973,994,2963,17778
2016-05-06 12:10:00,972,946,972,2890,17340
2016-05-06 12:20:00,937,913,932,2782,16692
2016-05-06 12:30:00,1019,974,1009,3002,18012
2016-05-06 12:40:00,1023,987,1025,3035,18210
2016-05-06 12:50:00,1031,987,1016,3034,18204
2016-05-06 13:00:00,1051,1021,1045,3117,18702
2016-05-06 13:10:00,1067,1041,1054,3162,18972
2016-05-06 13:20:00,1097,1066,1082,3245,19470
2016-05-06 13:30:00,1040,1011,1029,3080,18480
2016-05-06 13:40:00,1040,1009,1022,3071,18426
2016-05-06 13:50:00,1075,1040,1055,3170,19020
2016-05-06 14:00:00,1054,1028,1034,3116,18696
2016-05-06 14:10:00,1027,997,1010,3034,18204
2016-05-06 14:20:00,1035,1006,1025,3066,18396
2016-05-06 14:30:00,1010,980,995,2985,17910
2016-05-06 14:40:00,979,950,972,2901,17406
2016-05-06 14:50:00,959,932,946,2837,17022
2016-05-06 15:00:00,922,885,902,2709,16254
2016-05-06 15:10:00,879,846,861,2586,15516
2016-05-06 15:20:00,855,820,841,2516,15096
2016-05-06 15:30:00,826,791,812,2429,14574
2016-05-06 15:40:00,783,754,772,2309,13854
2016-05-06 15:50:00,734,712,731,2177,13062
2016-05-06 16:00:00,703,670,695,2068,12408
2016-05-06 16:10:00,657,622,646,1925,11550
2016-05-06 16:20:00,603,569,597,1769,10614
2016-05-06 16:30:00,567,535,559,1661,9966
2016-05-06 16:40:00,536,510,529,1575,9450
2016-05-06 16:50:00,473,446,465,1384,8304
2016-05-06 17:00:00,455,430,449,1334,8004
2016-05-06 17:10:00,412,388,405,1205,7230
2016-05-06 17:20:00,374,350,369,1093,6558
2016-05-06 17:30:00,338,314,334,986,5916
2016-05-06 17:40:00,293,273,291,857,5142
2016-05-06 17:50:00,226,203,220,649,3894
2016-05-06 18:00:00,202,179,195,576,3456
2016-05-06 18:10:00,180,158,174,512,3072
2016-05-06 18:20:00,133,111,124,368,2208
2016-05-06 18:30:00,119,100,111,330,1980
2016-05-06 18:40:00,78,59,92,229,1374
2016-05-06 18:50:00,59,42,67,168,1008
2016-05-06 19:00:00,27,30,70,127,762
2016-05-06 19:10:00,24,22,79,125,750
2016-05-06 19:20:00,30,18,52,100,600
2016-05-06 19:30:00,26,13,36,75,450
2016-05-06 19:40:00,18,15,29,62,372
2016-05-06 19:50:00,17,8,30,55,330
2016-05-06 20:00:00,13,11,27,51,306
2016-05-06 20:10:00,12,15,21,48,288
2016-05-06 20:20:00,10,10,21,41,246
2016-05-06 20:30:00,6,8,8,22,132
2016-05-06 20:40:00,1,0,1,2,12
2016-05-06 20:50:00,0,0,0,0,0
2016-05-06 21:00:00,0,0,0,0,0
2016-05-06 21:10:00,0,0,0,0,0
2016-05-07 04:40:00,0,0,0,0,0
2016-05-07 04:50:00,0,0,0,0,0
2016-05-07 05:00:00,0,0,0,0,0
2016-05-07 05:10:00,0,0,0,0,0
2016-05-07 05:20:00,0,0,0,0,0
2016-05-07 05:30:00,1,2,1,4,24
2016-05-07 05:40:00,7,4,5,16,96
2016-05-07 05:50:00,12,7,13,32,192
2016-05-07 06:00:00,16,10,17,43,258
2016-05-07 06:10:00,19,15,22,56,336
2016-05-07 06:20:00,25,11,37,73,438
2016-05-07 06:30:00,37,10,49,96,576
2016-05-07 06:40:00,25,34,55,114,684
2016-05-07 06:50:00,39,33,67,139,834
2016-05-07 07:00:00,46,43,71,160,960
2016-05-07 07:10:00,74,33,75,182,1092
2016-05-07 07:20:00,62,62,77,201,1206
2016-05-07 07:30:00,65,69,80,214,1284
2016-05-07 07:40:00,84,86,143,313,1878
2016-05-07 07:50:00,243,71,170,484,2904
2016-05-07 08:00:00,315,153,115,583,3498
2016-05-07 08:10:00,316,199,169,684,4104
2016-05-07 08:20:00,313,286,302,901,5406
2016-05-07 08:30:00,367,347,362,1076,6456
2016-05-07 08:40:00,445,421,438,1304,7824
2016-05-07 08:50:00,462,441,460,1363,8178
2016-05-07 09:00:00,508,486,504,1498,8988
2016-05-07 09:10:00,573,548,566,1687,10122
2016-05-07 09:20:00,666,642,658,1966,11796
2016-05-07 09:30:00,680,657,676,2013,12078
2016-05-07 09:40:00,656,631,653,1940,11640
2016-05-07 09:50:00,723,700,716,2139,12834
2016-05-07 10:00:00,769,733,755,2257,13542
2016-05-07 10:10:00,801,762,790,2353,14118
2016-05-07 10:20:00,870,842,861,2573,15438
2016-05-07 10:30:00,892,865,887,2644,15864
2016-05-07 10:40:00,932,906,929,2767,16602
2016-05-07 10:50:00,930,902,920,2752,16512
2016-05-07 11:00:00,962,938,954,2854,17124
2016-05-07 11:10:00,987,959,984,2930,17580
2016-05-07 11:20:00,996,973,998,2967,17802
2016-05-07 11:30:00,1010,998,1015,3023,18138
2016-05-07 11:40:00,1028,1010,1021,3059,18354
2016-05-07 11:50:00,1036,1029,1042,3107,18642
2016-05-07 12:00:00,1048,1035,1056,3139,18834
2016-05-07 12:10:00,1055,1037,1056,3148,18888
2016-05-07 12:20:00,1063,1037,1060,3160,18960
2016-05-07 12:30:00,1060,1046,1078,3184,19104
2016-05-07 12:40:00,1066,1047,1070,3183,19098
2016-05-07 12:50:00,1054,1050,1071,3175,19050
2016-05-07 13:00:00,1070,1063,1070,3203,19218
2016-05-07 13:10:00,1058,1065,1072,3195,19170
2016-05-07 13:20:00,1075,1060,1062,3197,19182
2016-05-07 13:30:00,1070,1050,1065,3185,19110
2016-05-07 13:40:00,1060,1047,1061,3168,19008
2016-05-07 13:50:00,1054,1044,1060,3158,18948
2016-05-07 14:00:00,1047,1039,1056,3142,18852
2016-05-07 14:10:00,1043,1033,1045,3121,18726
2016-05-07 14:20:00,1031,1021,1035,3087,18522
2016-05-07 14:30:00,1008,995,1009,3012,18072
2016-05-07 14:40:00,984,974,975,2933,17598
2016-05-07 14:50:00,966,946,962,2874,17244
2016-05-07 15:00:00,933,913,934,2780,16680
2016-05-07 15:10:00,890,871,894,2655,15930
2016-05-07 15:20:00,863,845,872,2580,15480
2016-05-07 15:30:00,812,808,827,2447,14682
2016-05-07 15:40:00,786,773,795,2354,14124
2016-05-07 15:50:00,748,730,754,2232,13392
2016-05-07 16:00:00,704,694,713,2111,12666
2016-05-07 16:10:00,664,648,668,1980,11880
2016-05-07 16:20:00,629,613,635,1877,11262
2016-05-07 16:30:00,586,569,591,1746,10476
2016-05-07 16:40:00,544,529,551,1624,9744
2016-05-07 16:50:00,497,484,505,1486,8916
2016-05-07 17:00:00,453,441,461,1355,8130
2016-05-07 17:10:00,403,390,411,1204,7224
2016-05-07 17:20:00,372,356,377,1105,6630
2016-05-07 17:30:00,343,324,348,1015,6090
2016-05-07 17:40:00,302,295,316,913,5478
2016-05-07 17:50:00,259,240,260,759,4554
2016-05-07 18:00:00,223,197,219,639,3834
2016-05-07 18:10:00,179,169,161,509,3054
2016-05-07 18:20:00,84,154,156,394,2364
2016-05-07 18:30:00,111,122,82,315,1890
2016-05-07 18:40:00,68,66,84,218,1308
2016-05-07 18:50:00,48,42,66,156,936
2016-05-07 19:00:00,34,14,62,110,660
2016-05-07 19:10:00,12,13,98,123,738
2016-05-07 19:20:00,30,35,45,110,660
2016-05-07 19:30:00,30,35,33,98,588
2016-05-07 19:40:00,27,30,30,87,522
2016-05-07 19:50:00,25,30,20,75,450
2016-05-07 20:00:00,23,27,13,63,378
2016-05-07 20:10:00,17,21,12,50,300
2016-05-07 20:20:00,9,13,13,35,210
2016-05-07 20:30:00,5,8,7,20,120
2016-05-07 20:40:00,1,2,3,6,36
2016-05-07 20:50:00,0,0,0,0,0
2016-05-07 21:00:00,0,0,0,0,0
2016-05-07 21:10:00,0,0,0,0,0
2016-05-07 21:20:00,0,0,0,0,0
2016-05-08 04:50:00,0,0,0,0,0
2016-05-08 05:00:00,0,0,0,0,0
2016-05-08 05:10:00,0,0,0,0,0
2016-05-08 05:20:00,0,0,0,0,0
2016-05-08 05:30:00,2,1,2,5,30
2016-05-08 05:40:00,7,4,6,17,102
2016-05-08 05:50:00,13,7,11,31,186
2016-05-08 06:00:00,19,5,24,48,288
2016-05-08 06:10:00,23,8,34,65,390
2016-05-08 06:20:00,24,14,42,80,480
2016-05-08 06:30:00,30,19,44,93,558
2016-05-08 06:40:00,28,25,55,108,648
2016-05-08 06:50:00,12,9,103,124,744
2016-05-08 07:00:00,28,37,73,138,828
2016-05-08 07:10:00,42,51,59,152,912
2016-05-08 07:20:00,51,34,78,163,978
2016-05-08 07:30:00,21,70,84,175,1050
2016-05-08 07:40:00,96,117,129,342,2052
2016-05-08 07:50:00,143,176,185,504,3024
2016-05-08 08:00:00,232,159,248,639,3834
2016-05-08 08:10:00,264,244,286,794,4764
2016-05-08 08:20:00,330,304,324,958,5748
2016-05-08 08:30:00,384,358,378,1120,6720
2016-05-08 08:40:00,436,409,431,1276,7656
2016-05-08 08:50:00,492,470,492,1454,8724
2016-05-08 09:00:00,554,527,547,1628,9768
2016-05-08 09:10:00,609,585,606,1800,10800
2016-05-08 09:20:00,666,644,660,1970,11820
2016-05-08 09:30:00,717,690,710,2117,12702
2016-05-08 09:40:00,626,600,619,1845,11070
2016-05-08 09:50:00,786,758,774,2318,13908
2016-05-08 10:00:00,830,802,824,2456,14736
2016-05-08 10:10:00,871,837,864,2572,15432
2016-05-08 10:20:00,901,859,891,2651,15906
2016-05-08 10:30:00,921,890,914,2725,16350
2016-05-08 10:40:00,786,764,792,2342,14052
2016-05-08 10:50:00,957,928,961,2846,17076
2016-05-08 11:00:00,980,953,973,2906,17436
2016-05-08 11:10:00,1001,969,991,2961,17766
2016-05-08 11:20:00,1018,979,1006,3003,18018
2016-05-08 11:30:00,1027,1000,1023,3050,18300
2016-05-08 11:40:00,1030,1005,1033,3068,18408
2016-05-08 11:50:00,1032,1020,1051,3103,18618
2016-05-08 12:00:00,1036,1020,1062,3118,18708
2016-05-08 12:10:00,1044,1025,1065,3134,18804
2016-05-08 12:20:00,1048,1035,1070,3153,18918
2016-05-08 12:30:00,1059,1039,1068,3166,18996
2016-05-08 12:40:00,1059,1044,1062,3165,18990
2016-05-08 12:50:00,1059,1040,1062,3161,18966
2016-05-08 13:00:00,1060,1048,1067,3175,19050
2016-05-08 13:10:00,1069,1046,1058,3173,19038
2016-05-08 13:20:00,1064,1042,1059,3165,18990
2016-05-08 13:30:00,1058,1031,1053,3142,18852
2016-05-08 13:40:00,1050,1024,1043,3117,18702
2016-05-08 13:50:00,1046,1023,1034,3103,18618
2016-05-08 14:00:00,1035,1015,1023,3073,18438
2016-05-08 14:10:00,1025,1004,1020,3049,18294
2016-05-08 14:20:00,1013,993,1006,3012,18072
2016-05-08 14:30:00,987,967,978,2932,17592
2016-05-08 14:40:00,962,935,955,2852,17112
2016-05-08 14:50:00,934,918,938,2790,16740
2016-05-08 15:00:00,893,868,883,2644,15864
2016-05-08 15:10:00,851,839,855,2545,15270
2016-05-08 15:20:00,826,804,823,2453,14718
2016-05-08 15:30:00,787,773,793,2353,14118
2016-05-08 15:40:00,750,740,757,2247,13482
2016-05-08 15:50:00,703,707,723,2133,12798
2016-05-08 16:00:00,671,668,686,2025,12150
2016-05-08 16:10:00,639,612,630,1881,11286
2016-05-08 16:20:00,608,584,596,1788,10728
2016-05-08 16:30:00,558,534,547,1639,9834
2016-05-08 16:40:00,527,505,518,1550,9300
2016-05-08 16:50:00,483,460,475,1418,8508
2016-05-08 17:00:00,446,424,439,1309,7854
2016-05-08 17:10:00,401,379,395,1175,7050
2016-05-08 17:20:00,370,347,363,1080,6480
2016-05-08 17:30:00,344,313,333,990,5940
2016-05-08 17:40:00,309,280,297,886,5316
2016-05-08 17:50:00,255,228,245,728,4368
2016-05-08 18:00:00,209,185,202,596,3576
2016-05-08 18:10:00,169,146,164,479,2874
2016-05-08 18:20:00,137,115,132,384,2304
2016-05-08 18:30:00,111,89,106,306,1836
2016-05-08 18:40:00,75,77,64,216,1296
2016-05-08 18:50:00,54,45,53,152,912
2016-05-08 19:00:00,31,21,53,105,630
2016-05-08 19:10:00,21,13,90,124,744
2016-05-08 19:20:00,27,28,57,112,672
2016-05-08 19:30:00,30,36,33,99,594
2016-05-08 19:40:00,32,24,32,88,528
2016-05-08 19:50:00,26,16,34,76,456
2016-05-08 20:00:00,15,16,34,65,390
2016-05-08 20:10:00,14,19,19,52,312
2016-05-08 20:20:00,11,14,11,36,216
2016-05-08 20:30:00,5,7,9,21,126
2016-05-08 20:40:00,1,3,4,8,48
2016-05-08 20:50:00,0,0,0,0,0
2016-05-08 21:00:00,0,0,0,0,0
2016-05-08 21:10:00,0,0,0,0,0
2016-05-08 21:20:00,0,0,0,0,0
2016-05-09 04:40:00,0,0,0,0,0
2016-05-09 04:50:00,0,0,0,0,0
2016-05-09 05:00:00,0,0,0,0,0
2016-05-09 05:10:00,0,0,0,0,0
2016-05-09 05:20:00,0,1,1,2,12
2016-05-09 05:30:00,4,3,6,13,78
2016-05-09 05:40:00,8,5,13,26,156
2016-05-09 05:50:00,15,9,16,40,240
2016-05-09 06:00:00,20,11,24,55,330
2016-05-09 06:10:00,26,14,33,73,438
2016-05-09 06:20:00,28,26,37,91,546
2016-05-09 06:30:00,24,20,67,111,666
2016-05-09 06:40:00,41,31,66,138,828
2016-05-09 06:50:00,57,49,63,169,1014
2016-05-09 07:00:00,64,69,65,198,1188
2016-05-09 07:10:00,87,88,70,245,1470
2016-05-09 07:20:00,116,120,72,308,1848
2016-05-09 07:30:00,109,113,135,357,2142
2016-05-09 07:40:00,127,147,117,391,2346
2016-05-09 07:50:00,203,192,119,514,3084
2016-05-09 08:00:00,234,175,236,645,3870
2016-05-09 08:10:00,281,251,259,791,4746
2016-05-09 08:20:00,326,305,317,948,5688
2016-05-09 08:30:00,383,362,376,1121,6726
2016-05-09 08:40:00,438,415,433,1286,7716
2016-05-09 08:50:00,495,468,488,1451,8706
2016-05-09 09:00:00,551,525,544,1620,9720
2016-05-09 09:10:00,607,583,600,1790,10740
2016-05-09 09:20:00,659,640,652,1951,11706
2016-05-09 09:30:00,708,682,695,2085,12510
2016-05-09 09:40:00,759,727,742,2228,13368
2016-05-09 09:50:00,806,772,790,2368,14208
2016-05-09 10:00:00,839,806,825,2470,14820
2016-05-09 10:10:00,867,834,855,2556,15336
2016-05-09 10:20:00,889,860,882,2631,15786
2016-05-09 10:30:00,909,887,918,2714,16284
2016-05-09 10:40:00,924,911,937,2772,16632
2016-05-09 10:50:00,947,935,938,2820,16920
2016-05-09 11:00:00,972,947,961,2880,17280
2016-05-09 11:10:00,993,966,977,2936,17616
2016-05-09 11:20:00,1038,1010,1034,3082,18492
2016-05-09 11:30:00,1012,989,1011,3012,18072
2016-05-09 11:40:00,1011,994,1022,3027,18162
2016-05-09 11:50:00,1023,1008,1029,3060,18360
2016-05-09 12:00:00,1033,1016,1034,3083,18498
2016-05-09 12:10:00,1045,1032,1045,3122,18732
2016-05-09 12:20:00,1056,1038,1052,3146,18876
2016-05-09 12:30:00,1053,1041,1060,3154,18924
2016-05-09 12:40:00,1058,1041,1062,3161,18966
2016-05-09 12:50:00,1053,1035,1051,3139,18834
2016-05-09 13:00:00,1054,1031,1047,3132,18792
2016-05-09 13:10:00,1057,1034,1051,3142,18852
2016-05-09 13:20:00,1073,1032,1051,3156,18936
2016-05-09 13:30:00,1057,1023,1041,3121,18726
2016-05-09 13:40:00,1042,1023,1040,3105,18630
2016-05-09 13:50:00,1031,1014,1033,3078,18468
2016-05-09 14:00:00,1031,1008,1032,3071,18426
2016-05-09 14:10:00,1027,999,1020,3046,18276
2016-05-09 14:20:00,1013,982,1004,2999,17994
2016-05-09 14:30:00,981,958,976,2915,17490
2016-05-09 14:40:00,963,939,955,2857,17142
2016-05-09 14:50:00,938,913,929,2780,16680
2016-05-09 15:00:00,891,865,882,2638,15828
2016-05-09 15:10:00,869,844,860,2573,15438
2016-05-09 15:20:00,824,811,831,2466,14796
2016-05-09 15:30:00,789,768,788,2345,14070
2016-05-09 15:40:00,757,734,756,2247,13482
2016-05-09 15:50:00,709,686,705,2100,12600
2016-05-09 16:00:00,681,648,674,2003,12018
2016-05-09 16:10:00,641,607,640,1888,11328
2016-05-09 16:20:00,603,573,603,1779,10674
2016-05-09 16:30:00,558,528,557,1643,9858
2016-05-09 16:40:00,526,497,526,1549,9294
2016-05-09 16:50:00,485,460,484,1429,8574
2016-05-09 17:00:00,453,424,451,1328,7968
2016-05-09 17:10:00,407,380,405,1192,7152
2016-05-09 17:20:00,375,346,372,1093,6558
2016-05-09 17:30:00,345,316,340,1001,6006
2016-05-09 17:40:00,305,279,302,886,5316
2016-05-09 17:50:00,251,228,246,725,4350
2016-05-09 18:00:00,203,179,197,579,3474
2016-05-09 18:10:00,158,135,152,445,2670
2016-05-09 18:20:00,136,113,129,378,2268
2016-05-09 18:30:00,112,89,105,306,1836
2016-05-09 18:40:00,75,70,73,218,1308
2016-05-09 18:50:00,46,53,47,146,876
2016-05-09 19:00:00,38,43,54,135,810
2016-05-09 19:10:00,24,28,73,125,750
2016-05-09 19:20:00,15,14,85,114,684
2016-05-09 19:30:00,30,28,45,103,618
2016-05-09 19:40:00,27,23,42,92,552
2016-05-09 19:50:00,21,21,39,81,486
2016-05-09 20:00:00,19,16,34,69,414
2016-05-09 20:10:00,14,12,30,56,336
2016-05-09 20:20:00,13,11,17,41,246
2016-05-09 20:30:00,8,7,9,24,144
2016-05-09 20:40:00,3,3,5,11,66
2016-05-09 20:50:00,0,0,0,0,0
2016-05-09 21:00:00,0,0,0,0,0
2016-05-09 21:10:00,0,0,0,0,0
2016-05-09 21:20:00,0,0,0,0,0
2016-05-10 04:40:00,0,0,0,0,0
2016-05-10 04:50:00,0,0,0,0,0
2016-05-10 05:00:00,0,0,0,0,0
2016-05-10 05:10:00,0,0,0,0,0
2016-05-10 05:20:00,0,0,0,0,0
2016-05-10 05:30:00,2,2,3,7,42
2016-05-10 05:40:00,4,3,7,14,84
2016-05-10 05:50:00,8,2,10,20,120
2016-05-10 06:00:00,11,4,14,29,174
2016-05-10 06:10:00,15,13,24,52,312
2016-05-10 06:20:00,29,16,45,90,540
2016-05-10 06:30:00,35,31,42,108,648
2016-05-10 06:40:00,31,28,51,110,660
2016-05-10 06:50:00,19,66,76,161,966
2016-05-10 07:00:00,46,57,72,175,1050
2016-05-10 07:10:00,50,68,80,198,1188
2016-05-10 07:20:00,71,81,87,239,1434
2016-05-10 07:30:00,104,93,136,333,1998
2016-05-10 07:40:00,116,138,180,434,2604
2016-05-10 07:50:00,162,58,223,443,2658
2016-05-10 08:00:00,219,114,202,535,3210
2016-05-10 08:10:00,235,199,211,645,3870
2016-05-10 08:20:00,246,168,162,576,3456
2016-05-10 08:30:00,303,150,122,575,3450
2016-05-10 08:40:00,318,169,131,618,3708
2016-05-10 08:50:00,285,251,252,788,4728
2016-05-10 09:00:00,489,468,468,1425,8550
2016-05-10 09:10:00,595,572,574,1741,10446
2016-05-10 09:20:00,640,615,617,1872,11232
2016-05-10 09:30:00,688,659,661,2008,12048
2016-05-10 09:40:00,675,650,654,1979,11874
2016-05-10 09:50:00,697,674,682,2053,12318
2016-05-10 10:00:00,787,765,775,2327,13962
2016-05-10 10:10:00,840,820,826,2486,14916
2016-05-10 10:20:00,859,838,845,2542,15252
2016-05-10 10:30:00,886,862,872,2620,15720
2016-05-10 10:40:00,897,878,888,2663,15978
2016-05-10 10:50:00,917,893,918,2728,16368
2016-05-10 11:00:00,936,909,931,2776,16656
2016-05-10 11:10:00,957,938,956,2851,17106
2016-05-10 11:20:00,965,952,963,2880,17280
2016-05-10 11:30:00,983,962,981,2926,17556
2016-05-10 11:40:00,997,972,992,2961,17766
2016-05-10 11:50:00,999,980,997,2976,17856
2016-05-10 12:00:00,1008,989,1001,2998,17988
2016-05-10 12:10:00,1019,992,1000,3011,18066
2016-05-10 12:20:00,1018,999,1018,3035,18210
2016-05-10 12:30:00,1022,1004,1011,3037,18222
2016-05-10 12:40:00,1022,1004,1008,3034,18204
2016-05-10 12:50:00,1026,1004,1018,3048,18288
2016-05-10 13:00:00,1022,997,1011,3030,18180
2016-05-10 13:10:00,1023,997,1010,3030,18180
2016-05-10 13:20:00,1016,993,1006,3015,18090
2016-05-10 13:30:00,1014,991,1002,3007,18042
2016-05-10 13:40:00,1007,992,992,2991,17946
2016-05-10 13:50:00,1002,985,980,2967,17802
2016-05-10 14:00:00,983,972,982,2937,17622
2016-05-10 14:10:00,976,970,972,2918,17508
2016-05-10 14:20:00,961,950,962,2873,17238
2016-05-10 14:30:00,931,916,935,2782,16692
2016-05-10 14:40:00,914,896,911,2721,16326
2016-05-10 14:50:00,879,855,871,2605,15630
2016-05-10 15:00:00,832,809,827,2468,14808
2016-05-10 15:10:00,816,783,807,2406,14436
2016-05-10 15:20:00,778,747,768,2293,13758
2016-05-10 15:30:00,742,713,729,2184,13104
2016-05-10 15:40:00,715,687,704,2106,12636
2016-05-10 15:50:00,671,657,674,2002,12012
2016-05-10 16:00:00,636,609,627,1872,11232
2016-05-10 16:10:00,601,570,594,1765,10590
2016-05-10 16:20:00,571,536,565,1672,10032
2016-05-10 16:30:00,523,504,516,1543,9258
2016-05-10 16:40:00,491,470,484,1445,8670
2016-05-10 16:50:00,460,444,457,1361,8166
2016-05-10 17:00:00,415,403,416,1234,7404
2016-05-10 17:10:00,373,357,377,1107,6642
2016-05-10 17:20:00,351,332,347,1030,6180
2016-05-10 17:30:00,319,296,318,933,5598
2016-05-10 17:40:00,280,257,277,814,4884
2016-05-10 17:50:00,233,208,228,669,4014
2016-05-10 18:00:00,188,160,182,530,3180
2016-05-10 18:10:00,148,119,138,405,2430
2016-05-10 18:20:00,131,104,123,358,2148
2016-05-10 18:30:00,107,84,102,293,1758
2016-05-10 18:40:00,60,78,78,216,1296
2016-05-10 18:50:00,47,58,64,169,1014
2016-05-10 19:00:00,60,43,56,159,954
2016-05-10 19:10:00,49,38,56,143,858
2016-05-10 19:20:00,33,34,62,129,774
2016-05-10 19:30:00,32,33,49,114,684
2016-05-10 19:40:00,27,26,46,99,594
2016-05-10 19:50:00,30,18,37,85,510
2016-05-10 20:00:00,17,20,33,70,420
2016-05-10 20:10:00,16,16,22,54,324
2016-05-10 20:20:00,5,23,10,38,228
2016-05-10 20:30:00,7,8,7,22,132
2016-05-10 20:40:00,3,2,4,9,54
2016-05-10 20:50:00,0,0,0,0,0
2016-05-10 21:00:00,0,0,0,0,0
2016-05-10 21:10:00,0,0,0,0,0
2016-05-10 21:20:00,0,0,0,0,0
2016-05-11 04:40:00,0,0,0,0,0
2016-05-11 04:50:00,0,0,0,0,0
2016-05-11 05:00:00,0,0,0,0,0
2016-05-11 05:10:00,0,0,0,0,0
2016-05-11 05:20:00,0,0,0,0,0
2016-05-11 05:30:00,4,2,5,11,66
2016-05-11 05:40:00,9,5,15,29,174
2016-05-11 05:50:00,18,5,21,44,264
2016-05-11 06:00:00,22,10,26,58,348
2016-05-11 06:10:00,24,8,40,72,432
2016-05-11 06:20:00,22,21,42,85,510
2016-05-11 06:30:00,34,17,49,100,600
2016-05-11 06:40:00,33,28,52,113,678
2016-05-11 06:50:00,23,28,77,128,768
2016-05-11 07:00:00,37,50,56,143,858
2016-05-11 07:10:00,34,59,62,155,930
2016-05-11 07:20:00,44,39,59,142,852
2016-05-11 07:30:00,60,72,86,218,1308
2016-05-11 07:40:00,108,145,148,401,2406
2016-05-11 07:50:00,177,172,181,530,3180
2016-05-11 08:00:00,223,190,257,670,4020
2016-05-11 08:10:00,283,262,282,827,4962
2016-05-11 08:20:00,332,314,331,977,5862
2016-05-11 08:30:00,392,367,382,1141,6846
2016-05-11 08:40:00,440,413,429,1282,7692
2016-05-11 08:50:00,494,471,490,1455,8730
2016-05-11 09:00:00,557,527,550,1634,9804
2016-05-11 09:10:00,619,586,608,1813,10878
2016-05-11 09:20:00,669,641,654,1964,11784
2016-05-11 09:30:00,713,690,706,2109,12654
2016-05-11 09:40:00,752,739,748,2239,13434
2016-05-11 09:50:00,805,785,793,2383,14298
2016-05-11 10:00:00,830,811,823,2464,14784
2016-05-11 10:10:00,862,830,851,2543,15258
2016-05-11 10:20:00,891,856,875,2622,15732
2016-05-11 10:30:00,912,884,895,2691,16146
2016-05-11 10:40:00,935,912,914,2761,16566
2016-05-11 10:50:00,954,926,938,2818,16908
2016-05-11 11:00:00,974,946,961,2881,17286
2016-05-11 11:10:00,988,959,979,2926,17556
2016-05-11 11:20:00,1003,974,991,2968,17808
2016-05-11 11:30:00,1019,991,1010,3020,18120
2016-05-11 11:40:00,1036,1008,1027,3071,18426
2016-05-11 11:50:00,1049,1019,1036,3104,18624
2016-05-11 12:00:00,1058,1028,1043,3129,18774
2016-05-11 12:10:00,1061,1028,1046,3135,18810
2016-05-11 12:20:00,1069,1027,1048,3144,18864
2016-05-11 12:30:00,1071,1031,1050,3152,18912
2016-05-11 12:40:00,1062,1026,1044,3132,18792
2016-05-11 12:50:00,1043,1012,1026,3081,18486
2016-05-11 13:00:00,1062,1028,1046,3136,18816
2016-05-11 13:10:00,1051,1032,1048,3131,18786
2016-05-11 13:20:00,1039,1018,1034,3091,18546
2016-05-11 13:30:00,1037,1010,1030,3077,18462
2016-05-11 13:40:00,1040,1012,1026,3078,18468
2016-05-11 13:50:00,1028,998,1012,3038,18228
2016-05-11 14:00:00,1023,995,1014,3032,18192
2016-05-11 14:10:00,1024,992,1011,3027,18162
2016-05-11 14:20:00,992,965,980,2937,17622
2016-05-11 14:30:00,954,928,942,2824,16944
2016-05-11 14:40:00,935,912,921,2768,16608
2016-05-11 14:50:00,902,880,893,2675,16050
2016-05-11 15:00:00,867,843,858,2568,15408
2016-05-11 15:10:00,839,825,839,2503,15018
2016-05-11 15:20:00,816,788,803,2407,14442
2016-05-11 15:30:00,778,749,768,2295,13770
2016-05-11 15:40:00,750,717,743,2210,13260
2016-05-11 15:50:00,713,684,706,2103,12618
2016-05-11 16:00:00,653,623,649,1925,11550
2016-05-11 16:10:00,623,592,615,1830,10980
2016-05-11 16:20:00,597,558,584,1739,10434
2016-05-11 16:30:00,547,512,532,1591,9546
2016-05-11 16:40:00,518,491,508,1517,9102
2016-05-11 16:50:00,488,459,478,1425,8550
2016-05-11 17:00:00,449,414,434,1297,7782
2016-05-11 17:10:00,407,372,396,1175,7050
2016-05-11 17:20:00,375,343,367,1085,6510
2016-05-11 17:30:00,348,314,337,999,5994
2016-05-11 17:40:00,302,275,296,873,5238
2016-05-11 17:50:00,237,220,264,721,4326
2016-05-11 18:00:00,200,178,195,573,3438
2016-05-11 18:10:00,157,133,150,440,2640
2016-05-11 18:20:00,102,122,149,373,2238
2016-05-11 18:30:00,93,81,132,306,1836
2016-05-11 18:40:00,65,68,87,220,1320
2016-05-11 18:50:00,51,38,67,156,936
2016-05-11 19:00:00,44,34,68,146,876
2016-05-11 19:10:00,40,36,57,133,798
2016-05-11 19:20:00,43,25,53,121,726
2016-05-11 19:30:00,38,14,57,109,654
2016-05-11 19:40:00,38,10,49,97,582
2016-05-11 19:50:00,23,12,47,82,492
2016-05-11 20:00:00,24,8,36,68,408
2016-05-11 20:10:00,20,7,27,54,324
2016-05-11 20:20:00,13,13,14,40,240
2016-05-11 20:30:00,9,8,9,26,156
2016-05-11 20:40:00,4,3,6,13,78
2016-05-11 20:50:00,0,0,1,1,6
2016-05-11 21:00:00,0,0,0,0,0
2016-05-11 21:10:00,0,0,0,0,0
2016-05-11 21:20:00,0,0,0,0,0
2016-05-11 21:30:00,0,0,0,0,0
2016-05-12 04:40:00,0,0,0,0,0
2016-05-12 04:50:00,0,0,0,0,0
2016-05-12 05:00:00,0,0,0,0,0
2016-05-12 05:10:00,0,0,0,0,0
2016-05-12 05:20:00,3,2,4,9,54
2016-05-12 05:30:00,6,3,10,19,114
2016-05-12 05:40:00,12,4,15,31,186
2016-05-12 05:50:00,17,9,17,43,258
2016-05-12 06:00:00,23,5,27,55,330
2016-05-12 06:10:00,22,10,33,65,390
2016-05-12 06:20:00,25,11,45,81,486
2016-05-12 06:30:00,15,19,86,120,720
2016-05-12 06:40:00,25,28,74,127,762
2016-05-12 06:50:00,39,35,65,139,834
2016-05-12 07:00:00,36,35,70,141,846
2016-05-12 07:10:00,49,35,68,152,912
2016-05-12 07:20:00,38,35,70,143,858
2016-05-12 07:30:00,68,88,108,264,1584
2016-05-12 07:40:00,102,82,238,422,2532
2016-05-12 07:50:00,201,118,240,559,3354
2016-05-12 08:00:00,225,129,351,705,4230
2016-05-12 08:10:00,295,273,289,857,5142
2016-05-12 08:20:00,350,325,343,1018,6108
2016-05-12 08:30:00,403,386,403,1192,7152
2016-05-12 08:40:00,460,434,455,1349,8094
2016-05-12 08:50:00,519,494,510,1523,9138
2016-05-12 09:00:00,573,558,577,1708,10248
2016-05-12 09:10:00,641,615,632,1888,11328
2016-05-12 09:20:00,685,668,684,2037,12222
2016-05-12 09:30:00,733,717,726,2176,13056
2016-05-12 09:40:00,775,758,771,2304,13824
2016-05-12 09:50:00,829,804,820,2453,14718
2016-05-12 10:00:00,863,833,858,2554,15324
2016-05-12 10:10:00,894,867,889,2650,15900
2016-05-12 10:20:00,920,898,913,2731,16386
2016-05-12 10:30:00,942,923,931,2796,16776
2016-05-12 10:40:00,966,947,965,2878,17268
2016-05-12 10:50:00,981,957,976,2914,17484
2016-05-12 11:00:00,1012,986,999,2997,17982
2016-05-12 11:10:00,1021,1001,1015,3037,18222
2016-05-12 11:20:00,1036,1006,1026,3068,18408
2016-05-12 11:30:00,1049,1018,1042,3109,18654
2016-05-12 11:40:00,1057,1030,1054,3141,18846
2016-05-12 11:50:00,1060,1046,1070,3176,19056
2016-05-12 12:00:00,1067,1066,1083,3216,19296
2016-05-12 12:10:00,1081,1066,1084,3231,19386
2016-05-12 12:20:00,1086,1060,1079,3225,19350
2016-05-12 12:30:00,1096,1062,1088,3246,19476
2016-05-12 12:40:00,1100,1058,1085,3243,19458
2016-05-12 12:50:00,1105,1064,1090,3259,19554
2016-05-12 13:00:00,1108,1057,1094,3259,19554
2016-05-12 13:10:00,1104,1053,1093,3250,19500
2016-05-12 13:20:00,1103,1049,1086,3238,19428
2016-05-12 13:30:00,1081,1047,1076,3204,19224
2016-05-12 13:40:00,1075,1041,1075,3191,19146
2016-05-12 13:50:00,1063,1037,1069,3169,19014
2016-05-12 14:00:00,1060,1022,1059,3141,18846
2016-05-12 14:10:00,1044,1006,1048,3098,18588
2016-05-12 14:20:00,1014,973,1015,3002,18012
2016-05-12 14:30:00,983,958,993,2934,17604
2016-05-12 14:40:00,964,943,975,2882,17292
2016-05-12 14:50:00,927,901,930,2758,16548
2016-05-12 15:00:00,895,862,892,2649,15894
2016-05-12 15:10:00,872,835,866,2573,15438
2016-05-12 15:20:00,831,796,825,2452,14712
2016-05-12 15:30:00,792,756,789,2337,14022
2016-05-12 15:40:00,767,729,758,2254,13524
2016-05-12 15:50:00,731,700,725,2156,12936
2016-05-12 16:00:00,677,648,672,1997,11982
2016-05-12 16:10:00,645,614,642,1901,11406
2016-05-12 16:20:00,609,576,602,1787,10722
2016-05-12 16:30:00,566,533,560,1659,9954
2016-05-12 16:40:00,537,506,533,1576,9456
2016-05-12 16:50:00,503,473,497,1473,8838
2016-05-12 17:00:00,454,430,446,1330,7980
2016-05-12 17:10:00,409,382,404,1195,7170
2016-05-12 17:20:00,384,365,384,1133,6798
2016-05-12 17:30:00,351,332,350,1033,6198
2016-05-12 17:40:00,297,284,305,886,5316
2016-05-12 17:50:00,252,234,251,737,4422
2016-05-12 18:00:00,203,181,197,581,3486
2016-05-12 18:10:00,159,138,154,451,2706
2016-05-12 18:20:00,120,132,142,394,2364
2016-05-12 18:30:00,50,129,138,317,1902
2016-05-12 18:40:00,54,79,96,229,1374
2016-05-12 18:50:00,23,42,81,146,876
2016-05-12 19:00:00,33,10,62,105,630
2016-05-12 19:10:00,17,13,93,123,738
2016-05-12 19:20:00,31,30,49,110,660
2016-05-12 19:30:00,32,35,32,99,594
2016-05-12 19:40:00,35,13,43,91,546
2016-05-12 19:50:00,31,8,42,81,486
2016-05-12 20:00:00,28,9,34,71,426
2016-05-12 20:10:00,22,9,28,59,354
2016-05-12 20:20:00,12,11,20,43,258
2016-05-12 20:30:00,5,6,9,20,120
2016-05-12 20:40:00,2,1,2,5,30
2016-05-12 20:50:00,0,0,0,0,0
2016-05-12 21:00:00,0,0,0,0,0
2016-05-12 21:10:00,0,0,0,0,0
2016-05-12 21:20:00,0,0,0,0,0
2016-05-12 21:30:00,0,0,0,0,0
2016-05-13 04:30:00,0,0,0,0,0
2016-05-13 04:40:00,0,0,0,0,0
2016-05-13 04:50:00,0,0,0,0,0
2016-05-13 05:00:00,0,0,0,0,0
2016-05-13 05:10:00,0,0,0,0,0
2016-05-13 05:20:00,3,0,4,7,42
2016-05-13 05:30:00,6,2,8,16,96
2016-05-13 05:40:00,11,5,12,28,168
2016-05-13 05:50:00,20,5,18,43,258
2016-05-13 06:00:00,24,7,28,59,354
2016-05-13 06:10:00,25,11,39,75,450
2016-05-13 06:20:00,28,14,47,89,534
2016-05-13 06:30:00,38,15,51,104,624
2016-05-13 06:40:00,35,17,66,118,708
2016-05-13 06:50:00,45,25,62,132,792
2016-05-13 07:00:00,42,41,64,147,882
2016-05-13 07:10:00,44,62,59,165,990
2016-05-13 07:20:00,25,57,82,164,984
2016-05-13 07:30:00,69,106,121,296,1776
2016-05-13 07:40:00,87,180,171,438,2628
2016-05-13 07:50:00,171,167,230,568,3408
2016-05-13 08:00:00,246,222,240,708,4248
2016-05-13 08:10:00,298,274,292,864,5184
2016-05-13 08:20:00,352,327,344,1023,6138
2016-05-13 08:30:00,406,384,399,1189,7134
2016-05-13 08:40:00,457,435,449,1341,8046
2016-05-13 08:50:00,501,482,496,1479,8874
2016-05-13 09:00:00,475,457,468,1400,8400
2016-05-13 09:10:00,608,584,599,1791,10746
2016-05-13 09:20:00,688,656,675,2019,12114
2016-05-13 09:30:00,628,597,611,1836,11016
2016-05-13 09:40:00,707,672,687,2066,12396
2016-05-13 09:50:00,793,754,783,2330,13980
2016-05-13 10:00:00,819,790,813,2422,14532
2016-05-13 10:10:00,846,821,841,2508,15048
2016-05-13 10:20:00,898,875,895,2668,16008
2016-05-13 10:30:00,978,956,967,2901,17406
2016-05-13 10:40:00,811,790,799,2400,14400
2016-05-13 10:50:00,375,354,366,1095,6570
2016-05-13 11:00:00,600,569,590,1759,10554
2016-05-13 11:10:00,876,829,854,2559,15354
2016-05-13 11:20:00,778,748,763,2289,13734
2016-05-13 11:30:00,834,799,819,2452,14712
2016-05-13 11:40:00,846,823,830,2499,14994
2016-05-13 11:50:00,932,914,919,2765,16590
2016-05-13 12:00:00,1020,1000,1008,3028,18168
2016-05-13 12:10:00,1005,989,996,2990,17940
2016-05-13 12:20:00,1048,1020,1037,3105,18630
2016-05-13 12:30:00,928,907,926,2761,16566
2016-05-13 12:40:00,1041,1024,1042,3107,18642
2016-05-13 12:50:00,1021,1003,1018,3042,18252
2016-05-13 13:00:00,1022,1008,1025,3055,18330
2016-05-13 13:10:00,1037,1015,1011,3063,18378
2016-05-13 13:20:00,1014,1000,997,3011,18066
2016-05-13 13:30:00,1029,1009,1009,3047,18282
2016-05-13 13:40:00,922,903,914,2739,16434
2016-05-13 13:50:00,960,924,955,2839,17034
2016-05-13 14:00:00,993,963,995,2951,17706
2016-05-13 14:10:00,916,900,915,2731,16386
2016-05-13 14:20:00,922,903,926,2751,16506
2016-05-13 14:30:00,886,857,881,2624,15744
2016-05-13 14:40:00,665,646,661,1972,11832
2016-05-13 14:50:00,763,745,761,2269,13614
2016-05-13 15:00:00,822,801,819,2442,14652
2016-05-13 15:10:00,860,839,855,2554,15324
2016-05-13 15:20:00,775,749,765,2289,13734
2016-05-13 15:30:00,771,744,760,2275,13650
2016-05-13 15:40:00,742,716,733,2191,13146
2016-05-13 15:50:00,697,671,689,2057,12342
2016-05-13 16:00:00,650,634,649,1933,11598
2016-05-13 16:10:00,602,583,601,1786,10716
2016-05-13 16:20:00,518,493,513,1524,9144
2016-05-13 16:30:00,472,448,464,1384,8304
2016-05-13 16:40:00,573,546,565,1684,10104
2016-05-13 16:50:00,526,499,519,1544,9264
2016-05-13 17:00:00,453,426,449,1328,7968
2016-05-13 17:10:00,387,363,380,1130,6780
2016-05-13 17:20:00,347,323,340,1010,6060
2016-05-13 17:30:00,349,325,339,1013,6078
2016-05-13 17:40:00,303,280,293,876,5256
2016-05-13 17:50:00,225,202,218,645,3870
2016-05-13 18:00:00,192,169,185,546,3276
2016-05-13 18:10:00,163,142,158,463,2778
2016-05-13 18:20:00,112,129,153,394,2364
2016-05-13 18:30:00,74,119,131,324,1944
2016-05-13 18:40:00,47,84,92,223,1338
2016-05-13 18:50:00,26,40,78,144,864
2016-05-13 19:00:00,52,38,57,147,882
2016-05-13 19:10:00,59,40,61,160,960
2016-05-13 19:20:00,51,53,49,153,918
2016-05-13 19:30:00,28,40,71,139,834
2016-05-13 19:40:00,45,20,51,116,696
2016-05-13 19:50:00,20,47,34,101,606
2016-05-13 20:00:00,18,15,86,119,714
2016-05-13 20:10:00,30,33,68,131,786
2016-05-13 20:20:00,23,22,51,96,576
2016-05-13 20:30:00,17,19,33,69,414
2016-05-13 20:40:00,12,10,18,40,240
2016-05-13 20:50:00,5,5,7,17,102
2016-05-13 21:00:00,0,0,1,1,6
2016-05-13 21:10:00,0,0,0,0,0
2016-05-13 21:20:00,0,0,0,0,0
2016-05-13 21:30:00,0,0,0,0,0
2016-05-14 04:40:00,0,0,0,0,0
2016-05-14 04:50:00,0,0,0,0,0
2016-05-14 05:00:00,0,0,0,0,0
2016-05-14 05:10:00,0,0,0,0,0
2016-05-14 05:20:00,3,0,4,7,42
2016-05-14 05:30:00,10,4,16,30,180
2016-05-14 05:40:00,15,11,33,59,354
2016-05-14 05:50:00,21,14,36,71,426
2016-05-14 06:00:00,25,28,48,101,606
2016-05-14 06:10:00,28,32,66,126,756
2016-05-14 06:20:00,21,29,58,108,648
2016-05-14 06:30:00,20,26,64,110,660
2016-05-14 06:40:00,17,26,82,125,750
2016-05-14 06:50:00,26,66,89,181,1086
2016-05-14 07:00:00,20,95,109,224,1344
2016-05-14 07:10:00,42,62,95,199,1194
2016-05-14 07:20:00,54,67,81,202,1212
2016-05-14 07:30:00,74,121,157,352,2112
2016-05-14 07:40:00,67,182,170,419,2514
2016-05-14 07:50:00,103,147,185,435,2610
2016-05-14 08:00:00,229,203,228,660,3960
2016-05-14 08:10:00,289,260,285,834,5004
2016-05-14 08:20:00,344,313,335,992,5952
2016-05-14 08:30:00,413,386,409,1208,7248
2016-05-14 08:40:00,465,437,463,1365,8190
2016-05-14 08:50:00,536,506,536,1578,9468
2016-05-14 09:00:00,593,563,586,1742,10452
2016-05-14 09:10:00,648,615,641,1904,11424
2016-05-14 09:20:00,637,608,632,1877,11262
2016-05-14 09:30:00,723,689,712,2124,12744
2016-05-14 09:40:00,775,748,768,2291,13746
2016-05-14 09:50:00,782,756,773,2311,13866
2016-05-14 10:00:00,839,815,836,2490,14940
2016-05-14 10:10:00,810,778,799,2387,14322
2016-05-14 10:20:00,864,829,858,2551,15306
2016-05-14 10:30:00,925,885,917,2727,16362
2016-05-14 10:40:00,876,841,869,2586,15516
2016-05-14 10:50:00,919,880,912,2711,16266
2016-05-14 11:00:00,921,881,910,2712,16272
2016-05-14 11:10:00,956,919,955,2830,16980
2016-05-14 11:20:00,948,906,938,2792,16752
2016-05-14 11:30:00,924,887,920,2731,16386
2016-05-14 11:40:00,1061,1021,1051,3133,18798
2016-05-14 11:50:00,927,890,921,2738,16428
2016-05-14 12:00:00,191,165,184,540,3240
2016-05-14 12:10:00,581,553,572,1706,10236
2016-05-14 12:20:00,1207,1176,1196,3579,21474
2016-05-14 12:30:00,1147,1111,1138,3396,20376
2016-05-14 12:40:00,1134,1106,1132,3372,20232
2016-05-14 12:50:00,1097,1076,1098,3271,19626
2016-05-14 13:00:00,1047,1016,1051,3114,18684
2016-05-14 13:10:00,653,620,645,1918,11508
2016-05-14 13:20:00,1063,1033,1060,3156,18936
2016-05-14 13:30:00,1113,1098,1109,3320,19920
2016-05-14 13:40:00,1103,1086,1100,3289,19734
2016-05-14 13:50:00,1086,1065,1072,3223,19338
2016-05-14 14:00:00,1074,1046,1059,3179,19074
2016-05-14 14:10:00,1072,1051,1064,3187,19122
2016-05-14 14:20:00,1033,1004,1017,3054,18324
2016-05-14 14:30:00,1021,991,1007,3019,18114
2016-05-14 14:40:00,956,924,954,2834,17004
2016-05-14 14:50:00,947,914,944,2805,16830
2016-05-14 15:00:00,933,909,936,2778,16668
2016-05-14 15:10:00,861,848,853,2562,15372
2016-05-14 15:20:00,828,808,811,2447,14682
2016-05-14 15:30:00,801,773,791,2365,14190
2016-05-14 15:40:00,745,722,741,2208,13248
2016-05-14 15:50:00,741,718,737,2196,13176
2016-05-14 16:00:00,569,548,559,1676,10056
2016-05-14 16:10:00,641,616,636,1893,11358
2016-05-14 16:20:00,561,532,554,1647,9882
2016-05-14 16:30:00,385,358,378,1121,6726
2016-05-14 16:40:00,505,484,501,1490,8940
2016-05-14 16:50:00,508,489,502,1499,8994
2016-05-14 17:00:00,272,250,264,786,4716
2016-05-14 17:10:00,406,386,404,1196,7176
2016-05-14 17:20:00,361,338,362,1061,6366
2016-05-14 17:30:00,320,293,316,929,5574
2016-05-14 17:40:00,308,283,301,892,5352
2016-05-14 17:50:00,256,235,254,745,4470
2016-05-14 18:00:00,191,171,191,553,3318
2016-05-14 18:10:00,92,107,104,303,1818
2016-05-14 18:20:00,100,98,153,351,2106
2016-05-14 18:30:00,53,59,81,193,1158
2016-05-14 18:40:00,66,70,91,227,1362
2016-05-14 18:50:00,54,61,76,191,1146
2016-05-14 19:00:00,31,50,75,156,936
2016-05-14 19:10:00,22,49,76,147,882
2016-05-14 19:20:00,25,44,73,142,852
2016-05-14 19:30:00,29,23,66,118,708
2016-05-14 19:40:00,31,19,53,103,618
2016-05-14 19:50:00,25,23,43,91,546
2016-05-14 20:00:00,21,16,46,83,498
2016-05-14 20:10:00,17,11,41,69,414
2016-05-14 20:20:00,21,3,27,51,306
2016-05-14 20:30:00,11,3,14,28,168
2016-05-14 20:40:00,6,3,7,16,96
2016-05-14 20:50:00,1,2,2,5,30
2016-05-14 21:00:00,0,0,0,0,0
2016-05-14 21:10:00,0,0,0,0,0
2016-05-14 21:20:00,0,0,0,0,0
2016-05-14 21:30:00,0,0,0,0,0
2016-05-15 04:30:00,0,0,0,0,0
2016-05-15 04:40:00,0,0,0,0,0
2016-05-15 04:50:00,0,0,0,0,0
2016-05-15 05:00:00,0,0,0,0,0
2016-05-15 05:10:00,0,0,0,0,0
2016-05-15 05:20:00,6,2,6,14,84
2016-05-15 05:30:00,12,5,16,33,198
2016-05-15 05:40:00,16,10,33,59,354
2016-05-15 05:50:00,19,20,46,85,510
2016-05-15 06:00:00,21,24,47,92,552
2016-05-15 06:10:00,22,27,50,99,594
2016-05-15 06:20:00,16,33,54,103,618
2016-05-15 06:30:00,20,36,60,116,696
2016-05-15 06:40:00,21,81,94,196,1176
2016-05-15 06:50:00,26,51,74,151,906
2016-05-15 07:00:00,21,54,83,158,948
2016-05-15 07:10:00,31,76,97,204,1224
2016-05-15 07:20:00,4,128,131,263,1578
2016-05-15 07:30:00,0,143,145,288,1728
2016-05-15 07:40:00,114,164,178,456,2736
2016-05-15 07:50:00,241,214,235,690,4140
2016-05-15 08:00:00,263,237,258,758,4548
2016-05-15 08:10:00,313,289,312,914,5484
2016-05-15 08:20:00,180,205,222,607,3642
2016-05-15 08:30:00,230,196,248,674,4044
2016-05-15 08:40:00,295,268,291,854,5124
2016-05-15 08:50:00,253,228,245,726,4356
2016-05-15 09:00:00,37,53,80,170,1020
2016-05-15 09:10:00,161,152,124,437,2622
2016-05-15 09:20:00,271,206,225,702,4212
2016-05-15 09:30:00,212,184,205,601,3606
2016-05-15 09:40:00,330,300,324,954,5724
2016-05-15 09:50:00,651,614,647,1912,11472
2016-05-15 10:00:00,800,748,789,2337,14022
2016-05-15 10:10:00,897,856,893,2646,15876
2016-05-15 10:20:00,926,886,924,2736,16416
2016-05-15 10:30:00,952,914,950,2816,16896
2016-05-15 10:40:00,968,941,972,2881,17286
2016-05-15 10:50:00,991,964,999,2954,17724
2016-05-15 11:00:00,1029,1002,1039,3070,18420
2016-05-15 11:10:00,420,398,424,1242,7452
2016-05-15 11:20:00,182,157,178,517,3102
2016-05-15 11:30:00,29,61,81,171,1026
2016-05-15 11:40:00,22,40,70,132,792
2016-05-15 11:50:00,184,168,249,601,3606
2016-05-15 12:00:00,452,421,448,1321,7926
2016-05-15 12:10:00,316,283,310,909,5454
2016-05-15 12:20:00,291,259,285,835,5010
2016-05-15 12:30:00,1159,1115,1159,3433,20598
2016-05-15 12:40:00,1028,987,1027,3042,18252
2016-05-15 12:50:00,1146,1096,1136,3378,20268
2016-05-15 13:00:00,1141,1111,1149,3401,20406
2016-05-15 13:10:00,1134,1103,1137,3374,20244
2016-05-15 13:20:00,990,960,984,2934,17604
2016-05-15 13:30:00,131,109,125,365,2190
2016-05-15 13:40:00,229,221,243,693,4158
2016-05-15 13:50:00,880,852,877,2609,15654
2016-05-15 14:00:00,801,769,800,2370,14220
2016-05-15 14:10:00,801,767,797,2365,14190
2016-05-15 14:20:00,685,657,684,2026,12156
2016-05-15 14:30:00,701,673,701,2075,12450
2016-05-15 14:40:00,347,321,346,1014,6084
2016-05-15 14:50:00,711,674,709,2094,12564
2016-05-15 15:00:00,969,939,984,2892,17352
2016-05-15 15:10:00,843,826,852,2521,15126
2016-05-15 15:20:00,680,655,681,2016,12096
2016-05-15 15:30:00,538,512,541,1591,9546
2016-05-15 15:40:00,600,579,607,1786,10716
2016-05-15 15:50:00,169,170,176,515,3090
2016-05-15 16:00:00,37,41,78,156,936
2016-05-15 16:10:00,27,27,73,127,762
2016-05-15 16:20:00,20,45,78,143,858
2016-05-15 16:30:00,43,88,119,250,1500
2016-05-15 16:40:00,299,266,364,929,5574
2016-05-15 16:50:00,206,198,229,633,3798
2016-05-15 17:00:00,104,196,220,520,3120
2016-05-15 17:10:00,68,78,122,268,1608
2016-05-15 17:20:00,19,28,58,105,630
2016-05-15 17:30:00,22,32,66,120,720
2016-05-15 17:40:00,14,38,63,115,690
2016-05-15 17:50:00,13,15,34,62,372
2016-05-15 18:00:00,10,9,22,41,246
2016-05-15 18:10:00,65,103,101,269,1614
2016-05-15 18:20:00,152,127,87,366,2196
2016-05-15 18:30:00,18,88,97,203,1218
2016-05-15 18:40:00,25,92,90,207,1242
2016-05-15 18:50:00,70,88,59,217,1302
2016-05-15 19:00:00,19,26,46,91,546
2016-05-15 19:10:00,4,5,8,17,102
2016-05-15 19:20:00,11,20,37,68,408
2016-05-15 19:30:00,11,14,34,59,354
2016-05-15 19:40:00,8,5,19,32,192
2016-05-15 19:50:00,7,14,30,51,306
2016-05-15 20:00:00,12,18,39,69,414
2016-05-15 20:10:00,8,7,17,32,192
2016-05-15 20:20:00,6,5,15,26,156
2016-05-15 20:30:00,6,4,6,16,96
2016-05-15 20:40:00,2,2,3,7,42
2016-05-15 20:50:00,0,0,0,0,0
2016-05-15 21:00:00,0,0,0,0,0
2016-05-15 21:10:00,0,0,0,0,0
2016-05-15 21:20:00,0,0,0,0,0
2016-05-15 21:30:00,0,0,0,0,0
2016-05-16 04:30:00,0,0,0,0,0
2016-05-16 04:40:00,0,0,0,0,0
2016-05-16 04:50:00,0,0,0,0,0
2016-05-16 05:00:00,0,0,0,0,0
2016-05-16 05:10:00,0,0,0,0,0
2016-05-16 05:20:00,0,0,1,1,6
2016-05-16 05:30:00,6,1,7,14,84
2016-05-16 05:40:00,14,4,18,36,216
2016-05-16 05:50:00,19,8,31,58,348
2016-05-16 06:00:00,19,13,43,75,450
2016-05-16 06:10:00,20,18,46,84,504
2016-05-16 06:20:00,24,19,48,91,546
2016-05-16 06:30:00,26,23,49,98,588
2016-05-16 06:40:00,29,38,70,137,822
2016-05-16 06:50:00,38,75,99,212,1272
2016-05-16 07:00:00,40,66,91,197,1182
2016-05-16 07:10:00,45,49,82,176,1056
2016-05-16 07:20:00,55,89,87,231,1386
2016-05-16 07:30:00,34,86,93,213,1278
2016-05-16 07:40:00,139,123,190,452,2712
2016-05-16 07:50:00,208,195,224,627,3762
2016-05-16 08:00:00,273,246,268,787,4722
2016-05-16 08:10:00,323,298,320,941,5646
2016-05-16 08:20:00,381,357,380,1118,6708
2016-05-16 08:30:00,440,411,435,1286,7716
2016-05-16 08:40:00,498,467,490,1455,8730
2016-05-16 08:50:00,556,527,550,1633,9798
2016-05-16 09:00:00,602,573,602,1777,10662
2016-05-16 09:10:00,605,579,600,1784,10704
2016-05-16 09:20:00,730,702,725,2157,12942
2016-05-16 09:30:00,766,744,762,2272,13632
2016-05-16 09:40:00,801,775,804,2380,14280
2016-05-16 09:50:00,849,822,852,2523,15138
2016-05-16 10:00:00,875,856,887,2618,15708
2016-05-16 10:10:00,916,876,915,2707,16242
2016-05-16 10:20:00,951,899,940,2790,16740
2016-05-16 10:30:00,973,931,963,2867,17202
2016-05-16 10:40:00,1001,954,981,2936,17616
2016-05-16 10:50:00,1015,973,1002,2990,17940
2016-05-16 11:00:00,1037,990,1031,3058,18348
2016-05-16 11:10:00,1048,1006,1043,3097,18582
2016-05-16 11:20:00,1040,1001,1038,3079,18474
2016-05-16 11:30:00,1047,1008,1052,3107,18642
2016-05-16 11:40:00,1081,1041,1076,3198,19188
2016-05-16 11:50:00,1091,1094,1121,3306,19836
2016-05-16 12:00:00,974,964,986,2924,17544
2016-05-16 12:10:00,865,845,868,2578,15468
2016-05-16 12:20:00,968,945,969,2882,17292
2016-05-16 12:30:00,1041,1012,1030,3083,18498
2016-05-16 12:40:00,882,851,873,2606,15636
2016-05-16 12:50:00,935,902,926,2763,16578
2016-05-16 13:00:00,551,528,550,1629,9774
2016-05-16 13:10:00,959,928,951,2838,17028
2016-05-16 13:20:00,1189,1161,1183,3533,21198
2016-05-16 13:30:00,1042,991,1023,3056,18336
2016-05-16 13:40:00,915,870,903,2688,16128
2016-05-16 13:50:00,916,863,898,2677,16062
2016-05-16 14:00:00,668,651,684,2003,12018
2016-05-16 14:10:00,970,941,964,2875,17250
2016-05-16 14:20:00,926,892,915,2733,16398
2016-05-16 14:30:00,1030,1000,1026,3056,18336
2016-05-16 14:40:00,701,664,692,2057,12342
2016-05-16 14:50:00,378,354,372,1104,6624
2016-05-16 15:00:00,697,663,682,2042,12252
2016-05-16 15:10:00,287,262,279,828,4968
2016-05-16 15:20:00,263,218,234,715,4290
2016-05-16 15:30:00,523,502,513,1538,9228
2016-05-16 15:40:00,378,355,373,1106,6636
2016-05-16 15:50:00,375,354,373,1102,6612
2016-05-16 16:00:00,165,140,159,464,2784
2016-05-16 16:10:00,158,134,146,438,2628
2016-05-16 16:20:00,38,51,73,162,972
2016-05-16 16:30:00,206,185,249,640,3840
2016-05-16 16:40:00,475,448,473,1396,8376
2016-05-16 16:50:00,192,170,187,549,3294
2016-05-16 17:00:00,151,130,150,431,2586
2016-05-16 17:10:00,86,87,81,254,1524
2016-05-16 17:20:00,289,266,290,845,5070
2016-05-16 17:30:00,405,376,399,1180,7080
2016-05-16 17:40:00,355,322,346,1023,6138
2016-05-16 17:50:00,293,264,283,840,5040
2016-05-16 18:00:00,223,200,219,642,3852
2016-05-16 18:10:00,172,152,167,491,2946
2016-05-16 18:20:00,157,135,151,443,2658
2016-05-16 18:30:00,124,103,119,346,2076
2016-05-16 18:40:00,99,95,74,268,1608
2016-05-16 18:50:00,42,59,62,163,978
2016-05-16 19:00:00,34,31,62,127,762
2016-05-16 19:10:00,23,16,86,125,750
2016-05-16 19:20:00,13,13,94,120,720
2016-05-16 19:30:00,6,3,113,122,732
2016-05-16 19:40:00,35,33,38,106,636
2016-05-16 19:50:00,27,28,28,83,498
2016-05-16 20:00:00,25,22,27,74,444
2016-05-16 20:10:00,20,15,31,66,396
2016-05-16 20:20:00,21,6,26,53,318
2016-05-16 20:30:00,15,7,20,42,252
2016-05-16 20:40:00,12,6,16,34,204
2016-05-16 20:50:00,6,1,7,14,84
2016-05-16 21:00:00,1,0,0,1,6
2016-05-16 21:10:00,0,0,0,0,0
2016-05-16 21:20:00,0,0,0,0,0
2016-05-16 21:30:00,0,0,0,0,0
2016-05-16 21:40:00,0,0,0,0,0
2016-05-17 04:20:00,0,0,0,0,0
2016-05-17 04:30:00,0,0,0,0,0
2016-05-17 04:40:00,0,0,0,0,0
2016-05-17 04:50:00,0,0,0,0,0
2016-05-17 05:00:00,0,0,0,0,0
2016-05-17 05:10:00,1,1,2,4,24
2016-05-17 05:20:00,6,4,12,22,132
2016-05-17 05:30:00,10,5,17,32,192
2016-05-17 05:40:00,11,8,18,37,222
2016-05-17 05:50:00,20,7,27,54,324
2016-05-17 06:00:00,36,22,56,114,684
2016-05-17 06:10:00,29,25,53,107,642
2016-05-17 06:20:00,48,36,77,161,966
2016-05-17 06:30:00,40,80,102,222,1332
2016-05-17 06:40:00,36,103,115,254,1524
2016-05-17 06:50:00,78,88,107,273,1638
2016-05-17 07:00:00,98,114,145,357,2142
2016-05-17 07:10:00,44,139,169,352,2112
2016-05-17 07:20:00,58,138,176,372,2232
2016-05-17 07:30:00,93,82,218,393,2358
2016-05-17 07:40:00,59,123,190,372,2232
2016-05-17 07:50:00,16,122,130,268,1608
2016-05-17 08:00:00,123,92,211,426,2556
2016-05-17 08:10:00,149,63,257,469,2814
2016-05-17 08:20:00,156,56,240,452,2712
2016-05-17 08:30:00,64,153,164,381,2286
2016-05-17 08:40:00,126,89,243,458,2748
2016-05-17 08:50:00,159,15,298,472,2832
2016-05-17 09:00:00,81,73,103,257,1542
2016-05-17 09:10:00,124,182,174,480,2880
2016-05-17 09:20:00,151,131,155,437,2622
2016-05-17 09:30:00,140,100,141,381,2286
2016-05-17 09:40:00,134,77,188,399,2394
2016-05-17 09:50:00,170,154,116,440,2640
2016-05-17 10:00:00,157,129,186,472,2832
2016-05-17 10:10:00,230,167,255,652,3912
2016-05-17 10:20:00,326,300,318,944,5664
2016-05-17 10:30:00,234,208,227,669,4014
2016-05-17 10:40:00,180,157,183,520,3120
2016-05-17 10:50:00,255,233,253,741,4446
2016-05-17 11:00:00,306,277,299,882,5292
2016-05-17 11:10:00,325,300,317,942,5652
2016-05-17 11:20:00,222,173,233,628,3768
2016-05-17 11:30:00,248,93,156,497,2982
2016-05-17 11:40:00,325,287,296,908,5448
2016-05-17 11:50:00,514,474,494,1482,8892
2016-05-17 12:00:00,621,579,601,1801,10806
2016-05-17 12:10:00,439,405,423,1267,7602
2016-05-17 12:20:00,416,379,398,1193,7158
2016-05-17 12:30:00,505,467,487,1459,8754
2016-05-17 12:40:00,391,358,378,1127,6762
2016-05-17 12:50:00,226,155,156,537,3222
2016-05-17 13:00:00,252,209,246,707,4242
2016-05-17 13:10:00,558,540,571,1669,10014
2016-05-17 13:20:00,622,600,625,1847,11082
2016-05-17 13:30:00,613,581,609,1803,10818
2016-05-17 13:40:00,485,453,477,1415,8490
2016-05-17 13:50:00,488,453,478,1419,8514
2016-05-17 14:00:00,472,442,470,1384,8304
2016-05-17 14:10:00,367,334,359,1060,6360
2016-05-17 14:20:00,386,350,371,1107,6642
2016-05-17 14:30:00,422,391,410,1223,7338
2016-05-17 14:40:00,407,376,395,1178,7068
2016-05-17 14:50:00,416,384,406,1206,7236
2016-05-17 15:00:00,339,309,329,977,5862
2016-05-17 15:10:00,238,211,230,679,4074
2016-05-17 15:20:00,283,256,278,817,4902
2016-05-17 15:30:00,330,303,324,957,5742
2016-05-17 15:40:00,397,367,388,1152,6912
2016-05-17 15:50:00,273,245,265,783,4698
2016-05-17 16:00:00,178,154,172,504,3024
2016-05-17 16:10:00,183,159,177,519,3114
2016-05-17 16:20:00,242,168,155,565,3390
2016-05-17 16:30:00,199,162,134,495,2970
2016-05-17 16:40:00,113,131,195,439,2634
2016-05-17 16:50:00,227,95,214,536,3216
2016-05-17 17:00:00,158,104,258,520,3120
2016-05-17 17:10:00,95,87,234,416,2496
2016-05-17 17:20:00,86,93,217,396,2376
2016-05-17 17:30:00,152,0,288,440,2640
2016-05-17 17:40:00,161,35,291,487,2922
2016-05-17 17:50:00,79,79,193,351,2106
2016-05-17 18:00:00,27,110,119,256,1536
2016-05-17 18:10:00,38,238,166,442,2652
2016-05-17 18:20:00,37,215,161,413,2478
2016-05-17 18:30:00,0,147,159,306,1836
2016-05-17 18:40:00,65,80,121,266,1596
2016-05-17 18:50:00,66,70,100,236,1416
2016-05-17 19:00:00,59,74,108,241,1446
2016-05-17 19:10:00,68,40,95,203,1218
2016-05-17 19:20:00,32,46,77,155,930
2016-05-17 19:30:00,52,15,62,129,774
2016-05-17 19:40:00,36,14,48,98,588
2016-05-17 19:50:00,28,13,42,83,498
2016-05-17 20:00:00,24,7,32,63,378
2016-05-17 20:10:00,19,2,21,42,252
2016-05-17 20:20:00,10,2,13,25,150
2016-05-17 20:30:00,3,0,4,7,42
2016-05-17 20:40:00,0,0,1,1,6
2016-05-17 20:50:00,0,0,0,0,0
2016-05-17 21:00:00,0,0,0,0,0
2016-05-17 21:10:00,0,0,0,0,0
2016-05-17 21:20:00,0,0,0,0,0
2016-05-18 04:30:00,0,0,0,0,0
2016-05-18 04:40:00,0,0,0,0,0
2016-05-18 04:50:00,0,0,0,0,0
2016-05-18 05:00:00,0,0,0,0,0
2016-05-18 05:10:00,0,0,1,1,6
2016-05-18 05:20:00,4,1,6,11,66
2016-05-18 05:30:00,7,3,12,22,132
2016-05-18 05:40:00,15,17,40,72,432
2016-05-18 05:50:00,25,22,69,116,696
2016-05-18 06:00:00,36,21,56,113,678
2016-05-18 06:10:00,25,17,82,124,744
2016-05-18 06:20:00,37,41,67,145,870
2016-05-18 06:30:00,54,45,83,182,1092
2016-05-18 06:40:00,29,83,111,223,1338
2016-05-18 06:50:00,0,125,130,255,1530
2016-05-18 07:00:00,10,136,144,290,1740
2016-05-18 07:10:00,51,128,150,329,1974
2016-05-18 07:20:00,48,155,184,387,2322
2016-05-18 07:30:00,130,180,161,471,2826
2016-05-18 07:40:00,191,125,233,549,3294
2016-05-18 07:50:00,208,177,235,620,3720
2016-05-18 08:00:00,150,125,146,421,2526
2016-05-18 08:10:00,338,311,331,980,5880
2016-05-18 08:20:00,396,366,390,1152,6912
2016-05-18 08:30:00,487,459,480,1426,8556
2016-05-18 08:40:00,315,288,311,914,5484
2016-05-18 08:50:00,289,263,281,833,4998
2016-05-18 09:00:00,321,294,316,931,5586
2016-05-18 09:10:00,333,303,325,961,5766
2016-05-18 09:20:00,331,303,322,956,5736
2016-05-18 09:30:00,419,389,409,1217,7302
2016-05-18 09:40:00,533,494,520,1547,9282
2016-05-18 09:50:00,669,632,659,1960,11760
2016-05-18 10:00:00,803,762,788,2353,14118
2016-05-18 10:10:00,844,806,830,2480,14880
2016-05-18 10:20:00,726,687,715,2128,12768
2016-05-18 10:30:00,992,955,991,2938,17628
2016-05-18 10:40:00,829,799,827,2455,14730
2016-05-18 10:50:00,1023,990,1016,3029,18174
2016-05-18 11:00:00,895,863,890,2648,15888
2016-05-18 11:10:00,906,866,895,2667,16002
2016-05-18 11:20:00,1003,955,989,2947,17682
2016-05-18 11:30:00,1086,1042,1075,3203,19218
2016-05-18 11:40:00,1087,1049,1088,3224,19344
2016-05-18 11:50:00,1093,1056,1089,3238,19428
2016-05-18 12:00:00,1101,1065,1101,3267,19602
2016-05-18 12:10:00,1113,1067,1101,3281,19686
2016-05-18 12:20:00,1123,1073,1109,3305,19830
2016-05-18 12:30:00,1118,1071,1108,3297,19782
2016-05-18 12:40:00,1123,1079,1115,3317,19902
2016-05-18 12:50:00,1121,1087,1128,3336,20016
2016-05-18 13:00:00,1125,1104,1123,3352,20112
2016-05-18 13:10:00,1134,1109,1130,3373,20238
2016-05-18 13:20:00,1135,1102,1134,3371,20226
2016-05-18 13:30:00,965,926,958,2849,17094
2016-05-18 13:40:00,982,945,969,2896,17376
2016-05-18 13:50:00,971,931,958,2860,17160
2016-05-18 14:00:00,924,896,911,2731,16386
2016-05-18 14:10:00,767,744,754,2265,13590
2016-05-18 14:20:00,720,700,713,2133,12798
2016-05-18 14:30:00,806,775,798,2379,14274
2016-05-18 14:40:00,729,700,728,2157,12942
2016-05-18 14:50:00,861,823,849,2533,15198
2016-05-18 15:00:00,901,863,884,2648,15888
2016-05-18 15:10:00,981,943,963,2887,17322
2016-05-18 15:20:00,949,916,941,2806,16836
2016-05-18 15:30:00,922,888,910,2720,16320
2016-05-18 15:40:00,898,856,887,2641,15846
2016-05-18 15:50:00,866,825,852,2543,15258
2016-05-18 16:00:00,835,796,824,2455,14730
2016-05-18 16:10:00,799,761,788,2348,14088
2016-05-18 16:20:00,750,709,738,2197,13182
2016-05-18 16:30:00,712,671,701,2084,12504
2016-05-18 16:40:00,672,639,664,1975,11850
2016-05-18 16:50:00,328,282,290,900,5400
2016-05-18 17:00:00,266,241,263,770,4620
2016-05-18 17:10:00,272,245,266,783,4698
2016-05-18 17:20:00,208,180,206,594,3564
2016-05-18 17:30:00,158,144,170,472,2832
2016-05-18 17:40:00,58,145,154,357,2142
2016-05-18 17:50:00,50,152,152,354,2124
2016-05-18 18:00:00,75,128,145,348,2088
2016-05-18 18:10:00,98,101,136,335,2010
2016-05-18 18:20:00,71,136,171,378,2268
2016-05-18 18:30:00,62,110,160,332,1992
2016-05-18 18:40:00,25,94,118,237,1422
2016-05-18 18:50:00,76,29,92,197,1182
2016-05-18 19:00:00,32,88,111,231,1386
2016-05-18 19:10:00,42,134,162,338,2028
2016-05-18 19:20:00,3,143,150,296,1776
2016-05-18 19:30:00,74,49,82,205,1230
2016-05-18 19:40:00,58,43,73,174,1044
2016-05-18 19:50:00,29,24,72,125,750
2016-05-18 20:00:00,36,14,52,102,612
2016-05-18 20:10:00,31,8,43,82,492
2016-05-18 20:20:00,26,5,32,63,378
2016-05-18 20:30:00,21,2,24,47,282
2016-05-18 20:40:00,8,2,11,21,126
2016-05-18 20:50:00,3,0,5,8,48
2016-05-18 21:00:00,0,0,0,0,0
2016-05-18 21:10:00,0,0,0,0,0
2016-05-18 21:20:00,0,0,0,0,0
2016-05-18 21:30:00,0,0,0,0,0
2016-05-18 21:40:00,0,0,0,0,0
2016-05-19 04:20:00,0,0,0,0,0
2016-05-19 04:30:00,0,0,0,0,0
2016-05-19 04:40:00,0,0,0,0,0
2016-05-19 04:50:00,0,0,0,0,0
2016-05-19 05:00:00,2,0,3,5,30
2016-05-19 05:10:00,9,2,15,26,156
2016-05-19 05:20:00,11,7,22,40,240
2016-05-19 05:30:00,11,11,30,52,312
2016-05-19 05:40:00,25,11,39,75,450
2016-05-19 05:50:00,27,11,42,80,480
2016-05-19 06:00:00,26,15,45,86,516
2016-05-19 06:10:00,20,29,53,102,612
2016-05-19 06:20:00,23,29,74,126,756
2016-05-19 06:30:00,41,37,74,152,912
2016-05-19 06:40:00,69,27,87,183,1098
2016-05-19 06:50:00,57,53,89,199,1194
2016-05-19 07:00:00,24,76,117,217,1302
2016-05-19 07:10:00,4,121,125,250,1500
2016-05-19 07:20:00,0,136,136,272,1632
2016-05-19 07:30:00,21,136,142,299,1794
2016-05-19 07:40:00,51,154,167,372,2232
2016-05-19 07:50:00,104,163,153,420,2520
2016-05-19 08:00:00,141,107,255,503,3018
2016-05-19 08:10:00,219,170,173,562,3372
2016-05-19 08:20:00,257,192,229,678,4068
2016-05-19 08:30:00,285,258,282,825,4950
2016-05-19 08:40:00,300,273,300,873,5238
2016-05-19 08:50:00,384,354,379,1117,6702
2016-05-19 09:00:00,475,444,471,1390,8340
2016-05-19 09:10:00,505,473,503,1481,8886
2016-05-19 09:20:00,474,446,471,1391,8346
2016-05-19 09:30:00,500,474,496,1470,8820
2016-05-19 09:40:00,587,556,582,1725,10350
2016-05-19 09:50:00,574,541,568,1683,10098
2016-05-19 10:00:00,540,505,535,1580,9480
2016-05-19 10:10:00,500,463,491,1454,8724
2016-05-19 10:20:00,722,684,715,2121,12726
2016-05-19 10:30:00,975,931,970,2876,17256
2016-05-19 10:40:00,884,849,886,2619,15714
2016-05-19 10:50:00,864,832,862,2558,15348
2016-05-19 11:00:00,873,841,873,2587,15522
2016-05-19 11:10:00,751,719,755,2225,13350
2016-05-19 11:20:00,744,707,743,2194,13164
2016-05-19 11:30:00,881,830,871,2582,15492
2016-05-19 11:40:00,1083,1025,1076,3184,19104
2016-05-19 11:50:00,929,895,930,2754,16524
2016-05-19 12:00:00,633,604,635,1872,11232
2016-05-19 12:10:00,365,339,359,1063,6378
2016-05-19 12:20:00,357,334,353,1044,6264
2016-05-19 12:30:00,839,814,827,2480,14880
2016-05-19 12:40:00,751,724,737,2212,13272
2016-05-19 12:50:00,1030,991,1014,3035,18210
2016-05-19 13:00:00,1061,1028,1042,3131,18786
2016-05-19 13:10:00,1083,1049,1071,3203,19218
2016-05-19 13:20:00,1053,1018,1036,3107,18642
2016-05-19 13:30:00,1049,1006,1037,3092,18552
2016-05-19 13:40:00,1031,993,1016,3040,18240
2016-05-19 13:50:00,1019,978,1006,3003,18018
2016-05-19 14:00:00,1000,969,986,2955,17730
2016-05-19 14:10:00,990,960,984,2934,17604
2016-05-19 14:20:00,985,962,981,2928,17568
2016-05-19 14:30:00,960,936,953,2849,17094
2016-05-19 14:40:00,950,927,944,2821,16926
2016-05-19 14:50:00,894,887,903,2684,16104
2016-05-19 15:00:00,854,831,850,2535,15210
2016-05-19 15:10:00,805,785,805,2395,14370
2016-05-19 15:20:00,724,702,721,2147,12882
2016-05-19 15:30:00,651,621,642,1914,11484
2016-05-19 15:40:00,838,803,828,2469,14814
2016-05-19 15:50:00,788,756,777,2321,13926
2016-05-19 16:00:00,737,714,729,2180,13080
2016-05-19 16:10:00,667,644,657,1968,11808
2016-05-19 16:20:00,701,677,695,2073,12438
2016-05-19 16:30:00,668,648,662,1978,11868
2016-05-19 16:40:00,640,613,631,1884,11304
2016-05-19 16:50:00,568,547,566,1681,10086
2016-05-19 17:00:00,527,504,523,1554,9324
2016-05-19 17:10:00,509,479,507,1495,8970
2016-05-19 17:20:00,464,433,460,1357,8142
2016-05-19 17:30:00,421,393,417,1231,7386
2016-05-19 17:40:00,370,352,369,1091,6546
2016-05-19 17:50:00,326,307,324,957,5742
2016-05-19 18:00:00,229,204,221,654,3924
2016-05-19 18:10:00,205,180,196,581,3486
2016-05-19 18:20:00,193,167,184,544,3264
2016-05-19 18:30:00,157,133,150,440,2640
2016-05-19 18:40:00,131,66,162,359,2154
2016-05-19 18:50:00,110,76,168,354,2124
2016-05-19 19:00:00,71,131,140,342,2052
2016-05-19 19:10:00,50,85,76,211,1266
2016-05-19 19:20:00,70,37,74,181,1086
2016-05-19 19:30:00,45,34,67,146,876
2016-05-19 19:40:00,39,18,49,106,636
2016-05-19 19:50:00,21,13,31,65,390
2016-05-19 20:00:00,15,11,18,44,264
2016-05-19 20:10:00,8,11,13,32,192
2016-05-19 20:20:00,6,7,7,20,120
2016-05-19 20:30:00,1,1,2,4,24
2016-05-19 20:40:00,0,0,0,0,0
2016-05-19 20:50:00,0,0,0,0,0
2016-05-19 21:00:00,0,0,0,0,0
2016-05-19 21:10:00,0,0,0,0,0
2016-05-19 21:20:00,0,0,0,0,0
2016-05-19 21:30:00,0,0,0,0,0
2016-05-20 04:30:00,0,0,0,0,0
2016-05-20 04:40:00,0,0,0,0,0
2016-05-20 04:50:00,0,0,0,0,0
2016-05-20 05:00:00,0,0,0,0,0
2016-05-20 05:10:00,1,1,2,4,24
2016-05-20 05:20:00,10,5,10,25,150
2016-05-20 05:30:00,13,7,20,40,240
2016-05-20 05:40:00,25,12,55,92,552
2016-05-20 05:50:00,29,31,80,140,840
2016-05-20 06:00:00,25,64,90,179,1074
2016-05-20 06:10:00,48,73,97,218,1308
2016-05-20 06:20:00,61,114,92,267,1602
2016-05-20 06:30:00,46,60,61,167,1002
2016-05-20 06:40:00,59,66,88,213,1278
2016-05-20 06:50:00,46,105,116,267,1602
2016-05-20 07:00:00,51,132,167,350,2100
2016-05-20 07:10:00,24,76,95,195,1170
2016-05-20 07:20:00,17,45,87,149,894
2016-05-20 07:30:00,32,108,125,265,1590
2016-05-20 07:40:00,105,158,145,408,2448
2016-05-20 07:50:00,112,147,131,390,2340
2016-05-20 08:00:00,130,144,201,475,2850
2016-05-20 08:10:00,288,154,127,569,3414
2016-05-20 08:20:00,223,260,195,678,4068
2016-05-20 08:30:00,270,251,268,789,4734
2016-05-20 08:40:00,273,253,271,797,4782
2016-05-20 08:50:00,331,306,327,964,5784
2016-05-20 09:00:00,323,295,317,935,5610
2016-05-20 09:10:00,342,313,335,990,5940
2016-05-20 09:20:00,357,331,352,1040,6240
2016-05-20 09:30:00,264,238,257,759,4554
2016-05-20 09:40:00,251,230,244,725,4350
2016-05-20 09:50:00,246,225,241,712,4272
2016-05-20 10:00:00,312,290,307,909,5454
2016-05-20 10:10:00,301,276,294,871,5226
2016-05-20 10:20:00,286,252,275,813,4878
2016-05-20 10:30:00,240,210,230,680,4080
2016-05-20 10:40:00,236,211,228,675,4050
2016-05-20 10:50:00,230,168,235,633,3798
2016-05-20 11:00:00,187,122,353,662,3972
2016-05-20 11:10:00,260,225,265,750,4500
2016-05-20 11:20:00,310,281,302,893,5358
2016-05-20 11:30:00,294,269,285,848,5088
2016-05-20 11:40:00,264,241,257,762,4572
2016-05-20 11:50:00,414,392,404,1210,7260
2016-05-20 12:00:00,468,444,458,1370,8220
2016-05-20 12:10:00,479,450,469,1398,8388
2016-05-20 12:20:00,370,341,361,1072,6432
2016-05-20 12:30:00,148,120,138,406,2436
2016-05-20 12:40:00,197,137,196,530,3180
2016-05-20 12:50:00,332,310,325,967,5802
2016-05-20 13:00:00,730,708,730,2168,13008
2016-05-20 13:10:00,650,634,645,1929,11574
2016-05-20 13:20:00,721,701,720,2142,12852
2016-05-20 13:30:00,520,497,517,1534,9204
2016-05-20 13:40:00,367,345,362,1074,6444
2016-05-20 13:50:00,336,314,331,981,5886
2016-05-20 14:00:00,342,321,338,1001,6006
2016-05-20 14:10:00,232,209,227,668,4008
2016-05-20 14:20:00,183,118,246,547,3282
2016-05-20 14:30:00,231,151,224,606,3636
2016-05-20 14:40:00,344,317,337,998,5988
2016-05-20 14:50:00,326,298,317,941,5646
2016-05-20 15:00:00,185,163,177,525,3150
2016-05-20 15:10:00,197,176,189,562,3372
2016-05-20 15:20:00,81,75,91,247,1482
2016-05-20 15:30:00,152,92,192,436,2616
2016-05-20 15:40:00,327,298,318,943,5658
2016-05-20 15:50:00,291,261,281,833,4998
2016-05-20 16:00:00,394,362,383,1139,6834
2016-05-20 16:10:00,849,820,846,2515,15090
2016-05-20 16:20:00,633,620,641,1894,11364
2016-05-20 16:30:00,545,523,539,1607,9642
2016-05-20 16:40:00,505,476,497,1478,8868
2016-05-20 16:50:00,569,544,565,1678,10068
2016-05-20 17:00:00,572,550,568,1690,10140
2016-05-20 17:10:00,557,532,549,1638,9828
2016-05-20 17:20:00,509,483,499,1491,8946
2016-05-20 17:30:00,470,434,461,1365,8190
2016-05-20 17:40:00,417,388,414,1219,7314
2016-05-20 17:50:00,363,342,364,1069,6414
2016-05-20 18:00:00,315,300,323,938,5628
2016-05-20 18:10:00,276,255,273,804,4824
2016-05-20 18:20:00,219,180,284,683,4098
2016-05-20 18:30:00,184,157,211,552,3312
2016-05-20 18:40:00,154,132,149,435,2610
2016-05-20 18:50:00,117,104,125,346,2076
2016-05-20 19:00:00,107,111,43,261,1566
2016-05-20 19:10:00,40,74,67,181,1086
2016-05-20 19:20:00,36,51,55,142,852
2016-05-20 19:30:00,41,41,50,132,792
2016-05-20 19:40:00,39,22,52,113,678
2016-05-20 19:50:00,24,32,45,101,606
2016-05-20 20:00:00,21,26,43,90,540
2016-05-20 20:10:00,17,24,40,81,486
2016-05-20 20:20:00,14,22,38,74,444
2016-05-20 20:30:00,11,13,30,54,324
2016-05-20 20:40:00,8,12,15,35,210
2016-05-20 20:50:00,7,5,9,21,126
2016-05-20 21:00:00,4,3,4,11,66
2016-05-20 21:10:00,0,0,0,0,0
2016-05-20 21:20:00,0,0,0,0,0
2016-05-20 21:30:00,0,0,0,0,0
2016-05-20 21:40:00,0,0,0,0,0
2016-05-20 21:50:00,0,0,0,0,0
2016-05-21 04:20:00,0,0,0,0,0
2016-05-21 04:30:00,0,0,0,0,0
2016-05-21 04:40:00,0,0,0,0,0
2016-05-21 04:50:00,0,0,0,0,0
2016-05-21 05:00:00,0,0,0,0,0
2016-05-21 05:10:00,1,1,1,3,18
2016-05-21 05:20:00,7,3,13,23,138
2016-05-21 05:30:00,22,5,20,47,282
2016-05-21 05:40:00,19,15,42,76,456
2016-05-21 05:50:00,31,40,73,144,864
2016-05-21 06:00:00,36,66,95,197,1182
2016-05-21 06:10:00,8,32,50,90,540
2016-05-21 06:20:00,20,45,61,126,756
2016-05-21 06:30:00,49,89,106,244,1464
2016-05-21 06:40:00,36,48,64,148,888
2016-05-21 06:50:00,44,84,94,222,1332
2016-05-21 07:00:00,83,100,217,400,2400
2016-05-21 07:10:00,114,64,232,410,2460
2016-05-21 07:20:00,37,125,143,305,1830
2016-05-21 07:30:00,134,176,155,465,2790
2016-05-21 07:40:00,181,117,195,493,2958
2016-05-21 07:50:00,208,184,203,595,3570
2016-05-21 08:00:00,190,169,185,544,3264
2016-05-21 08:10:00,189,152,212,553,3318
2016-05-21 08:20:00,250,228,245,723,4338
2016-05-21 08:30:00,322,293,314,929,5574
2016-05-21 08:40:00,313,284,307,904,5424
2016-05-21 08:50:00,376,341,369,1086,6516
2016-05-21 09:00:00,438,396,427,1261,7566
2016-05-21 09:10:00,484,446,470,1400,8400
2016-05-21 09:20:00,451,424,444,1319,7914
2016-05-21 09:30:00,392,360,381,1133,6798
2016-05-21 09:40:00,306,277,297,880,5280
2016-05-21 09:50:00,309,278,302,889,5334
2016-05-21 10:00:00,321,291,315,927,5562
2016-05-21 10:10:00,368,339,365,1072,6432
2016-05-21 10:20:00,457,426,457,1340,8040
2016-05-21 10:30:00,499,472,501,1472,8832
2016-05-21 10:40:00,471,448,466,1385,8310
2016-05-21 10:50:00,600,572,592,1764,10584
2016-05-21 11:00:00,515,485,507,1507,9042
2016-05-21 11:10:00,662,627,652,1941,11646
2016-05-21 11:20:00,580,539,566,1685,10110
2016-05-21 11:30:00,675,631,661,1967,11802
2016-05-21 11:40:00,647,614,651,1912,11472
2016-05-21 11:50:00,521,493,521,1535,9210
2016-05-21 12:00:00,591,561,587,1739,10434
2016-05-21 12:10:00,729,700,726,2155,12930
2016-05-21 12:20:00,699,670,691,2060,12360
2016-05-21 12:30:00,739,714,736,2189,13134
2016-05-21 12:40:00,528,501,520,1549,9294
2016-05-21 12:50:00,396,370,390,1156,6936
2016-05-21 13:00:00,670,634,660,1964,11784
2016-05-21 13:10:00,794,750,790,2334,14004
2016-05-21 13:20:00,560,525,557,1642,9852
2016-05-21 13:30:00,632,608,637,1877,11262
2016-05-21 13:40:00,845,814,845,2504,15024
2016-05-21 13:50:00,866,828,857,2551,15306
2016-05-21 14:00:00,319,291,309,919,5514
2016-05-21 14:10:00,292,267,283,842,5052
2016-05-21 14:20:00,360,335,354,1049,6294
2016-05-21 14:30:00,275,251,267,793,4758
2016-05-21 14:40:00,444,412,430,1286,7716
2016-05-21 14:50:00,663,624,650,1937,11622
2016-05-21 15:00:00,674,642,668,1984,11904
2016-05-21 15:10:00,484,461,477,1422,8532
2016-05-21 15:20:00,482,458,477,1417,8502
2016-05-21 15:30:00,454,427,442,1323,7938
2016-05-21 15:40:00,349,323,337,1009,6054
2016-05-21 15:50:00,384,356,374,1114,6684
2016-05-21 16:00:00,236,213,229,678,4068
2016-05-21 16:10:00,51,85,105,241,1446
2016-05-21 16:20:00,98,93,182,373,2238
2016-05-21 16:30:00,131,121,244,496,2976
2016-05-21 16:40:00,132,147,195,474,2844
2016-05-21 16:50:00,196,171,185,552,3312
2016-05-21 17:00:00,100,79,87,266,1596
2016-05-21 17:10:00,56,119,127,302,1812
2016-05-21 17:20:00,203,88,210,501,3006
2016-05-21 17:30:00,145,108,239,492,2952
2016-05-21 17:40:00,12,135,144,291,1746
2016-05-21 17:50:00,60,42,87,189,1134
2016-05-21 18:00:00,79,14,87,180,1080
2016-05-21 18:10:00,15,72,90,177,1062
2016-05-21 18:20:00,12,72,83,167,1002
2016-05-21 18:30:00,38,36,58,132,792
2016-05-21 18:40:00,14,15,33,62,372
2016-05-21 18:50:00,0,0,0,0,0
2016-05-21 19:00:00,14,15,23,52,312
2016-05-21 19:10:00,18,19,37,74,444
2016-05-21 19:20:00,24,34,22,80,480
2016-05-21 19:30:00,28,31,37,96,576
2016-05-21 19:40:00,10,5,15,30,180
2016-05-21 19:50:00,23,10,37,70,420
2016-05-21 20:00:00,7,2,8,17,102
2016-05-21 20:10:00,0,0,0,0,0
2016-05-21 20:20:00,0,0,0,0,0
2016-05-21 20:30:00,0,0,0,0,0
2016-05-21 20:40:00,0,0,0,0,0
2016-05-21 20:50:00,0,0,0,0,0
2016-05-21 21:00:00,0,0,0,0,0
2016-05-21 21:10:00,0,0,0,0,0
2016-05-21 21:20:00,0,0,0,0,0
2016-05-21 21:30:00,0,0,0,0,0
2016-05-22 04:20:00,0,0,0,0,0
2016-05-22 04:30:00,0,0,0,0,0
2016-05-22 04:40:00,0,0,0,0,0
2016-05-22 04:50:00,0,0,0,0,0
2016-05-22 05:00:00,2,0,3,5,30
2016-05-22 05:10:00,12,4,16,32,192
2016-05-22 05:20:00,22,7,32,61,366
2016-05-22 05:30:00,20,4,28,52,312
2016-05-22 05:40:00,20,6,26,52,312
2016-05-22 05:50:00,28,13,41,82,492
2016-05-22 06:00:00,24,35,64,123,738
2016-05-22 06:10:00,39,45,81,165,990
2016-05-22 06:20:00,41,83,98,222,1332
2016-05-22 06:30:00,35,54,84,173,1038
2016-05-22 06:40:00,42,32,73,147,882
2016-05-22 06:50:00,68,65,81,214,1284
2016-05-22 07:00:00,50,46,85,181,1086
2016-05-22 07:10:00,131,54,166,351,2106
2016-05-22 07:20:00,202,174,180,556,3336
2016-05-22 07:30:00,192,57,291,540,3240
2016-05-22 07:40:00,201,151,275,627,3762
2016-05-22 07:50:00,198,172,192,562,3372
2016-05-22 08:00:00,225,202,219,646,3876
2016-05-22 08:10:00,180,155,172,507,3042
2016-05-22 08:20:00,173,149,167,489,2934
2016-05-22 08:30:00,235,211,227,673,4038
2016-05-22 08:40:00,400,373,389,1162,6972
2016-05-22 08:50:00,455,426,447,1328,7968
2016-05-22 09:00:00,216,187,208,611,3666
2016-05-22 09:10:00,274,244,266,784,4704
2016-05-22 09:20:00,370,344,364,1078,6468
2016-05-22 09:30:00,239,216,235,690,4140
2016-05-22 09:40:00,459,432,456,1347,8082
2016-05-22 09:50:00,784,758,780,2322,13932
2016-05-22 10:00:00,762,738,760,2260,13560
2016-05-22 10:10:00,674,648,669,1991,11946
2016-05-22 10:20:00,646,607,639,1892,11352
2016-05-22 10:30:00,889,851,888,2628,15768
2016-05-22 10:40:00,942,921,945,2808,16848
2016-05-22 10:50:00,929,914,932,2775,16650
2016-05-22 11:00:00,961,943,969,2873,17238
2016-05-22 11:10:00,828,808,832,2468,14808
2016-05-22 11:20:00,921,896,912,2729,16374
2016-05-22 11:30:00,737,715,736,2188,13128
2016-05-22 11:40:00,1040,1014,1030,3084,18504
2016-05-22 11:50:00,949,911,934,2794,16764
2016-05-22 12:00:00,664,632,654,1950,11700
2016-05-22 12:10:00,511,487,507,1505,9030
2016-05-22 12:20:00,573,551,565,1689,10134
2016-05-22 12:30:00,643,625,640,1908,11448
2016-05-22 12:40:00,648,629,647,1924,11544
2016-05-22 12:50:00,682,659,677,2018,12108
2016-05-22 13:00:00,643,621,639,1903,11418
2016-05-22 13:10:00,650,628,644,1922,11532
2016-05-22 13:20:00,563,540,555,1658,9948
2016-05-22 13:30:00,566,542,555,1663,9978
2016-05-22 13:40:00,635,612,624,1871,11226
2016-05-22 13:50:00,772,748,764,2284,13704
2016-05-22 14:00:00,831,805,820,2456,14736
2016-05-22 14:10:00,893,867,878,2638,15828
2016-05-22 14:20:00,822,803,816,2441,14646
2016-05-22 14:30:00,798,778,796,2372,14232
2016-05-22 14:40:00,790,772,793,2355,14130
2016-05-22 14:50:00,907,885,904,2696,16176
2016-05-22 15:00:00,922,892,912,2726,16356
2016-05-22 15:10:00,975,950,970,2895,17370
2016-05-22 15:20:00,811,784,797,2392,14352
2016-05-22 15:30:00,856,840,853,2549,15294
2016-05-22 15:40:00,933,899,917,2749,16494
2016-05-22 15:50:00,853,819,839,2511,15066
2016-05-22 16:00:00,606,577,588,1771,10626
2016-05-22 16:10:00,632,605,620,1857,11142
2016-05-22 16:20:00,654,624,639,1917,11502
2016-05-22 16:30:00,605,578,591,1774,10644
2016-05-22 16:40:00,565,533,548,1646,9876
2016-05-22 16:50:00,724,696,708,2128,12768
2016-05-22 17:00:00,719,692,704,2115,12690
2016-05-22 17:10:00,575,550,541,1666,9996
2016-05-22 17:20:00,459,431,446,1336,8016
2016-05-22 17:30:00,465,431,449,1345,8070
2016-05-22 17:40:00,409,377,398,1184,7104
2016-05-22 17:50:00,352,327,346,1025,6150
2016-05-22 18:00:00,334,308,328,970,5820
2016-05-22 18:10:00,279,255,271,805,4830
2016-05-22 18:20:00,195,171,188,554,3324
2016-05-22 18:30:00,150,126,144,420,2520
2016-05-22 18:40:00,166,144,162,472,2832
2016-05-22 18:50:00,139,113,142,394,2364
2016-05-22 19:00:00,95,111,120,326,1956
2016-05-22 19:10:00,57,122,91,270,1620
2016-05-22 19:20:00,79,79,79,237,1422
2016-05-22 19:30:00,59,65,73,197,1182
2016-05-22 19:40:00,60,55,53,168,1008
2016-05-22 19:50:00,27,28,67,122,732
2016-05-22 20:00:00,25,23,37,85,510
2016-05-22 20:10:00,11,26,24,61,366
2016-05-22 20:20:00,12,11,21,44,264
2016-05-22 20:30:00,10,8,14,32,192
2016-05-22 20:40:00,8,6,11,25,150
2016-05-22 20:50:00,4,3,6,13,78
2016-05-22 21:00:00,0,0,0,0,0
2016-05-22 21:10:00,0,0,0,0,0
2016-05-22 21:20:00,0,0,0,0,0
2016-05-22 21:30:00,0,0,0,0,0
2016-05-22 21:40:00,0,0,0,0,0
2016-05-23 04:20:00,0,0,0,0,0
2016-05-23 04:30:00,0,0,0,0,0
2016-05-23 04:40:00,0,0,0,0,0
2016-05-23 04:50:00,0,0,0,0,0
2016-05-23 05:00:00,0,0,0,0,0
2016-05-23 05:10:00,0,0,0,0,0
2016-05-23 05:20:00,0,0,0,0,0
2016-05-23 05:30:00,2,1,6,9,54
2016-05-23 05:40:00,8,5,18,31,186
2016-05-23 05:50:00,21,15,49,85,510
2016-05-23 06:00:00,29,24,70,123,738
2016-05-23 06:10:00,23,26,67,116,696
2016-05-23 06:20:00,24,13,46,83,498
2016-05-23 06:30:00,16,9,22,47,282
2016-05-23 06:40:00,9,5,11,25,150
2016-05-23 06:50:00,16,5,19,40,240
2016-05-23 07:00:00,14,5,18,37,222
2016-05-23 07:10:00,32,23,57,112,672
2016-05-23 07:20:00,36,30,56,122,732
2016-05-23 07:30:00,44,38,53,135,810
2016-05-23 07:40:00,25,24,53,102,612
2016-05-23 07:50:00,30,36,64,130,780
2016-05-23 08:00:00,15,23,86,124,744
2016-05-23 08:10:00,23,18,49,90,540
2016-05-23 08:20:00,16,21,56,93,558
2016-05-23 08:30:00,62,68,78,208,1248
2016-05-23 08:40:00,63,98,98,259,1554
2016-05-23 08:50:00,52,59,79,190,1140
2016-05-23 09:00:00,53,73,82,208,1248
2016-05-23 09:10:00,69,81,88,238,1428
2016-05-23 09:20:00,54,84,91,229,1374
2016-05-23 09:30:00,67,42,74,183,1098
2016-05-23 09:40:00,103,72,98,273,1638
2016-05-23 09:50:00,115,120,67,302,1812
2016-05-23 10:00:00,115,118,86,319,1914
2016-05-23 10:10:00,85,137,115,337,2022
2016-05-23 10:20:00,111,146,151,408,2448
2016-05-23 10:30:00,83,113,121,317,1902
2016-05-23 10:40:00,139,192,239,570,3420
2016-05-23 10:50:00,125,177,193,495,2970
2016-05-23 11:00:00,329,268,267,864,5184
2016-05-23 11:10:00,349,325,342,1016,6096
2016-05-23 11:20:00,157,168,177,502,3012
2016-05-23 11:30:00,267,235,292,794,4764
2016-05-23 11:40:00,314,289,308,911,5466
2016-05-23 11:50:00,236,212,230,678,4068
2016-05-23 12:00:00,284,260,279,823,4938
2016-05-23 12:10:00,338,316,336,990,5940
2016-05-23 12:20:00,367,349,369,1085,6510
2016-05-23 12:30:00,261,244,261,766,4596
2016-05-23 12:40:00,233,194,294,721,4326
2016-05-23 12:50:00,262,284,274,820,4920
2016-05-23 13:00:00,427,404,426,1257,7542
2016-05-23 13:10:00,322,298,316,936,5616
2016-05-23 13:20:00,248,225,242,715,4290
2016-05-23 13:30:00,296,274,291,861,5166
2016-05-23 13:40:00,350,329,346,1025,6150
2016-05-23 13:50:00,314,292,311,917,5502
2016-05-23 14:00:00,557,534,555,1646,9876
2016-05-23 14:10:00,186,164,183,533,3198
2016-05-23 14:20:00,114,146,151,411,2466
2016-05-23 14:30:00,259,213,209,681,4086
2016-05-23 14:40:00,234,181,252,667,4002
2016-05-23 14:50:00,555,534,549,1638,9828
2016-05-23 15:00:00,673,650,670,1993,11958
2016-05-23 15:10:00,541,516,536,1593,9558
2016-05-23 15:20:00,360,336,354,1050,6300
2016-05-23 15:30:00,561,534,554,1649,9894
2016-05-23 15:40:00,809,782,806,2397,14382
2016-05-23 15:50:00,748,723,748,2219,13314
2016-05-23 16:00:00,536,511,533,1580,9480
2016-05-23 16:10:00,622,594,620,1836,11016
2016-05-23 16:20:00,498,474,494,1466,8796
2016-05-23 16:30:00,254,231,250,735,4410
2016-05-23 16:40:00,331,305,325,961,5766
2016-05-23 16:50:00,325,301,322,948,5688
2016-05-23 17:00:00,286,262,283,831,4986
2016-05-23 17:10:00,250,225,246,721,4326
2016-05-23 17:20:00,165,140,161,466,2796
2016-05-23 17:30:00,134,110,129,373,2238
2016-05-23 17:40:00,78,136,169,383,2298
2016-05-23 17:50:00,25,141,149,315,1890
2016-05-23 18:00:00,24,93,95,212,1272
2016-05-23 18:10:00,47,94,86,227,1362
2016-05-23 18:20:00,81,94,68,243,1458
2016-05-23 18:30:00,114,132,39,285,1710
2016-05-23 18:40:00,75,96,102,273,1638
2016-05-23 18:50:00,74,62,91,227,1362
2016-05-23 19:00:00,123,40,128,291,1746
2016-05-23 19:10:00,65,85,74,224,1344
2016-05-23 19:20:00,47,80,61,188,1128
2016-05-23 19:30:00,68,68,62,198,1188
2016-05-23 19:40:00,45,60,71,176,1056
2016-05-23 19:50:00,29,33,50,112,672
2016-05-23 20:00:00,19,21,32,72,432
2016-05-23 20:10:00,19,21,20,60,360
2016-05-23 20:20:00,13,15,22,50,300
2016-05-23 20:30:00,5,9,7,21,126
2016-05-23 20:40:00,4,4,4,12,72
2016-05-23 20:50:00,0,0,0,0,0
2016-05-23 21:00:00,0,0,0,0,0
2016-05-23 21:10:00,0,0,0,0,0
2016-05-23 21:20:00,0,0,0,0,0
2016-05-23 21:30:00,0,0,0,0,0
2016-05-24 04:20:00,0,0,0,0,0
2016-05-24 04:30:00,0,0,0,0,0
2016-05-24 04:40:00,0,0,0,0,0
2016-05-24 04:50:00,0,0,0,0,0
2016-05-24 05:00:00,0,0,0,0,0
2016-05-24 05:10:00,0,0,0,0,0
2016-05-24 05:20:00,0,0,0,0,0
2016-05-24 05:30:00,1,0,0,1,6
2016-05-24 05:40:00,9,3,6,18,108
2016-05-24 05:50:00,14,4,4,22,132
2016-05-24 06:00:00,8,4,7,19,114
2016-05-24 06:10:00,11,7,13,31,186
2016-05-24 06:20:00,26,8,37,71,426
2016-05-24 06:30:00,26,9,42,77,462
2016-05-24 06:40:00,38,42,68,148,888
2016-05-24 06:50:00,46,55,74,175,1050
2016-05-24 07:00:00,46,56,83,185,1110
2016-05-24 07:10:00,30,80,90,200,1200
2016-05-24 07:20:00,51,84,90,225,1350
2016-05-24 07:30:00,58,101,92,251,1506
2016-05-24 07:40:00,45,111,125,281,1686
2016-05-24 07:50:00,67,85,88,240,1440
2016-05-24 08:00:00,81,113,95,289,1734
2016-05-24 08:10:00,115,151,143,409,2454
2016-05-24 08:20:00,192,135,252,579,3474
2016-05-24 08:30:00,194,191,147,532,3192
2016-05-24 08:40:00,216,165,199,580,3480
2016-05-24 08:50:00,96,128,129,353,2118
2016-05-24 09:00:00,89,109,78,276,1656
2016-05-24 09:10:00,94,96,44,234,1404
2016-05-24 09:20:00,106,117,96,319,1914
2016-05-24 09:30:00,89,131,145,365,2190
2016-05-24 09:40:00,98,110,136,344,2064
2016-05-24 09:50:00,118,138,142,398,2388
2016-05-24 10:00:00,180,138,201,519,3114
2016-05-24 10:10:00,295,219,217,731,4386
2016-05-24 10:20:00,318,292,313,923,5538
2016-05-24 10:30:00,324,301,320,945,5670
2016-05-24 10:40:00,345,326,349,1020,6120
2016-05-24 10:50:00,381,352,369,1102,6612
2016-05-24 11:00:00,349,319,338,1006,6036
2016-05-24 11:10:00,329,295,316,940,5640
2016-05-24 11:20:00,251,227,255,733,4398
2016-05-24 11:30:00,206,180,203,589,3534
2016-05-24 11:40:00,298,269,296,863,5178
2016-05-24 11:50:00,291,263,287,841,5046
2016-05-24 12:00:00,164,140,160,464,2784
2016-05-24 12:10:00,105,100,132,337,2022
2016-05-24 12:20:00,103,97,129,329,1974
2016-05-24 12:30:00,92,95,120,307,1842
2016-05-24 12:40:00,93,112,142,347,2082
2016-05-24 12:50:00,141,100,220,461,2766
2016-05-24 13:00:00,270,198,204,672,4032
2016-05-24 13:10:00,265,231,263,759,4554
2016-05-24 13:20:00,377,354,370,1101,6606
2016-05-24 13:30:00,374,356,368,1098,6588
2016-05-24 13:40:00,417,401,402,1220,7320
2016-05-24 13:50:00,379,355,367,1101,6606
2016-05-24 14:00:00,269,242,260,771,4626
2016-05-24 14:10:00,325,299,315,939,5634
2016-05-24 14:20:00,345,328,337,1010,6060
2016-05-24 14:30:00,435,416,426,1277,7662
2016-05-24 14:40:00,324,299,318,941,5646
2016-05-24 14:50:00,442,416,437,1295,7770
2016-05-24 15:00:00,522,500,520,1542,9252
2016-05-24 15:10:00,589,569,588,1746,10476
2016-05-24 15:20:00,384,363,381,1128,6768
2016-05-24 15:30:00,358,338,356,1052,6312
2016-05-24 15:40:00,529,513,531,1573,9438
2016-05-24 15:50:00,664,659,682,2005,12030
2016-05-24 16:00:00,748,745,760,2253,13518
2016-05-24 16:10:00,554,533,556,1643,9858
2016-05-24 16:20:00,237,220,241,698,4188
2016-05-24 16:30:00,307,279,303,889,5334
2016-05-24 16:40:00,469,435,464,1368,8208
2016-05-24 16:50:00,444,419,444,1307,7842
2016-05-24 17:00:00,588,567,583,1738,10428
2016-05-24 17:10:00,523,499,521,1543,9258
2016-05-24 17:20:00,451,432,448,1331,7986
2016-05-24 17:30:00,435,413,425,1273,7638
2016-05-24 17:40:00,434,409,421,1264,7584
2016-05-24 17:50:00,217,165,199,581,3486
2016-05-24 18:00:00,292,261,285,838,5028
2016-05-24 18:10:00,289,258,283,830,4980
2016-05-24 18:20:00,237,211,229,677,4062
2016-05-24 18:30:00,198,173,192,563,3378
2016-05-24 18:40:00,167,53,234,454,2724
2016-05-24 18:50:00,86,153,153,392,2352
2016-05-24 19:00:00,68,162,153,383,2298
2016-05-24 19:10:00,134,150,127,411,2466
2016-05-24 19:20:00,74,111,119,304,1824
2016-05-24 19:30:00,68,72,83,223,1338
2016-05-24 19:40:00,66,58,78,202,1212
2016-05-24 19:50:00,52,54,71,177,1062
2016-05-24 20:00:00,39,44,58,141,846
2016-05-24 20:10:00,43,15,58,116,696
2016-05-24 20:20:00,23,31,41,95,570
2016-05-24 20:30:00,18,21,31,70,420
2016-05-24 20:40:00,14,13,20,47,282
2016-05-24 20:50:00,9,7,14,30,180
2016-05-24 21:00:00,5,3,7,15,90
2016-05-24 21:10:00,1,0,1,2,12
2016-05-24 21:20:00,0,0,0,0,0
2016-05-24 21:30:00,0,0,0,0,0
2016-05-24 21:40:00,0,0,0,0,0
2016-05-24 21:50:00,0,0,0,0,0
2016-05-25 04:10:00,0,0,0,0,0
2016-05-25 04:20:00,0,0,0,0,0
2016-05-25 04:30:00,0,0,0,0,0
2016-05-25 04:40:00,0,0,0,0,0
2016-05-25 04:50:00,0,0,0,0,0
2016-05-25 05:00:00,0,0,0,0,0
2016-05-25 05:10:00,3,1,4,8,48
2016-05-25 05:20:00,8,4,11,23,138
2016-05-25 05:30:00,13,7,20,40,240
2016-05-25 05:40:00,16,10,29,55,330
2016-05-25 05:50:00,23,7,33,63,378
2016-05-25 06:00:00,33,7,43,83,498
2016-05-25 06:10:00,40,26,59,125,750
2016-05-25 06:20:00,53,36,77,166,996
2016-05-25 06:30:00,56,51,83,190,1140
2016-05-25 06:40:00,54,33,71,158,948
2016-05-25 06:50:00,37,51,63,151,906
2016-05-25 07:00:00,47,83,85,215,1290
2016-05-25 07:10:00,57,136,142,335,2010
2016-05-25 07:20:00,78,129,140,347,2082
2016-05-25 07:30:00,119,74,149,342,2052
2016-05-25 07:40:00,82,104,174,360,2160
2016-05-25 07:50:00,90,139,149,378,2268
2016-05-25 08:00:00,178,141,223,542,3252
2016-05-25 08:10:00,59,210,214,483,2898
2016-05-25 08:20:00,144,23,289,456,2736
2016-05-25 08:30:00,185,170,180,535,3210
2016-05-25 08:40:00,292,150,120,562,3372
2016-05-25 08:50:00,259,188,163,610,3660
2016-05-25 09:00:00,246,225,247,718,4308
2016-05-25 09:10:00,266,241,264,771,4626
2016-05-25 09:20:00,265,238,259,762,4572
2016-05-25 09:30:00,351,321,344,1016,6096
2016-05-25 09:40:00,435,409,427,1271,7626
2016-05-25 09:50:00,638,613,634,1885,11310
2016-05-25 10:00:00,653,631,650,1934,11604
2016-05-25 10:10:00,496,479,494,1469,8814
2016-05-25 10:20:00,528,500,521,1549,9294
2016-05-25 10:30:00,455,424,448,1327,7962
2016-05-25 10:40:00,383,360,377,1120,6720
2016-05-25 10:50:00,445,426,445,1316,7896
2016-05-25 11:00:00,386,359,377,1122,6732
2016-05-25 11:10:00,379,351,370,1100,6600
2016-05-25 11:20:00,464,446,451,1361,8166
2016-05-25 11:30:00,519,497,506,1522,9132
2016-05-25 11:40:00,421,397,411,1229,7374
2016-05-25 11:50:00,429,412,426,1267,7602
2016-05-25 12:00:00,410,379,400,1189,7134
2016-05-25 12:10:00,435,405,426,1266,7596
2016-05-25 12:20:00,447,416,434,1297,7782
2016-05-25 12:30:00,514,487,506,1507,9042
2016-05-25 12:40:00,682,662,675,2019,12114
2016-05-25 12:50:00,671,659,672,2002,12012
2016-05-25 13:00:00,850,840,855,2545,15270
2016-05-25 13:10:00,1100,1092,1099,3291,19746
2016-05-25 13:20:00,821,809,812,2442,14652
2016-05-25 13:30:00,959,936,951,2846,17076
2016-05-25 13:40:00,1048,1024,1038,3110,18660
2016-05-25 13:50:00,950,923,957,2830,16980
2016-05-25 14:00:00,968,937,975,2880,17280
2016-05-25 14:10:00,971,945,976,2892,17352
2016-05-25 14:20:00,906,885,906,2697,16182
2016-05-25 14:30:00,977,957,976,2910,17460
2016-05-25 14:40:00,917,902,919,2738,16428
2016-05-25 14:50:00,999,980,998,2977,17862
2016-05-25 15:00:00,962,944,960,2866,17196
2016-05-25 15:10:00,893,880,894,2667,16002
2016-05-25 15:20:00,901,879,895,2675,16050
2016-05-25 15:30:00,838,813,827,2478,14868
2016-05-25 15:40:00,826,801,816,2443,14658
2016-05-25 15:50:00,863,827,855,2545,15270
2016-05-25 16:00:00,831,800,830,2461,14766
2016-05-25 16:10:00,648,622,645,1915,11490
2016-05-25 16:20:00,672,658,668,1998,11988
2016-05-25 16:30:00,688,681,686,2055,12330
2016-05-25 16:40:00,633,634,647,1914,11484
2016-05-25 16:50:00,600,585,606,1791,10746
2016-05-25 17:00:00,540,522,546,1608,9648
2016-05-25 17:10:00,589,563,590,1742,10452
2016-05-25 17:20:00,483,456,478,1417,8502
2016-05-25 17:30:00,476,443,468,1387,8322
2016-05-25 17:40:00,433,399,425,1257,7542
2016-05-25 17:50:00,378,345,365,1088,6528
2016-05-25 18:00:00,330,305,319,954,5724
2016-05-25 18:10:00,292,267,283,842,5052
2016-05-25 18:20:00,289,197,191,677,4062
2016-05-25 18:30:00,299,159,124,582,3492
2016-05-25 18:40:00,62,226,179,467,2802
2016-05-25 18:50:00,78,144,146,368,2208
2016-05-25 19:00:00,86,81,109,276,1656
2016-05-25 19:10:00,67,56,78,201,1206
2016-05-25 19:20:00,73,46,77,196,1176
2016-05-25 19:30:00,73,29,75,177,1062
2016-05-25 19:40:00,67,47,83,197,1182
2016-05-25 19:50:00,63,46,80,189,1134
2016-05-25 20:00:00,27,27,77,131,786
2016-05-25 20:10:00,26,22,60,108,648
2016-05-25 20:20:00,32,10,45,87,522
2016-05-25 20:30:00,25,5,32,62,372
2016-05-25 20:40:00,14,14,18,46,276
2016-05-25 20:50:00,9,6,11,26,156
2016-05-25 21:00:00,4,4,5,13,78
2016-05-25 21:10:00,1,0,1,2,12
2016-05-25 21:20:00,0,0,0,0,0
2016-05-25 21:30:00,0,0,0,0,0
2016-05-25 21:40:00,0,0,0,0,0
2016-05-25 21:50:00,0,0,0,0,0
2016-05-26 04:20:00,0,0,0,0,0
2016-05-26 04:30:00,0,0,0,0,0
2016-05-26 04:40:00,0,0,0,0,0
2016-05-26 04:50:00,0,0,0,0,0
2016-05-26 05:00:00,0,0,0,0,0
2016-05-26 05:10:00,0,0,0,0,0
2016-05-26 05:20:00,2,1,4,7,42
2016-05-26 05:30:00,8,5,13,26,156
2016-05-26 05:40:00,5,3,7,15,90
2016-05-26 05:50:00,6,2,6,14,84
2016-05-26 06:00:00,20,4,22,46,276
2016-05-26 06:10:00,30,3,35,68,408
2016-05-26 06:20:00,31,10,42,83,498
2016-05-26 06:30:00,39,22,51,112,672
2016-05-26 06:40:00,35,38,55,128,768
2016-05-26 06:50:00,46,32,62,140,840
2016-05-26 07:00:00,36,53,81,170,1020
2016-05-26 07:10:00,65,76,83,224,1344
2016-05-26 07:20:00,74,70,84,228,1368
2016-05-26 07:30:00,64,56,82,202,1212
2016-05-26 07:40:00,64,80,88,232,1392
2016-05-26 07:50:00,53,120,137,310,1860
2016-05-26 08:00:00,126,69,217,412,2472
2016-05-26 08:10:00,151,47,261,459,2754
2016-05-26 08:20:00,100,107,147,354,2124
2016-05-26 08:30:00,50,150,164,364,2184
2016-05-26 08:40:00,105,111,137,353,2118
2016-05-26 08:50:00,147,76,182,405,2430
2016-05-26 09:00:00,162,0,291,453,2718
2016-05-26 09:10:00,137,113,169,419,2514
2016-05-26 09:20:00,128,106,166,400,2400
2016-05-26 09:30:00,144,12,274,430,2580
2016-05-26 09:40:00,123,88,130,341,2046
2016-05-26 09:50:00,30,138,156,324,1944
2016-05-26 10:00:00,75,134,161,370,2220
2016-05-26 10:10:00,147,109,168,424,2544
2016-05-26 10:20:00,129,133,143,405,2430
2016-05-26 10:30:00,156,18,286,460,2760
2016-05-26 10:40:00,232,124,169,525,3150
2016-05-26 10:50:00,330,299,315,944,5664
2016-05-26 11:00:00,329,305,321,955,5730
2016-05-26 11:10:00,264,241,259,764,4584
2016-05-26 11:20:00,248,227,244,719,4314
2016-05-26 11:30:00,262,240,256,758,4548
2016-05-26 11:40:00,273,234,240,747,4482
2016-05-26 11:50:00,305,279,298,882,5292
2016-05-26 12:00:00,369,341,361,1071,6426
2016-05-26 12:10:00,279,255,273,807,4842
2016-05-26 12:20:00,245,228,252,725,4350
2016-05-26 12:30:00,234,207,226,667,4002
2016-05-26 12:40:00,269,238,259,766,4596
2016-05-26 12:50:00,293,268,286,847,5082
2016-05-26 13:00:00,305,276,298,879,5274
2016-05-26 13:10:00,287,259,280,826,4956
2016-05-26 13:20:00,296,271,290,857,5142
2016-05-26 13:30:00,324,295,315,934,5604
2016-05-26 13:40:00,273,247,265,785,4710
2016-05-26 13:50:00,245,220,239,704,4224
2016-05-26 14:00:00,291,267,285,843,5058
2016-05-26 14:10:00,343,321,336,1000,6000
2016-05-26 14:20:00,515,495,506,1516,9096
2016-05-26 14:30:00,526,506,519,1551,9306
2016-05-26 14:40:00,372,347,364,1083,6498
2016-05-26 14:50:00,657,627,642,1926,11556
2016-05-26 15:00:00,447,423,437,1307,7842
2016-05-26 15:10:00,410,389,402,1201,7206
2016-05-26 15:20:00,587,569,579,1735,10410
2016-05-26 15:30:00,809,791,809,2409,14454
2016-05-26 15:40:00,706,684,700,2090,12540
2016-05-26 15:50:00,510,492,502,1504,9024
2016-05-26 16:00:00,497,472,490,1459,8754
2016-05-26 16:10:00,449,424,443,1316,7896
2016-05-26 16:20:00,660,638,661,1959,11754
2016-05-26 16:30:00,774,741,768,2283,13698
2016-05-26 16:40:00,680,655,681,2016,12096
2016-05-26 16:50:00,639,616,638,1893,11358
2016-05-26 17:00:00,631,608,630,1869,11214
2016-05-26 17:10:00,582,565,582,1729,10374
2016-05-26 17:20:00,538,511,539,1588,9528
2016-05-26 17:30:00,500,470,494,1464,8784
2016-05-26 17:40:00,453,428,450,1331,7986
2016-05-26 17:50:00,400,369,392,1161,6966
2016-05-26 18:00:00,351,325,348,1024,6144
2016-05-26 18:10:00,307,286,307,900,5400
2016-05-26 18:20:00,259,233,256,748,4488
2016-05-26 18:30:00,221,195,214,630,3780
2016-05-26 18:40:00,182,31,289,502,3012
2016-05-26 18:50:00,104,107,180,391,2346
2016-05-26 19:00:00,3,142,150,295,1770
2016-05-26 19:10:00,44,82,87,213,1278
2016-05-26 19:20:00,26,63,69,158,948
2016-05-26 19:30:00,31,45,62,138,828
2016-05-26 19:40:00,30,27,64,121,726
2016-05-26 19:50:00,38,12,50,100,600
2016-05-26 20:00:00,39,10,51,100,600
2016-05-26 20:10:00,27,13,47,87,522
2016-05-26 20:20:00,24,13,45,82,492
2016-05-26 20:30:00,13,16,44,73,438
2016-05-26 20:40:00,20,12,29,61,366
2016-05-26 20:50:00,18,11,16,45,270
2016-05-26 21:00:00,8,6,12,26,156
2016-05-26 21:10:00,3,2,4,9,54
2016-05-26 21:20:00,0,0,0,0,0
2016-05-26 21:30:00,0,0,0,0,0
2016-05-26 21:40:00,0,0,0,0,0
2016-05-26 21:50:00,0,0,0,0,0
2016-05-27 04:10:00,0,0,0,0,0
2016-05-27 04:20:00,0,0,0,0,0
2016-05-27 04:30:00,0,0,0,0,0
2016-05-27 04:40:00,0,0,0,0,0
2016-05-27 04:50:00,1,1,2,4,24
2016-05-27 05:00:00,7,1,10,18,108
2016-05-27 05:10:00,11,3,16,30,180
2016-05-27 05:20:00,18,5,19,42,252
2016-05-27 05:30:00,22,6,25,53,318
2016-05-27 05:40:00,23,8,33,64,384
2016-05-27 05:50:00,26,7,40,73,438
2016-05-27 06:00:00,23,17,43,83,498
2016-05-27 06:10:00,28,18,50,96,576
2016-05-27 06:20:00,29,25,54,108,648
2016-05-27 06:30:00,27,19,75,121,726
2016-05-27 06:40:00,32,37,65,134,804
2016-05-27 06:50:00,35,46,65,146,876
2016-05-27 07:00:00,38,54,64,156,936
2016-05-27 07:10:00,60,65,74,199,1194
2016-05-27 07:20:00,74,114,150,338,2028
2016-05-27 07:30:00,119,132,197,448,2688
2016-05-27 07:40:00,183,105,292,580,3480
2016-05-27 07:50:00,239,203,274,716,4296
2016-05-27 08:00:00,297,272,294,863,5178
2016-05-27 08:10:00,348,323,348,1019,6114
2016-05-27 08:20:00,401,377,396,1174,7044
2016-05-27 08:30:00,454,430,447,1331,7986
2016-05-27 08:40:00,509,482,501,1492,8952
2016-05-27 08:50:00,556,532,553,1641,9846
2016-05-27 09:00:00,612,580,615,1807,10842
2016-05-27 09:10:00,663,629,660,1952,11712
2016-05-27 09:20:00,703,672,698,2073,12438
2016-05-27 09:30:00,743,712,741,2196,13176
2016-05-27 09:40:00,773,760,792,2325,13950
2016-05-27 09:50:00,803,792,816,2411,14466
2016-05-27 10:00:00,827,824,840,2491,14946
2016-05-27 10:10:00,864,849,868,2581,15486
2016-05-27 10:20:00,886,874,887,2647,15882
2016-05-27 10:30:00,915,898,908,2721,16326
2016-05-27 10:40:00,956,929,945,2830,16980
2016-05-27 10:50:00,720,688,710,2118,12708
2016-05-27 11:00:00,992,951,986,2929,17574
2016-05-27 11:10:00,662,627,653,1942,11652
2016-05-27 11:20:00,971,926,958,2855,17130
2016-05-27 11:30:00,1056,1018,1042,3116,18696
2016-05-27 11:40:00,1065,1034,1047,3146,18876
2016-05-27 11:50:00,1059,1036,1046,3141,18846
2016-05-27 12:00:00,1073,1044,1067,3184,19104
2016-05-27 12:10:00,1030,1005,1023,3058,18348
2016-05-27 12:20:00,950,923,947,2820,16920
2016-05-27 12:30:00,1131,1105,1118,3354,20124
2016-05-27 12:40:00,1096,1069,1096,3261,19566
2016-05-27 12:50:00,1091,1073,1089,3253,19518
2016-05-27 13:00:00,1101,1080,1089,3270,19620
2016-05-27 13:10:00,1086,1067,1082,3235,19410
2016-05-27 13:20:00,1090,1072,1068,3230,19380
2016-05-27 13:30:00,1083,1048,1064,3195,19170
2016-05-27 13:40:00,1069,1039,1055,3163,18978
2016-05-27 13:50:00,1063,1048,1054,3165,18990
2016-05-27 14:00:00,1066,1047,1052,3165,18990
2016-05-27 14:10:00,1048,1049,1053,3150,18900
2016-05-27 14:20:00,1062,1053,1056,3171,19026
2016-05-27 14:30:00,1037,1013,1019,3069,18414
2016-05-27 14:40:00,1010,991,1002,3003,18018
2016-05-27 14:50:00,993,969,982,2944,17664
2016-05-27 15:00:00,972,949,963,2884,17304
2016-05-27 15:10:00,949,924,944,2817,16902
2016-05-27 15:20:00,928,897,918,2743,16458
2016-05-27 15:30:00,905,878,902,2685,16110
2016-05-27 15:40:00,893,847,882,2622,15732
2016-05-27 15:50:00,860,827,851,2538,15228
2016-05-27 16:00:00,826,805,819,2450,14700
2016-05-27 16:10:00,800,776,786,2362,14172
2016-05-27 16:20:00,770,744,760,2274,13644
2016-05-27 16:30:00,729,705,721,2155,12930
2016-05-27 16:40:00,690,669,686,2045,12270
2016-05-27 16:50:00,653,637,652,1942,11652
2016-05-27 17:00:00,606,587,604,1797,10782
2016-05-27 17:10:00,565,544,567,1676,10056
2016-05-27 17:20:00,523,504,523,1550,9300
2016-05-27 17:30:00,474,455,474,1403,8418
2016-05-27 17:40:00,434,415,435,1284,7704
2016-05-27 17:50:00,359,339,357,1055,6330
2016-05-27 18:00:00,322,302,320,944,5664
2016-05-27 18:10:00,206,185,201,592,3552
2016-05-27 18:20:00,180,160,176,516,3096
2016-05-27 18:30:00,157,137,155,449,2694
2016-05-27 18:40:00,170,127,169,466,2796
2016-05-27 18:50:00,139,119,138,396,2376
2016-05-27 19:00:00,108,86,98,292,1752
2016-05-27 19:10:00,81,62,73,216,1296
2016-05-27 19:20:00,58,52,53,163,978
2016-05-27 19:30:00,51,46,54,151,906
2016-05-27 19:40:00,26,27,81,134,804
2016-05-27 19:50:00,36,33,63,132,792
2016-05-27 20:00:00,64,57,54,175,1050
2016-05-27 20:10:00,32,27,77,136,816
2016-05-27 20:20:00,36,32,65,133,798
2016-05-27 20:30:00,29,28,49,106,636
2016-05-27 20:40:00,23,20,25,68,408
2016-05-27 20:50:00,17,15,19,51,306
2016-05-27 21:00:00,8,9,9,26,156
2016-05-27 21:10:00,3,3,3,9,54
2016-05-27 21:20:00,0,0,0,0,0
2016-05-27 21:30:00,0,0,0,0,0
2016-05-27 21:40:00,0,0,0,0,0
2016-05-27 21:50:00,0,0,0,0,0
2016-05-27 22:00:00,0,0,0,0,0
2016-05-28 04:10:00,0,0,0,0,0
2016-05-28 04:20:00,0,0,0,0,0
2016-05-28 04:30:00,0,0,0,0,0
2016-05-28 04:40:00,0,0,0,0,0
2016-05-28 04:50:00,2,2,3,7,42
2016-05-28 05:00:00,15,9,22,46,276
2016-05-28 05:10:00,19,13,43,75,450
2016-05-28 05:20:00,20,9,34,63,378
2016-05-28 05:30:00,24,9,40,73,438
2016-05-28 05:40:00,28,24,55,107,642
2016-05-28 05:50:00,39,44,61,144,864
2016-05-28 06:00:00,64,63,77,204,1224
2016-05-28 06:10:00,89,69,104,262,1572
2016-05-28 06:20:00,61,92,102,255,1530
2016-05-28 06:30:00,67,71,84,222,1332
2016-05-28 06:40:00,73,83,101,257,1542
2016-05-28 06:50:00,80,94,66,240,1440
2016-05-28 07:00:00,82,82,81,245,1470
2016-05-28 07:10:00,82,85,86,253,1518
2016-05-28 07:20:00,132,104,170,406,2436
2016-05-28 07:30:00,258,133,152,543,3258
2016-05-28 07:40:00,153,169,200,522,3132
2016-05-28 07:50:00,194,173,188,555,3330
2016-05-28 08:00:00,164,144,161,469,2814
2016-05-28 08:10:00,329,311,333,973,5838
2016-05-28 08:20:00,366,344,367,1077,6462
2016-05-28 08:30:00,440,421,439,1300,7800
2016-05-28 08:40:00,395,375,391,1161,6966
2016-05-28 08:50:00,455,434,450,1339,8034
2016-05-28 09:00:00,578,553,569,1700,10200
2016-05-28 09:10:00,667,640,656,1963,11778
2016-05-28 09:20:00,624,599,610,1833,10998
2016-05-28 09:30:00,709,679,694,2082,12492
2016-05-28 09:40:00,717,692,712,2121,12726
2016-05-28 09:50:00,809,783,800,2392,14352
2016-05-28 10:00:00,814,792,817,2423,14538
2016-05-28 10:10:00,804,781,809,2394,14364
2016-05-28 10:20:00,859,858,880,2597,15582
2016-05-28 10:30:00,822,804,827,2453,14718
2016-05-28 10:40:00,959,938,967,2864,17184
2016-05-28 10:50:00,918,897,915,2730,16380
2016-05-28 11:00:00,1049,1017,1048,3114,18684
2016-05-28 11:10:00,1052,1021,1052,3125,18750
2016-05-28 11:20:00,1005,982,1009,2996,17976
2016-05-28 11:30:00,1018,996,1023,3037,18222
2016-05-28 11:40:00,720,695,721,2136,12816
2016-05-28 11:50:00,542,518,541,1601,9606
2016-05-28 12:00:00,892,870,900,2662,15972
2016-05-28 12:10:00,1108,1083,1109,3300,19800
2016-05-28 12:20:00,1060,1029,1051,3140,18840
2016-05-28 12:30:00,1118,1085,1110,3313,19878
2016-05-28 12:40:00,1078,1056,1074,3208,19248
2016-05-28 12:50:00,1068,1044,1070,3182,19092
2016-05-28 13:00:00,1063,1035,1060,3158,18948
2016-05-28 13:10:00,1075,1051,1074,3200,19200
2016-05-28 13:20:00,1004,987,1011,3002,18012
2016-05-28 13:30:00,1012,987,1007,3006,18036
2016-05-28 13:40:00,1069,1041,1058,3168,19008
2016-05-28 13:50:00,981,955,952,2888,17328
2016-05-28 14:00:00,696,667,688,2051,12306
2016-05-28 14:10:00,945,920,939,2804,16824
2016-05-28 14:20:00,1013,974,994,2981,17886
2016-05-28 14:30:00,867,823,849,2539,15234
2016-05-28 14:40:00,950,913,938,2801,16806
2016-05-28 14:50:00,804,773,779,2356,14136
2016-05-28 15:00:00,806,775,778,2359,14154
2016-05-28 15:10:00,927,894,914,2735,16410
2016-05-28 15:20:00,929,890,921,2740,16440
2016-05-28 15:30:00,898,870,895,2663,15978
2016-05-28 15:40:00,878,850,870,2598,15588
2016-05-28 15:50:00,861,821,846,2528,15168
2016-05-28 16:00:00,839,803,826,2468,14808
2016-05-28 16:10:00,814,780,802,2396,14376
2016-05-28 16:20:00,592,562,581,1735,10410
2016-05-28 16:30:00,510,479,499,1488,8928
2016-05-28 16:40:00,564,528,551,1643,9858
2016-05-28 16:50:00,736,690,714,2140,12840
2016-05-28 17:00:00,609,572,587,1768,10608
2016-05-28 17:10:00,351,324,339,1014,6084
2016-05-28 17:20:00,298,271,288,857,5142
2016-05-28 17:30:00,193,170,186,549,3294
2016-05-28 17:40:00,176,152,168,496,2976
2016-05-28 17:50:00,173,158,158,489,2934
2016-05-28 18:00:00,263,231,250,744,4464
2016-05-28 18:10:00,314,286,306,906,5436
2016-05-28 18:20:00,199,175,191,565,3390
2016-05-28 18:30:00,204,179,195,578,3468
2016-05-28 18:40:00,178,154,171,503,3018
2016-05-28 18:50:00,145,121,139,405,2430
2016-05-28 19:00:00,125,107,78,310,1860
2016-05-28 19:10:00,81,80,80,241,1446
2016-05-28 19:20:00,91,95,104,290,1740
2016-05-28 19:30:00,55,103,105,263,1578
2016-05-28 19:40:00,44,61,67,172,1032
2016-05-28 19:50:00,29,39,65,133,798
2016-05-28 20:00:00,13,12,86,111,666
2016-05-28 20:10:00,11,29,52,92,552
2016-05-28 20:20:00,9,22,45,76,456
2016-05-28 20:30:00,12,13,35,60,360
2016-05-28 20:40:00,12,10,23,45,270
2016-05-28 20:50:00,11,5,13,29,174
2016-05-28 21:00:00,7,2,8,17,102
2016-05-28 21:10:00,2,2,2,6,36
2016-05-28 21:20:00,0,0,0,0,0
2016-05-28 21:30:00,0,0,0,0,0
2016-05-28 21:40:00,0,0,0,0,0
2016-05-28 21:50:00,0,0,0,0,0
2016-05-28 22:00:00,0,0,0,0,0
2016-05-29 04:10:00,0,0,0,0,0
2016-05-29 04:20:00,0,0,0,0,0
2016-05-29 04:30:00,0,0,0,0,0
2016-05-29 04:40:00,0,0,0,0,0
2016-05-29 04:50:00,0,0,0,0,0
2016-05-29 05:00:00,0,3,0,3,18
2016-05-29 05:10:00,3,5,5,13,78
2016-05-29 05:20:00,9,11,18,38,228
2016-05-29 05:30:00,17,11,38,66,396
2016-05-29 05:40:00,14,11,55,80,480
2016-05-29 05:50:00,28,19,49,96,576
2016-05-29 06:00:00,26,24,61,111,666
2016-05-29 06:10:00,16,26,82,124,744
2016-05-29 06:20:00,37,39,70,146,876
2016-05-29 06:30:00,22,69,86,177,1062
2016-05-29 06:40:00,14,83,95,192,1152
2016-05-29 06:50:00,43,75,94,212,1272
2016-05-29 07:00:00,64,80,89,233,1398
2016-05-29 07:10:00,57,96,96,249,1494
2016-05-29 07:20:00,14,140,144,298,1788
2016-05-29 07:30:00,87,156,171,414,2484
2016-05-29 07:40:00,224,80,226,530,3180
2016-05-29 07:50:00,275,167,191,633,3798
2016-05-29 08:00:00,258,232,259,749,4494
2016-05-29 08:10:00,326,302,317,945,5670
2016-05-29 08:20:00,371,347,361,1079,6474
2016-05-29 08:30:00,411,386,405,1202,7212
2016-05-29 08:40:00,342,318,337,997,5982
2016-05-29 08:50:00,535,507,530,1572,9432
2016-05-29 09:00:00,575,547,572,1694,10164
2016-05-29 09:10:00,629,599,621,1849,11094
2016-05-29 09:20:00,663,637,656,1956,11736
2016-05-29 09:30:00,683,669,691,2043,12258
2016-05-29 09:40:00,736,724,740,2200,13200
2016-05-29 09:50:00,767,745,760,2272,13632
2016-05-29 10:00:00,760,734,754,2248,13488
2016-05-29 10:10:00,810,784,804,2398,14388
2016-05-29 10:20:00,748,724,746,2218,13308
2016-05-29 10:30:00,665,643,663,1971,11826
2016-05-29 10:40:00,782,756,777,2315,13890
2016-05-29 10:50:00,943,911,937,2791,16746
2016-05-29 11:00:00,950,925,948,2823,16938
2016-05-29 11:10:00,970,952,968,2890,17340
2016-05-29 11:20:00,993,972,984,2949,17694
2016-05-29 11:30:00,983,962,976,2921,17526
2016-05-29 11:40:00,1007,986,1008,3001,18006
2016-05-29 11:50:00,1026,1007,1028,3061,18366
2016-05-29 12:00:00,1031,1007,1022,3060,18360
2016-05-29 12:10:00,1049,1027,1039,3115,18690
2016-05-29 12:20:00,1037,1017,1032,3086,18516
2016-05-29 12:30:00,1047,1023,1046,3116,18696
2016-05-29 12:40:00,1052,1034,1053,3139,18834
2016-05-29 12:50:00,718,696,716,2130,12780
2016-05-29 13:00:00,718,697,708,2123,12738
2016-05-29 13:10:00,1067,1048,1065,3180,19080
2016-05-29 13:20:00,854,832,852,2538,15228
2016-05-29 13:30:00,830,807,823,2460,14760
2016-05-29 13:40:00,717,701,716,2134,12804
2016-05-29 13:50:00,805,784,798,2387,14322
2016-05-29 14:00:00,687,664,678,2029,12174
2016-05-29 14:10:00,656,631,647,1934,11604
2016-05-29 14:20:00,541,521,534,1596,9576
2016-05-29 14:30:00,437,411,425,1273,7638
2016-05-29 14:40:00,379,355,371,1105,6630
2016-05-29 14:50:00,360,335,352,1047,6282
2016-05-29 15:00:00,338,315,329,982,5892
2016-05-29 15:10:00,310,288,303,901,5406
2016-05-29 15:20:00,314,292,309,915,5490
2016-05-29 15:30:00,371,347,362,1080,6480
2016-05-29 15:40:00,337,312,327,976,5856
2016-05-29 15:50:00,311,287,304,902,5412
2016-05-29 16:00:00,348,326,342,1016,6096
2016-05-29 16:10:00,535,512,524,1571,9426
2016-05-29 16:20:00,513,493,507,1513,9078
2016-05-29 16:30:00,441,417,437,1295,7770
2016-05-29 16:40:00,579,543,572,1694,10164
2016-05-29 16:50:00,661,636,650,1947,11682
2016-05-29 17:00:00,561,535,553,1649,9894
2016-05-29 17:10:00,353,327,345,1025,6150
2016-05-29 17:20:00,406,379,399,1184,7104
2016-05-29 17:30:00,407,381,404,1192,7152
2016-05-29 17:40:00,267,241,261,769,4614
2016-05-29 17:50:00,255,234,252,741,4446
2016-05-29 18:00:00,260,238,258,756,4536
2016-05-29 18:10:00,179,114,223,516,3096
2016-05-29 18:20:00,64,151,157,372,2232
2016-05-29 18:30:00,96,118,136,350,2100
2016-05-29 18:40:00,102,103,116,321,1926
2016-05-29 18:50:00,55,120,119,294,1764
2016-05-29 19:00:00,90,57,109,256,1536
2016-05-29 19:10:00,45,52,82,179,1074
2016-05-29 19:20:00,26,29,77,132,792
2016-05-29 19:30:00,19,19,41,79,474
2016-05-29 19:40:00,7,9,12,28,168
2016-05-29 19:50:00,2,9,5,16,96
2016-05-29 20:00:00,6,7,4,17,102
2016-05-29 20:10:00,4,3,5,12,72
2016-05-29 20:20:00,21,13,29,63,378
2016-05-29 20:30:00,14,9,14,37,222
2016-05-29 20:40:00,11,10,9,30,180
2016-05-29 20:50:00,6,4,7,17,102
2016-05-29 21:00:00,4,4,5,13,78
2016-05-29 21:10:00,0,0,0,0,0
2016-05-29 21:20:00,0,0,0,0,0
2016-05-29 21:30:00,0,0,0,0,0
2016-05-29 21:40:00,0,0,0,0,0
2016-05-29 21:50:00,0,0,0,0,0
2016-05-30 04:10:00,0,0,0,0,0
2016-05-30 04:20:00,0,0,0,0,0
2016-05-30 04:30:00,0,0,0,0,0
2016-05-30 04:40:00,0,0,0,0,0
2016-05-30 04:50:00,0,0,0,0,0
2016-05-30 05:00:00,0,0,0,0,0
2016-05-30 05:10:00,0,0,0,0,0
2016-05-30 05:20:00,0,0,0,0,0
2016-05-30 05:30:00,0,0,0,0,0
2016-05-30 05:40:00,0,0,0,0,0
2016-05-30 05:50:00,1,0,1,2,12
2016-05-30 06:00:00,5,1,5,11,66
2016-05-30 06:10:00,11,4,13,28,168
2016-05-30 06:20:00,22,26,46,94,564
2016-05-30 06:30:00,23,21,75,119,714
2016-05-30 06:40:00,28,22,58,108,648
2016-05-30 06:50:00,31,27,61,119,714
2016-05-30 07:00:00,31,54,47,132,792
2016-05-30 07:10:00,32,36,51,119,714
2016-05-30 07:20:00,36,33,67,136,816
2016-05-30 07:30:00,52,47,71,170,1020
2016-05-30 07:40:00,54,51,59,164,984
2016-05-30 07:50:00,64,72,83,219,1314
2016-05-30 08:00:00,70,70,81,221,1326
2016-05-30 08:10:00,58,61,76,195,1170
2016-05-30 08:20:00,50,45,78,173,1038
2016-05-30 08:30:00,66,88,99,253,1518
2016-05-30 08:40:00,134,102,134,370,2220
2016-05-30 08:50:00,63,117,126,306,1836
2016-05-30 09:00:00,92,75,105,272,1632
2016-05-30 09:10:00,199,174,195,568,3408
2016-05-30 09:20:00,183,151,211,545,3270
2016-05-30 09:30:00,276,251,270,797,4782
2016-05-30 09:40:00,257,234,250,741,4446
2016-05-30 09:50:00,238,216,232,686,4116
2016-05-30 10:00:00,294,272,289,855,5130
2016-05-30 10:10:00,353,333,354,1040,6240
2016-05-30 10:20:00,324,302,322,948,5688
2016-05-30 10:30:00,252,230,248,730,4380
2016-05-30 10:40:00,320,299,319,938,5628
2016-05-30 10:50:00,276,256,273,805,4830
2016-05-30 11:00:00,260,238,257,755,4530
2016-05-30 11:10:00,321,302,319,942,5652
2016-05-30 11:20:00,349,333,352,1034,6204
2016-05-30 11:30:00,357,337,354,1048,6288
2016-05-30 11:40:00,593,575,593,1761,10566
2016-05-30 11:50:00,835,821,842,2498,14988
2016-05-30 12:00:00,1030,1008,1034,3072,18432
2016-05-30 12:10:00,963,940,961,2864,17184
2016-05-30 12:20:00,1057,1047,1060,3164,18984
2016-05-30 12:30:00,1057,1040,1055,3152,18912
2016-05-30 12:40:00,1045,1032,1042,3119,18714
2016-05-30 12:50:00,1031,1015,1028,3074,18444
2016-05-30 13:00:00,1030,1017,1023,3070,18420
2016-05-30 13:10:00,1044,1022,1030,3096,18576
2016-05-30 13:20:00,1034,1017,1024,3075,18450
2016-05-30 13:30:00,1029,1009,1020,3058,18348
2016-05-30 13:40:00,1015,1003,1014,3032,18192
2016-05-30 13:50:00,1020,999,1013,3032,18192
2016-05-30 14:00:00,1009,987,998,2994,17964
2016-05-30 14:10:00,992,972,977,2941,17646
2016-05-30 14:20:00,985,971,977,2933,17598
2016-05-30 14:30:00,974,959,965,2898,17388
2016-05-30 14:40:00,958,948,955,2861,17166
2016-05-30 14:50:00,943,936,945,2824,16944
2016-05-30 15:00:00,933,917,932,2782,16692
2016-05-30 15:10:00,921,893,921,2735,16410
2016-05-30 15:20:00,894,877,906,2677,16062
2016-05-30 15:30:00,878,855,882,2615,15690
2016-05-30 15:40:00,856,831,862,2549,15294
2016-05-30 15:50:00,833,810,824,2467,14802
2016-05-30 16:00:00,807,787,806,2400,14400
2016-05-30 16:10:00,774,761,776,2311,13866
2016-05-30 16:20:00,746,730,744,2220,13320
2016-05-30 16:30:00,703,689,703,2095,12570
2016-05-30 16:40:00,664,652,665,1981,11886
2016-05-30 16:50:00,629,610,632,1871,11226
2016-05-30 17:00:00,591,568,590,1749,10494
2016-05-30 17:10:00,547,530,547,1624,9744
2016-05-30 17:20:00,511,488,513,1512,9072
2016-05-30 17:30:00,464,440,465,1369,8214
2016-05-30 17:40:00,423,402,425,1250,7500
2016-05-30 17:50:00,369,352,374,1095,6570
2016-05-30 18:00:00,331,313,334,978,5868
2016-05-30 18:10:00,290,268,288,846,5076
2016-05-30 18:20:00,243,224,240,707,4242
2016-05-30 18:30:00,207,186,203,596,3576
2016-05-30 18:40:00,184,25,275,484,2904
2016-05-30 18:50:00,120,134,126,380,2280
2016-05-30 19:00:00,123,127,45,295,1770
2016-05-30 19:10:00,66,78,71,215,1290
2016-05-30 19:20:00,61,38,62,161,966
2016-05-30 19:30:00,46,44,53,143,858
2016-05-30 19:40:00,34,32,60,126,756
2016-05-30 19:50:00,20,19,76,115,690
2016-05-30 20:00:00,27,29,47,103,618
2016-05-30 20:10:00,29,31,32,92,552
2016-05-30 20:20:00,31,22,28,81,486
2016-05-30 20:30:00,21,14,33,68,408
2016-05-30 20:40:00,16,16,23,55,330
2016-05-30 20:50:00,11,12,17,40,240
2016-05-30 21:00:00,8,8,9,25,150
2016-05-30 21:10:00,3,3,5,11,66
2016-05-30 21:20:00,0,0,0,0,0
2016-05-30 21:30:00,0,0,0,0,0
2016-05-30 21:40:00,0,0,0,0,0
2016-05-30 21:50:00,0,0,0,0,0
2016-05-30 22:00:00,0,0,0,0,0
2016-05-31 04:00:00,0,0,0,0,0
2016-05-31 04:10:00,0,0,0,0,0
2016-05-31 04:20:00,0,0,0,0,0
2016-05-31 04:30:00,0,0,0,0,0
2016-05-31 04:40:00,1,1,1,3,18
2016-05-31 04:50:00,4,6,7,17,102
2016-05-31 05:00:00,7,5,10,22,132
2016-05-31 05:10:00,7,6,11,24,144
2016-05-31 05:20:00,14,8,19,41,246
2016-05-31 05:30:00,18,13,36,67,402
2016-05-31 05:40:00,29,13,43,85,510
2016-05-31 05:50:00,25,10,28,63,378
2016-05-31 06:00:00,19,11,16,46,276
2016-05-31 06:10:00,13,11,18,42,252
2016-05-31 06:20:00,11,8,16,35,210
2016-05-31 06:30:00,13,11,26,50,300
2016-05-31 06:40:00,43,38,57,138,828
2016-05-31 06:50:00,68,89,97,254,1524
2016-05-31 07:00:00,56,122,135,313,1878
2016-05-31 07:10:00,61,94,82,237,1422
2016-05-31 07:20:00,42,138,152,332,1992
2016-05-31 07:30:00,80,130,149,359,2154
2016-05-31 07:40:00,113,72,167,352,2112
2016-05-31 07:50:00,142,161,177,480,2880
2016-05-31 08:00:00,254,227,249,730,4380
2016-05-31 08:10:00,304,282,303,889,5334
2016-05-31 08:20:00,354,333,354,1041,6246
2016-05-31 08:30:00,410,391,412,1213,7278
2016-05-31 08:40:00,429,408,429,1266,7596
2016-05-31 08:50:00,275,200,224,699,4194
2016-05-31 09:00:00,243,211,258,712,4272
2016-05-31 09:10:00,162,178,176,516,3096
2016-05-31 09:20:00,157,96,184,437,2622
2016-05-31 09:30:00,282,249,247,778,4668
2016-05-31 09:40:00,412,393,410,1215,7290
2016-05-31 09:50:00,283,261,277,821,4926
2016-05-31 10:00:00,228,203,220,651,3906
2016-05-31 10:10:00,311,288,307,906,5436
2016-05-31 10:20:00,277,258,279,814,4884
2016-05-31 10:30:00,284,266,287,837,5022
2016-05-31 10:40:00,373,351,367,1091,6546
2016-05-31 10:50:00,412,393,413,1218,7308
2016-05-31 11:00:00,120,99,116,335,2010
2016-05-31 11:10:00,118,157,149,424,2544
2016-05-31 11:20:00,195,163,184,542,3252
2016-05-31 11:30:00,189,246,168,603,3618
2016-05-31 11:40:00,226,222,234,682,4092
2016-05-31 11:50:00,292,269,287,848,5088
2016-05-31 12:00:00,303,279,298,880,5280
2016-05-31 12:10:00,402,381,397,1180,7080
2016-05-31 12:20:00,649,624,639,1912,11472
2016-05-31 12:30:00,865,841,856,2562,15372
2016-05-31 12:40:00,944,913,933,2790,16740
2016-05-31 12:50:00,1016,980,1000,2996,17976
2016-05-31 13:00:00,1035,1012,1024,3071,18426
2016-05-31 13:10:00,1074,1046,1061,3181,19086
2016-05-31 13:20:00,621,602,616,1839,11034
2016-05-31 13:30:00,376,356,369,1101,6606
2016-05-31 13:40:00,224,204,217,645,3870
2016-05-31 13:50:00,139,93,136,368,2208
2016-05-31 14:00:00,112,30,115,257,1542
2016-05-31 14:10:00,82,83,92,257,1542
2016-05-31 14:20:00,116,47,132,295,1770
2016-05-31 14:30:00,96,98,114,308,1848
2016-05-31 14:40:00,178,71,160,409,2454
2016-05-31 14:50:00,238,213,148,599,3594
2016-05-31 15:00:00,303,281,298,882,5292
2016-05-31 15:10:00,350,331,349,1030,6180
2016-05-31 15:20:00,918,901,918,2737,16422
2016-05-31 15:30:00,857,835,850,2542,15252
2016-05-31 15:40:00,279,258,272,809,4854
2016-05-31 15:50:00,240,216,231,687,4122
2016-05-31 16:00:00,402,375,393,1170,7020
2016-05-31 16:10:00,873,849,865,2587,15522
2016-05-31 16:20:00,449,428,441,1318,7908
2016-05-31 16:30:00,349,327,342,1018,6108
2016-05-31 16:40:00,387,369,384,1140,6840
2016-05-31 16:50:00,550,526,547,1623,9738
2016-05-31 17:00:00,270,247,266,783,4698
2016-05-31 17:10:00,342,322,343,1007,6042
2016-05-31 17:20:00,490,469,490,1449,8694
2016-05-31 17:30:00,386,363,384,1133,6798
2016-05-31 17:40:00,395,374,394,1163,6978
2016-05-31 17:50:00,388,364,382,1134,6804
2016-05-31 18:00:00,327,309,328,964,5784
2016-05-31 18:10:00,284,261,281,826,4956
2016-05-31 18:20:00,209,199,262,670,4020
2016-05-31 18:30:00,126,319,180,625,3750
2016-05-31 18:40:00,191,156,276,623,3738
2016-05-31 18:50:00,127,122,124,373,2238
2016-05-31 19:00:00,94,129,109,332,1992
2016-05-31 19:10:00,102,123,91,316,1896
2016-05-31 19:20:00,99,99,82,280,1680
2016-05-31 19:30:00,110,114,54,278,1668
2016-05-31 19:40:00,87,84,126,297,1782
2016-05-31 19:50:00,81,89,87,257,1542
2016-05-31 20:00:00,61,62,69,192,1152
2016-05-31 20:10:00,23,26,48,97,582
2016-05-31 20:20:00,19,21,19,59,354
2016-05-31 20:30:00,14,17,22,53,318
2016-05-31 20:40:00,10,12,13,35,210
2016-05-31 20:50:00,7,6,9,22,132
2016-05-31 21:00:00,5,5,7,17,102
2016-05-31 21:10:00,2,1,3,6,36
2016-05-31 21:20:00,0,0,0,0,0
2016-05-31 21:30:00,0,0,0,0,0
2016-05-31 21:40:00,0,0,0,0,0
2016-05-31 21:50:00,0,0,0,0,0
2016-05-31 22:00:00,0,0,0,0,0
2016-06-01 04:10:00,0,0,0,0,0
2016-06-01 04:20:00,0,0,0,0,0
2016-06-01 04:30:00,0,0,0,0,0
2016-06-01 04:40:00,0,0,0,0,0
2016-06-01 04:50:00,0,0,0,0,0
2016-06-01 05:00:00,1,1,2,4,24
2016-06-01 05:10:00,4,4,6,14,84
2016-06-01 05:20:00,6,7,10,23,138
2016-06-01 05:30:00,9,8,11,28,168
2016-06-01 05:40:00,11,11,14,36,216
2016-06-01 05:50:00,19,10,19,48,288
2016-06-01 06:00:00,19,12,27,58,348
2016-06-01 06:10:00,21,15,32,68,408
2016-06-01 06:20:00,26,21,45,92,552
2016-06-01 06:30:00,41,40,57,138,828
2016-06-01 06:40:00,49,48,63,160,960
2016-06-01 06:50:00,57,67,72,196,1176
2016-06-01 07:00:00,85,93,115,293,1758
2016-06-01 07:10:00,65,129,164,358,2148
2016-06-01 07:20:00,63,217,160,440,2640
2016-06-01 07:30:00,172,35,297,504,3024
2016-06-01 07:40:00,125,98,264,487,2922
2016-06-01 07:50:00,190,263,213,666,3996
2016-06-01 08:00:00,206,184,203,593,3558
2016-06-01 08:10:00,197,125,322,644,3864
2016-06-01 08:20:00,192,118,315,625,3750
2016-06-01 08:30:00,219,171,241,631,3786
2016-06-01 08:40:00,221,200,219,640,3840
2016-06-01 08:50:00,176,266,204,646,3876
2016-06-01 09:00:00,123,361,197,681,4086
2016-06-01 09:10:00,165,124,330,619,3714
2016-06-01 09:20:00,191,126,333,650,3900
2016-06-01 09:30:00,286,265,289,840,5040
2016-06-01 09:40:00,375,352,370,1097,6582
2016-06-01 09:50:00,431,412,429,1272,7632
2016-06-01 10:00:00,457,436,455,1348,8088
2016-06-01 10:10:00,794,798,816,2408,14448
2016-06-01 10:20:00,938,952,964,2854,17124
2016-06-01 10:30:00,872,860,870,2602,15612
2016-06-01 10:40:00,927,916,913,2756,16536
2016-06-01 10:50:00,932,923,936,2791,16746
2016-06-01 11:00:00,944,921,940,2805,16830
2016-06-01 11:10:00,818,807,828,2453,14718
2016-06-01 11:20:00,863,856,876,2595,15570
2016-06-01 11:30:00,679,670,681,2030,12180
2016-06-01 11:40:00,440,422,429,1291,7746
2016-06-01 11:50:00,479,457,466,1402,8412
2016-06-01 12:00:00,512,488,506,1506,9036
2016-06-01 12:10:00,700,679,693,2072,12432
2016-06-01 12:20:00,1027,1008,1021,3056,18336
2016-06-01 12:30:00,959,942,956,2857,17142
2016-06-01 12:40:00,989,968,987,2944,17664
2016-06-01 12:50:00,1047,1012,1049,3108,18648
2016-06-01 13:00:00,947,880,957,2784,16704
2016-06-01 13:10:00,924,864,928,2716,16296
2016-06-01 13:20:00,971,950,967,2888,17328
2016-06-01 13:30:00,958,893,974,2825,16950
2016-06-01 13:40:00,788,748,785,2321,13926
2016-06-01 13:50:00,851,823,841,2515,15090
2016-06-01 14:00:00,910,833,915,2658,15948
2016-06-01 14:10:00,968,915,975,2858,17148
2016-06-01 14:20:00,797,754,815,2366,14196
2016-06-01 14:30:00,915,899,912,2726,16356
2016-06-01 14:40:00,914,892,905,2711,16266
2016-06-01 14:50:00,777,748,766,2291,13746
2016-06-01 15:00:00,756,683,758,2197,13182
2016-06-01 15:10:00,935,859,944,2738,16428
2016-06-01 15:20:00,888,865,878,2631,15786
2016-06-01 15:30:00,864,844,859,2567,15402
2016-06-01 15:40:00,837,822,829,2488,14928
2016-06-01 15:50:00,774,758,772,2304,13824
2016-06-01 16:00:00,788,723,795,2306,13836
2016-06-01 16:10:00,759,712,760,2231,13386
2016-06-01 16:20:00,732,694,726,2152,12912
2016-06-01 16:30:00,698,672,690,2060,12360
2016-06-01 16:40:00,672,655,663,1990,11940
2016-06-01 16:50:00,649,631,639,1919,11514
2016-06-01 17:00:00,380,372,390,1142,6852
2016-06-01 17:10:00,407,387,406,1200,7200
2016-06-01 17:20:00,511,490,507,1508,9048
2016-06-01 17:30:00,455,434,451,1340,8040
2016-06-01 17:40:00,408,388,403,1199,7194
2016-06-01 17:50:00,360,339,355,1054,6324
2016-06-01 18:00:00,322,302,323,947,5682
2016-06-01 18:10:00,287,264,282,833,4998
2016-06-01 18:20:00,243,220,236,699,4194
2016-06-01 18:30:00,204,180,198,582,3492
2016-06-01 18:40:00,175,152,170,497,2982
2016-06-01 18:50:00,119,94,120,333,1998
2016-06-01 19:00:00,63,72,84,219,1314
2016-06-01 19:10:00,68,62,81,211,1266
2016-06-01 19:20:00,73,64,91,228,1368
2016-06-01 19:30:00,129,83,146,358,2148
2016-06-01 19:40:00,105,123,129,357,2142
2016-06-01 19:50:00,96,61,114,271,1626
2016-06-01 20:00:00,39,26,63,128,768
2016-06-01 20:10:00,27,21,52,100,600
2016-06-01 20:20:00,22,25,41,88,528
2016-06-01 20:30:00,22,14,38,74,444
2016-06-01 20:40:00,19,9,19,47,282
2016-06-01 20:50:00,12,10,13,35,210
2016-06-01 21:00:00,5,5,6,16,96
2016-06-01 21:10:00,1,1,1,3,18
2016-06-01 21:20:00,0,0,0,0,0
2016-06-01 21:30:00,0,0,0,0,0
2016-06-01 21:40:00,0,0,0,0,0
2016-06-01 21:50:00,0,0,0,0,0
2016-06-01 22:00:00,0,0,0,0,0
2016-06-02 04:00:00,0,0,0,0,0
2016-06-02 04:10:00,0,0,0,0,0
2016-06-02 04:20:00,0,0,0,0,0
2016-06-02 04:30:00,0,0,0,0,0
2016-06-02 04:40:00,0,0,0,0,0
2016-06-02 04:50:00,3,2,3,8,48
2016-06-02 05:00:00,10,5,10,25,150
2016-06-02 05:10:00,14,8,21,43,258
2016-06-02 05:20:00,19,8,35,62,372
2016-06-02 05:30:00,22,10,37,69,414
2016-06-02 05:40:00,29,10,58,97,582
2016-06-02 05:50:00,42,33,61,136,816
2016-06-02 06:00:00,31,26,58,115,690
2016-06-02 06:10:00,31,25,55,111,666
2016-06-02 06:20:00,10,17,94,121,726
2016-06-02 06:30:00,21,24,86,131,786
2016-06-02 06:40:00,34,36,64,134,804
2016-06-02 06:50:00,61,51,74,186,1116
2016-06-02 07:00:00,60,106,120,286,1716
2016-06-02 07:10:00,125,132,165,422,2532
2016-06-02 07:20:00,165,167,199,531,3186
2016-06-02 07:30:00,93,212,177,482,2892
2016-06-02 07:40:00,118,169,130,417,2502
2016-06-02 07:50:00,157,77,262,496,2976
2016-06-02 08:00:00,184,101,330,615,3690
2016-06-02 08:10:00,296,157,131,584,3504
2016-06-02 08:20:00,160,227,152,539,3234
2016-06-02 08:30:00,165,157,221,543,3258
2016-06-02 08:40:00,61,260,198,519,3114
2016-06-02 08:50:00,96,191,225,512,3072
2016-06-02 09:00:00,180,0,312,492,2952
2016-06-02 09:10:00,185,0,320,505,3030
2016-06-02 09:20:00,127,65,204,396,2376
2016-06-02 09:30:00,155,53,222,430,2580
2016-06-02 09:40:00,262,138,183,583,3498
2016-06-02 09:50:00,257,164,182,603,3618
2016-06-02 10:00:00,296,269,288,853,5118
2016-06-02 10:10:00,492,466,484,1442,8652
2016-06-02 10:20:00,463,434,454,1351,8106
2016-06-02 10:30:00,516,488,508,1512,9072
2016-06-02 10:40:00,810,788,808,2406,14436
2016-06-02 10:50:00,864,838,860,2562,15372
2016-06-02 11:00:00,591,568,586,1745,10470
2016-06-02 11:10:00,542,519,535,1596,9576
2016-06-02 11:20:00,333,306,325,964,5784
2016-06-02 11:30:00,676,644,662,1982,11892
2016-06-02 11:40:00,688,653,671,2012,12072
2016-06-02 11:50:00,577,549,567,1693,10158
2016-06-02 12:00:00,890,866,884,2640,15840
2016-06-02 12:10:00,981,966,986,2933,17598
2016-06-02 12:20:00,977,958,981,2916,17496
2016-06-02 12:30:00,991,978,986,2955,17730
2016-06-02 12:40:00,994,971,994,2959,17754
2016-06-02 12:50:00,996,979,995,2970,17820
2016-06-02 13:00:00,1011,988,1007,3006,18036
2016-06-02 13:10:00,1007,984,1000,2991,17946
2016-06-02 13:20:00,1003,982,1002,2987,17922
2016-06-02 13:30:00,1007,977,997,2981,17886
2016-06-02 13:40:00,1003,973,991,2967,17802
2016-06-02 13:50:00,1004,979,996,2979,17874
2016-06-02 14:00:00,996,967,989,2952,17712
2016-06-02 14:10:00,984,961,979,2924,17544
2016-06-02 14:20:00,965,944,958,2867,17202
2016-06-02 14:30:00,943,932,948,2823,16938
2016-06-02 14:40:00,934,914,932,2780,16680
2016-06-02 14:50:00,915,897,915,2727,16362
2016-06-02 15:00:00,902,885,902,2689,16134
2016-06-02 15:10:00,897,874,890,2661,15966
2016-06-02 15:20:00,876,852,868,2596,15576
2016-06-02 15:30:00,855,828,847,2530,15180
2016-06-02 15:40:00,833,810,825,2468,14808
2016-06-02 15:50:00,799,781,805,2385,14310
2016-06-02 16:00:00,797,727,808,2332,13992
2016-06-02 16:10:00,760,737,756,2253,13518
2016-06-02 16:20:00,738,676,745,2159,12954
2016-06-02 16:30:00,694,662,684,2040,12240
2016-06-02 16:40:00,658,636,647,1941,11646
2016-06-02 16:50:00,630,609,624,1863,11178
2016-06-02 17:00:00,604,561,603,1768,10608
2016-06-02 17:10:00,561,508,566,1635,9810
2016-06-02 17:20:00,520,495,507,1522,9132
2016-06-02 17:30:00,474,442,460,1376,8256
2016-06-02 17:40:00,436,383,429,1248,7488
2016-06-02 17:50:00,378,342,369,1089,6534
2016-06-02 18:00:00,338,311,326,975,5850
2016-06-02 18:10:00,297,272,289,858,5148
2016-06-02 18:20:00,249,223,250,722,4332
2016-06-02 18:30:00,211,183,203,597,3582
2016-06-02 18:40:00,177,152,169,498,2988
2016-06-02 18:50:00,141,116,135,392,2352
2016-06-02 19:00:00,109,85,101,295,1770
2016-06-02 19:10:00,73,63,84,220,1320
2016-06-02 19:20:00,59,46,54,159,954
2016-06-02 19:30:00,34,27,71,132,792
2016-06-02 19:40:00,28,23,71,122,732
2016-06-02 19:50:00,36,34,43,113,678
2016-06-02 20:00:00,27,34,46,107,642
2016-06-02 20:10:00,31,23,41,95,570
2016-06-02 20:20:00,25,15,44,84,504
2016-06-02 20:30:00,20,12,37,69,414
2016-06-02 20:40:00,20,18,18,56,336
2016-06-02 20:50:00,13,15,13,41,246
2016-06-02 21:00:00,6,8,11,25,150
2016-06-02 21:10:00,5,3,6,14,84
2016-06-02 21:20:00,0,1,2,3,18
2016-06-02 21:30:00,0,0,0,0,0
2016-06-02 21:40:00,0,0,0,0,0
2016-06-02 21:50:00,0,0,0,0,0
2016-06-02 22:00:00,0,0,0,0,0
2016-06-03 04:00:00,0,0,0,0,0
2016-06-03 04:10:00,0,0,0,0,0
2016-06-03 04:20:00,0,0,0,0,0
2016-06-03 04:30:00,0,0,0,0,0
2016-06-03 04:40:00,0,0,0,0,0
2016-06-03 04:50:00,2,2,3,7,42
2016-06-03 05:00:00,5,6,7,18,108
2016-06-03 05:10:00,9,6,12,27,162
2016-06-03 05:20:00,14,6,18,38,228
2016-06-03 05:30:00,20,6,26,52,312
2016-06-03 05:40:00,24,7,33,64,384
2016-06-03 05:50:00,24,19,32,75,450
2016-06-03 06:00:00,28,14,45,87,522
2016-06-03 06:10:00,32,15,54,101,606
2016-06-03 06:20:00,31,21,58,110,660
2016-06-03 06:30:00,22,16,84,122,732
2016-06-03 06:40:00,39,32,61,132,792
2016-06-03 06:50:00,47,32,64,143,858
2016-06-03 07:00:00,46,45,64,155,930
2016-06-03 07:10:00,96,94,38,228,1368
2016-06-03 07:20:00,73,141,144,358,2148
2016-06-03 07:30:00,142,119,207,468,2808
2016-06-03 07:40:00,290,183,115,588,3528
2016-06-03 07:50:00,281,223,217,721,4326
2016-06-03 08:00:00,297,276,290,863,5178
2016-06-03 08:10:00,348,324,339,1011,6066
2016-06-03 08:20:00,393,366,387,1146,6876
2016-06-03 08:30:00,443,418,440,1301,7806
2016-06-03 08:40:00,498,478,476,1452,8712
2016-06-03 08:50:00,538,517,535,1590,9540
2016-06-03 09:00:00,584,564,578,1726,10356
2016-06-03 09:10:00,619,601,623,1843,11058
2016-06-03 09:20:00,648,630,651,1929,11574
2016-06-03 09:30:00,681,668,687,2036,12216
2016-06-03 09:40:00,724,704,725,2153,12918
2016-06-03 09:50:00,745,724,744,2213,13278
2016-06-03 10:00:00,777,738,770,2285,13710
2016-06-03 10:10:00,799,760,795,2354,14124
2016-06-03 10:20:00,818,782,811,2411,14466
2016-06-03 10:30:00,849,813,839,2501,15006
2016-06-03 10:40:00,869,831,858,2558,15348
2016-06-03 10:50:00,887,849,877,2613,15678
2016-06-03 11:00:00,895,862,892,2649,15894
2016-06-03 11:10:00,914,878,906,2698,16188
2016-06-03 11:20:00,932,890,917,2739,16434
2016-06-03 11:30:00,936,906,932,2774,16644
2016-06-03 11:40:00,936,921,947,2804,16824
2016-06-03 11:50:00,944,939,969,2852,17112
2016-06-03 12:00:00,980,954,977,2911,17466
2016-06-03 12:10:00,993,960,987,2940,17640
2016-06-03 12:20:00,1003,973,1002,2978,17868
2016-06-03 12:30:00,1016,984,1008,3008,18048
2016-06-03 12:40:00,1014,983,1002,2999,17994
2016-06-03 12:50:00,1006,973,997,2976,17856
2016-06-03 13:00:00,1002,988,1007,2997,17982
2016-06-03 13:10:00,1001,982,1000,2983,17898
2016-06-03 13:20:00,994,970,994,2958,17748
2016-06-03 13:30:00,997,972,994,2963,17778
2016-06-03 13:40:00,990,966,987,2943,17658
2016-06-03 13:50:00,993,961,984,2938,17628
2016-06-03 14:00:00,987,951,980,2918,17508
2016-06-03 14:10:00,974,941,974,2889,17334
2016-06-03 14:20:00,970,934,960,2864,17184
2016-06-03 14:30:00,958,922,946,2826,16956
2016-06-03 14:40:00,945,904,935,2784,16704
2016-06-03 14:50:00,916,893,907,2716,16296
2016-06-03 15:00:00,906,879,898,2683,16098
2016-06-03 15:10:00,888,865,880,2633,15798
2016-06-03 15:20:00,854,837,865,2556,15336
2016-06-03 15:30:00,869,843,862,2574,15444
2016-06-03 15:40:00,847,821,837,2505,15030
2016-06-03 15:50:00,824,792,815,2431,14586
2016-06-03 16:00:00,803,767,792,2362,14172
2016-06-03 16:10:00,781,724,774,2279,13674
2016-06-03 16:20:00,757,679,756,2192,13152
2016-06-03 16:30:00,703,678,690,2071,12426
2016-06-03 16:40:00,669,639,652,1960,11760
2016-06-03 16:50:00,643,573,638,1854,11124
2016-06-03 17:00:00,603,540,597,1740,10440
2016-06-03 17:10:00,551,518,535,1604,9624
2016-06-03 17:20:00,512,485,504,1501,9006
2016-06-03 17:30:00,462,444,462,1368,8208
2016-06-03 17:40:00,417,394,417,1228,7368
2016-06-03 17:50:00,381,336,383,1100,6600
2016-06-03 18:00:00,341,301,342,984,5904
2016-06-03 18:10:00,296,272,290,858,5148
2016-06-03 18:20:00,250,230,244,724,4344
2016-06-03 18:30:00,211,191,206,608,3648
2016-06-03 18:40:00,187,176,140,503,3018
2016-06-03 18:50:00,137,141,117,395,2370
2016-06-03 19:00:00,98,108,101,307,1842
2016-06-03 19:10:00,86,86,57,229,1374
2016-06-03 19:20:00,57,56,53,166,996
2016-06-03 19:30:00,44,31,61,136,816
2016-06-03 19:40:00,18,17,93,128,768
2016-06-03 19:50:00,16,16,86,118,708
2016-06-03 20:00:00,34,18,57,109,654
2016-06-03 20:10:00,26,24,50,100,600
2016-06-03 20:20:00,28,14,45,87,522
2016-06-03 20:30:00,13,15,46,74,444
2016-06-03 20:40:00,14,12,35,61,366
2016-06-03 20:50:00,8,12,27,47,282
2016-06-03 21:00:00,8,7,17,32,192
2016-06-03 21:10:00,8,3,9,20,120
2016-06-03 21:20:00,4,1,4,9,54
2016-06-03 21:30:00,0,0,0,0,0
2016-06-03 21:40:00,0,0,0,0,0
2016-06-03 21:50:00,0,0,0,0,0
2016-06-03 22:00:00,0,0,0,0,0
2016-06-03 22:10:00,0,0,0,0,0
2016-06-04 04:00:00,0,0,0,0,0
2016-06-04 04:10:00,0,0,0,0,0
2016-06-04 04:20:00,0,0,0,0,0
2016-06-04 04:30:00,0,0,0,0,0
2016-06-04 04:40:00,0,0,0,0,0
2016-06-04 04:50:00,2,2,3,7,42
2016-06-04 05:00:00,4,5,7,16,96
2016-06-04 05:10:00,9,6,11,26,156
2016-06-04 05:20:00,17,5,14,36,216
2016-06-04 05:30:00,17,7,22,46,276
2016-06-04 05:40:00,19,10,28,57,342
2016-06-04 05:50:00,24,8,34,66,396
2016-06-04 06:00:00,26,8,43,77,462
2016-06-04 06:10:00,23,25,41,89,534
2016-06-04 06:20:00,21,28,50,99,594
2016-06-04 06:30:00,26,30,54,110,660
2016-06-04 06:40:00,13,14,92,119,714
2016-06-04 06:50:00,14,14,100,128,768
2016-06-04 07:00:00,35,37,64,136,816
2016-06-04 07:10:00,37,100,107,244,1464
2016-06-04 07:20:00,92,136,144,372,2232
2016-06-04 07:30:00,131,173,177,481,2886
2016-06-04 07:40:00,212,163,233,608,3648
2016-06-04 07:50:00,258,236,249,743,4458
2016-06-04 08:00:00,306,286,298,890,5340
2016-06-04 08:10:00,351,333,350,1034,6204
2016-06-04 08:20:00,395,377,391,1163,6978
2016-06-04 08:30:00,445,428,443,1316,7896
2016-06-04 08:40:00,503,483,497,1483,8898
2016-06-04 08:50:00,551,525,544,1620,9720
2016-06-04 09:00:00,597,573,588,1758,10548
2016-06-04 09:10:00,636,609,628,1873,11238
2016-06-04 09:20:00,685,655,675,2015,12090
2016-06-04 09:30:00,724,689,710,2123,12738
2016-06-04 09:40:00,750,733,753,2236,13416
2016-06-04 09:50:00,777,758,781,2316,13896
2016-06-04 10:00:00,808,785,806,2399,14394
2016-06-04 10:10:00,834,807,827,2468,14808
2016-06-04 10:20:00,860,828,851,2539,15234
2016-06-04 10:30:00,884,845,869,2598,15588
2016-06-04 10:40:00,896,869,896,2661,15966
2016-06-04 10:50:00,911,884,911,2706,16236
2016-06-04 11:00:00,933,906,927,2766,16596
2016-06-04 11:10:00,952,919,943,2814,16884
2016-06-04 11:20:00,968,926,959,2853,17118
2016-06-04 11:30:00,980,940,971,2891,17346
2016-06-04 11:40:00,986,953,983,2922,17532
2016-06-04 11:50:00,995,964,988,2947,17682
2016-06-04 12:00:00,999,964,1000,2963,17778
2016-06-04 12:10:00,996,962,990,2948,17688
2016-06-04 12:20:00,1011,967,1007,2985,17910
2016-06-04 12:30:00,963,917,956,2836,17016
2016-06-04 12:40:00,931,887,921,2739,16434
2016-06-04 12:50:00,957,914,948,2819,16914
2016-06-04 13:00:00,965,922,953,2840,17040
2016-06-04 13:10:00,957,924,942,2823,16938
2016-06-04 13:20:00,1009,979,1002,2990,17940
2016-06-04 13:30:00,924,890,914,2728,16368
2016-06-04 13:40:00,747,712,738,2197,13182
2016-06-04 13:50:00,1004,965,991,2960,17760
2016-06-04 14:00:00,1034,998,1024,3056,18336
2016-06-04 14:10:00,1012,982,1001,2995,17970
2016-06-04 14:20:00,1003,971,990,2964,17784
2016-06-04 14:30:00,993,956,982,2931,17586
2016-06-04 14:40:00,970,933,956,2859,17154
2016-06-04 14:50:00,969,935,959,2863,17178
2016-06-04 15:00:00,942,911,925,2778,16668
2016-06-04 15:10:00,940,909,927,2776,16656
2016-06-04 15:20:00,918,882,905,2705,16230
2016-06-04 15:30:00,892,865,880,2637,15822
2016-06-04 15:40:00,868,835,854,2557,15342
2016-06-04 15:50:00,843,800,826,2469,14814
2016-06-04 16:00:00,820,775,806,2401,14406
2016-06-04 16:10:00,796,748,778,2322,13932
2016-06-04 16:20:00,772,720,751,2243,13458
2016-06-04 16:30:00,730,688,711,2129,12774
2016-06-04 16:40:00,686,657,677,2020,12120
2016-06-04 16:50:00,653,628,646,1927,11562
2016-06-04 17:00:00,609,581,602,1792,10752
2016-06-04 17:10:00,546,524,545,1615,9690
2016-06-04 17:20:00,528,509,533,1570,9420
2016-06-04 17:30:00,484,461,485,1430,8580
2016-06-04 17:40:00,445,422,441,1308,7848
2016-06-04 17:50:00,396,369,388,1153,6918
2016-06-04 18:00:00,351,323,341,1015,6090
2016-06-04 18:10:00,308,281,301,890,5340
2016-06-04 18:20:00,260,236,255,751,4506
2016-06-04 18:30:00,214,193,215,622,3732
2016-06-04 18:40:00,179,157,172,508,3048
2016-06-04 18:50:00,114,132,147,393,2358
2016-06-04 19:00:00,11,141,154,306,1836
2016-06-04 19:10:00,59,87,77,223,1338
2016-06-04 19:20:00,41,53,63,157,942
2016-06-04 19:30:00,29,22,73,124,744
2016-06-04 19:40:00,31,17,73,121,726
2016-06-04 19:50:00,34,33,46,113,678
2016-06-04 20:00:00,30,31,44,105,630
2016-06-04 20:10:00,26,22,47,95,570
2016-06-04 20:20:00,25,15,45,85,510
2016-06-04 20:30:00,19,11,42,72,432
2016-06-04 20:40:00,17,10,33,60,360
2016-06-04 20:50:00,13,9,23,45,270
2016-06-04 21:00:00,8,7,14,29,174
2016-06-04 21:10:00,5,5,7,17,102
2016-06-04 21:20:00,2,1,2,5,30
2016-06-04 21:30:00,0,0,0,0,0
2016-06-04 21:40:00,0,0,0,0,0
2016-06-04 21:50:00,0,0,0,0,0
2016-06-04 22:00:00,0,0,0,0,0
2016-06-04 22:10:00,0,0,0,0,0
2016-06-05 04:00:00,0,0,0,0,0
2016-06-05 04:10:00,0,0,0,0,0
2016-06-05 04:20:00,0,0,0,0,0
2016-06-05 04:30:00,0,0,0,0,0
2016-06-05 04:40:00,0,0,0,0,0
2016-06-05 04:50:00,2,6,1,9,54
2016-06-05 05:00:00,5,10,5,20,120
2016-06-05 05:10:00,7,11,16,34,204
2016-06-05 05:20:00,13,9,25,47,282
2016-06-05 05:30:00,14,12,35,61,366
2016-06-05 05:40:00,18,14,41,73,438
2016-06-05 05:50:00,23,18,44,85,510
2016-06-05 06:00:00,26,26,50,102,612
2016-06-05 06:10:00,18,19,78,115,690
2016-06-05 06:20:00,32,37,60,129,774
2016-06-05 06:30:00,29,48,59,136,816
2016-06-05 06:40:00,26,50,68,144,864
2016-06-05 06:50:00,15,65,77,157,942
2016-06-05 07:00:00,0,80,88,168,1008
2016-06-05 07:10:00,24,105,115,244,1464
2016-06-05 07:20:00,76,122,161,359,2154
2016-06-05 07:30:00,110,100,244,454,2724
2016-06-05 07:40:00,192,155,231,578,3468
2016-06-05 07:50:00,242,200,233,675,4050
2016-06-05 08:00:00,295,270,288,853,5118
2016-06-05 08:10:00,328,302,322,952,5712
2016-06-05 08:20:00,375,347,367,1089,6534
2016-06-05 08:30:00,430,398,422,1250,7500
2016-06-05 08:40:00,489,447,476,1412,8472
2016-06-05 08:50:00,533,495,519,1547,9282
2016-06-05 09:00:00,578,546,567,1691,10146
2016-06-05 09:10:00,602,571,592,1765,10590
2016-06-05 09:20:00,668,638,655,1961,11766
2016-06-05 09:30:00,694,662,682,2038,12228
2016-06-05 09:40:00,731,697,717,2145,12870
2016-06-05 09:50:00,747,714,736,2197,13182
2016-06-05 10:00:00,786,751,772,2309,13854
2016-06-05 10:10:00,826,778,808,2412,14472
2016-06-05 10:20:00,838,788,817,2443,14658
2016-06-05 10:30:00,864,821,852,2537,15222
2016-06-05 10:40:00,871,844,867,2582,15492
2016-06-05 10:50:00,635,612,629,1876,11256
2016-06-05 11:00:00,453,426,444,1323,7938
2016-06-05 11:10:00,528,496,515,1539,9234
2016-06-05 11:20:00,356,329,351,1036,6216
2016-06-05 11:30:00,485,460,487,1432,8592
2016-06-05 11:40:00,629,600,623,1852,11112
2016-06-05 11:50:00,641,608,634,1883,11298
2016-06-05 12:00:00,734,696,720,2150,12900
2016-06-05 12:10:00,574,536,559,1669,10014
2016-06-05 12:20:00,905,869,894,2668,16008
2016-06-05 12:30:00,1062,1024,1055,3141,18846
2016-06-05 12:40:00,963,935,950,2848,17088
2016-06-05 12:50:00,1002,971,995,2968,17808
2016-06-05 13:00:00,1069,1027,1055,3151,18906
2016-06-05 13:10:00,1068,1030,1054,3152,18912
2016-06-05 13:20:00,1079,1022,1053,3154,18924
2016-06-05 13:30:00,1037,995,1022,3054,18324
2016-06-05 13:40:00,1050,1013,1032,3095,18570
2016-06-05 13:50:00,1046,1003,1031,3080,18480
2016-06-05 14:00:00,1041,992,1022,3055,18330
2016-06-05 14:10:00,1034,986,1018,3038,18228
2016-06-05 14:20:00,1013,979,1002,2994,17964
2016-06-05 14:30:00,998,953,982,2933,17598
2016-06-05 14:40:00,978,941,969,2888,17328
2016-06-05 14:50:00,962,925,952,2839,17034
2016-06-05 15:00:00,946,903,931,2780,16680
2016-06-05 15:10:00,921,882,909,2712,16272
2016-06-05 15:20:00,898,861,888,2647,15882
2016-06-05 15:30:00,870,838,857,2565,15390
2016-06-05 15:40:00,846,818,839,2503,15018
2016-06-05 15:50:00,836,801,825,2462,14772
2016-06-05 16:00:00,814,779,800,2393,14358
2016-06-05 16:10:00,787,759,777,2323,13938
2016-06-05 16:20:00,756,727,743,2226,13356
2016-06-05 16:30:00,720,683,704,2107,12642
2016-06-05 16:40:00,687,647,670,2004,12024
2016-06-05 16:50:00,648,623,643,1914,11484
2016-06-05 17:00:00,617,584,604,1805,10830
2016-06-05 17:10:00,566,535,555,1656,9936
2016-06-05 17:20:00,526,501,521,1548,9288
2016-06-05 17:30:00,478,457,480,1415,8490
2016-06-05 17:40:00,439,417,438,1294,7764
2016-06-05 17:50:00,387,369,388,1144,6864
2016-06-05 18:00:00,345,324,345,1014,6084
2016-06-05 18:10:00,303,283,301,887,5322
2016-06-05 18:20:00,259,237,256,752,4512
2016-06-05 18:30:00,217,195,214,626,3756
2016-06-05 18:40:00,144,191,177,512,3072
2016-06-05 18:50:00,130,128,148,406,2436
2016-06-05 19:00:00,94,117,104,315,1890
2016-06-05 19:10:00,84,86,62,232,1392
2016-06-05 19:20:00,42,56,65,163,978
2016-06-05 19:30:00,23,29,76,128,768
2016-06-05 19:40:00,17,15,89,121,726
2016-06-05 19:50:00,31,27,53,111,666
2016-06-05 20:00:00,27,23,52,102,612
2016-06-05 20:10:00,24,26,43,93,558
2016-06-05 20:20:00,25,23,34,82,492
2016-06-05 20:30:00,18,18,35,71,426
2016-06-05 20:40:00,12,19,29,60,360
2016-06-05 20:50:00,8,15,22,45,270
2016-06-05 21:00:00,9,9,12,30,180
2016-06-05 21:10:00,5,6,8,19,114
2016-06-05 21:20:00,2,2,3,7,42
2016-06-05 21:30:00,0,0,0,0,0
2016-06-05 21:40:00,0,0,0,0,0
2016-06-05 21:50:00,0,0,0,0,0
2016-06-05 22:00:00,0,0,0,0,0
2016-06-05 22:10:00,0,0,0,0,0
2016-06-06 03:50:00,0,0,0,0,0
2016-06-06 04:00:00,0,0,0,0,0
2016-06-06 04:10:00,0,0,0,0,0
2016-06-06 04:20:00,0,0,0,0,0
2016-06-06 04:30:00,0,0,0,0,0
2016-06-06 04:40:00,0,0,1,1,6
2016-06-06 04:50:00,5,3,6,14,84
2016-06-06 05:00:00,11,6,9,26,156
2016-06-06 05:10:00,10,8,13,31,186
2016-06-06 05:20:00,17,8,18,43,258
2016-06-06 05:30:00,20,6,30,56,336
2016-06-06 05:40:00,22,7,35,64,384
2016-06-06 05:50:00,23,14,38,75,450
2016-06-06 06:00:00,26,13,44,83,498
2016-06-06 06:10:00,30,23,38,91,546
2016-06-06 06:20:00,30,19,52,101,606
2016-06-06 06:30:00,27,18,66,111,666
2016-06-06 06:40:00,2,1,119,122,732
2016-06-06 06:50:00,23,22,86,131,786
2016-06-06 07:00:00,41,44,56,141,846
2016-06-06 07:10:00,80,79,96,255,1530
2016-06-06 07:20:00,94,137,140,371,2226
2016-06-06 07:30:00,197,84,199,480,2880
2016-06-06 07:40:00,323,163,121,607,3642
2016-06-06 07:50:00,246,262,234,742,4452
2016-06-06 08:00:00,305,282,300,887,5322
2016-06-06 08:10:00,355,331,348,1034,6204
2016-06-06 08:20:00,399,375,390,1164,6984
2016-06-06 08:30:00,454,426,445,1325,7950
2016-06-06 08:40:00,511,487,504,1502,9012
2016-06-06 08:50:00,564,538,556,1658,9948
2016-06-06 09:00:00,612,581,599,1792,10752
2016-06-06 09:10:00,648,618,637,1903,11418
2016-06-06 09:20:00,694,663,686,2043,12258
2016-06-06 09:30:00,730,701,719,2150,12900
2016-06-06 09:40:00,767,739,757,2263,13578
2016-06-06 09:50:00,796,768,788,2352,14112
2016-06-06 10:00:00,822,792,811,2425,14550
2016-06-06 10:10:00,851,823,837,2511,15066
2016-06-06 10:20:00,871,844,858,2573,15438
2016-06-06 10:30:00,898,870,878,2646,15876
2016-06-06 10:40:00,919,889,904,2712,16272
2016-06-06 10:50:00,938,905,923,2766,16596
2016-06-06 11:00:00,947,924,944,2815,16890
2016-06-06 11:10:00,970,945,965,2880,17280
2016-06-06 11:20:00,987,954,978,2919,17514
2016-06-06 11:30:00,1005,969,989,2963,17778
2016-06-06 11:40:00,1008,979,996,2983,17898
2016-06-06 11:50:00,1019,992,1006,3017,18102
2016-06-06 12:00:00,1032,1003,1019,3054,18324
2016-06-06 12:10:00,1043,1002,1029,3074,18444
2016-06-06 12:20:00,1048,1019,1041,3108,18648
2016-06-06 12:30:00,1055,1024,1051,3130,18780
2016-06-06 12:40:00,1058,1032,1051,3141,18846
2016-06-06 12:50:00,1065,1036,1059,3160,18960
2016-06-06 13:00:00,1063,1036,1058,3157,18942
2016-06-06 13:10:00,1066,1038,1056,3160,18960
2016-06-06 13:20:00,1069,1041,1052,3162,18972
2016-06-06 13:30:00,1064,1034,1052,3150,18900
2016-06-06 13:40:00,1054,1027,1044,3125,18750
2016-06-06 13:50:00,1051,1023,1040,3114,18684
2016-06-06 14:00:00,1045,1015,1033,3093,18558
2016-06-06 14:10:00,1027,1000,1017,3044,18264
2016-06-06 14:20:00,1021,993,1008,3022,18132
2016-06-06 14:30:00,1011,980,995,2986,17916
2016-06-06 14:40:00,993,962,981,2936,17616
2016-06-06 14:50:00,976,950,961,2887,17322
2016-06-06 15:00:00,957,932,949,2838,17028
2016-06-06 15:10:00,935,916,936,2787,16722
2016-06-06 15:20:00,916,890,908,2714,16284
2016-06-06 15:30:00,880,873,890,2643,15858
2016-06-06 15:40:00,866,843,858,2567,15402
2016-06-06 15:50:00,846,817,841,2504,15024
2016-06-06 16:00:00,819,787,811,2417,14502
2016-06-06 16:10:00,791,762,782,2335,14010
2016-06-06 16:20:00,759,738,758,2255,13530
2016-06-06 16:30:00,722,698,720,2140,12840
2016-06-06 16:40:00,689,661,682,2032,12192
2016-06-06 16:50:00,658,624,645,1927,11562
2016-06-06 17:00:00,625,596,603,1824,10944
2016-06-06 17:10:00,574,550,566,1690,10140
2016-06-06 17:20:00,538,517,533,1588,9528
2016-06-06 17:30:00,495,467,489,1451,8706
2016-06-06 17:40:00,451,428,447,1326,7956
2016-06-06 17:50:00,403,378,393,1174,7044
2016-06-06 18:00:00,360,331,350,1041,6246
2016-06-06 18:10:00,314,291,305,910,5460
2016-06-06 18:20:00,265,243,258,766,4596
2016-06-06 18:30:00,220,199,215,634,3804
2016-06-06 18:40:00,181,159,174,514,3084
2016-06-06 18:50:00,142,134,133,409,2454
2016-06-06 19:00:00,105,98,110,313,1878
2016-06-06 19:10:00,76,79,75,230,1380
2016-06-06 19:20:00,51,44,68,163,978
2016-06-06 19:30:00,30,27,66,123,738
2016-06-06 19:40:00,25,23,68,116,696
2016-06-06 19:50:00,29,30,47,106,636
2016-06-06 20:00:00,30,32,36,98,588
2016-06-06 20:10:00,31,17,42,90,540
2016-06-06 20:20:00,22,14,44,80,480
2016-06-06 20:30:00,20,20,31,71,426
2016-06-06 20:40:00,17,19,23,59,354
2016-06-06 20:50:00,14,8,23,45,270
2016-06-06 21:00:00,10,5,15,30,180
2016-06-06 21:10:00,5,5,9,19,114
2016-06-06 21:20:00,2,3,3,8,48
2016-06-06 21:30:00,0,0,0,0,0
2016-06-06 21:40:00,0,0,0,0,0
2016-06-06 21:50:00,0,0,0,0,0
2016-06-06 22:00:00,0,0,0,0,0
2016-06-06 22:10:00,0,0,0,0,0
2016-06-07 04:00:00,0,0,0,0,0
2016-06-07 04:10:00,0,0,0,0,0
2016-06-07 04:20:00,0,0,0,0,0
2016-06-07 04:30:00,0,0,0,0,0
2016-06-07 04:40:00,2,3,3,8,48
2016-06-07 04:50:00,16,14,25,55,330
2016-06-07 05:00:00,33,22,49,104,624
2016-06-07 05:10:00,30,13,43,86,516
2016-06-07 05:20:00,36,10,47,93,558
2016-06-07 05:30:00,24,8,25,57,342
2016-06-07 05:40:00,12,6,6,24,144
2016-06-07 05:50:00,10,3,5,18,108
2016-06-07 06:00:00,11,3,8,22,132
2016-06-07 06:10:00,20,12,28,60,360
2016-06-07 06:20:00,30,68,71,169,1014
2016-06-07 06:30:00,84,65,94,243,1458
2016-06-07 06:40:00,63,64,73,200,1200
2016-06-07 06:50:00,32,67,77,176,1056
2016-06-07 07:00:00,60,76,90,226,1356
2016-06-07 07:10:00,40,117,115,272,1632
2016-06-07 07:20:00,90,99,120,309,1854
2016-06-07 07:30:00,83,122,139,344,2064
2016-06-07 07:40:00,204,171,170,545,3270
2016-06-07 07:50:00,261,241,263,765,4590
2016-06-07 08:00:00,198,178,196,572,3432
2016-06-07 08:10:00,345,321,339,1005,6030
2016-06-07 08:20:00,393,368,386,1147,6882
2016-06-07 08:30:00,434,414,431,1279,7674
2016-06-07 08:40:00,477,453,470,1400,8400
2016-06-07 08:50:00,538,513,526,1577,9462
2016-06-07 09:00:00,589,558,576,1723,10338
2016-06-07 09:10:00,632,592,617,1841,11046
2016-06-07 09:20:00,672,633,660,1965,11790
2016-06-07 09:30:00,708,671,698,2077,12462
2016-06-07 09:40:00,727,696,716,2139,12834
2016-06-07 09:50:00,766,738,756,2260,13560
2016-06-07 10:00:00,784,772,788,2344,14064
2016-06-07 10:10:00,817,810,828,2455,14730
2016-06-07 10:20:00,847,834,853,2534,15204
2016-06-07 10:30:00,878,856,871,2605,15630
2016-06-07 10:40:00,894,872,885,2651,15906
2016-06-07 10:50:00,918,883,911,2712,16272
2016-06-07 11:00:00,942,904,936,2782,16692
2016-06-07 11:10:00,966,932,959,2857,17142
2016-06-07 11:20:00,975,950,970,2895,17370
2016-06-07 11:30:00,987,962,980,2929,17574
2016-06-07 11:40:00,987,985,1007,2979,17874
2016-06-07 11:50:00,986,1003,1018,3007,18042
2016-06-07 12:00:00,1008,1012,1027,3047,18282
2016-06-07 12:10:00,1049,1024,1041,3114,18684
2016-06-07 12:20:00,1034,998,1020,3052,18312
2016-06-07 12:30:00,1065,1022,1045,3132,18792
2016-06-07 12:40:00,970,930,946,2846,17076
2016-06-07 12:50:00,1105,1069,1093,3267,19602
2016-06-07 13:00:00,1098,1081,1094,3273,19638
2016-06-07 13:10:00,1060,1040,1052,3152,18912
2016-06-07 13:20:00,873,852,869,2594,15564
2016-06-07 13:30:00,730,716,730,2176,13056
2016-06-07 13:40:00,574,547,567,1688,10128
2016-06-07 13:50:00,799,772,794,2365,14190
2016-06-07 14:00:00,894,859,873,2626,15756
2016-06-07 14:10:00,952,917,929,2798,16788
2016-06-07 14:20:00,981,936,950,2867,17202
2016-06-07 14:30:00,904,863,864,2631,15786
2016-06-07 14:40:00,977,944,942,2863,17178
2016-06-07 14:50:00,940,906,908,2754,16524
2016-06-07 15:00:00,921,894,908,2723,16338
2016-06-07 15:10:00,916,893,900,2709,16254
2016-06-07 15:20:00,880,852,854,2586,15516
2016-06-07 15:30:00,879,846,845,2570,15420
2016-06-07 15:40:00,843,813,825,2481,14886
2016-06-07 15:50:00,829,799,805,2433,14598
2016-06-07 16:00:00,816,786,783,2385,14310
2016-06-07 16:10:00,782,756,761,2299,13794
2016-06-07 16:20:00,749,724,741,2214,13284
2016-06-07 16:30:00,703,671,691,2065,12390
2016-06-07 16:40:00,651,617,638,1906,11436
2016-06-07 16:50:00,623,588,613,1824,10944
2016-06-07 17:00:00,591,565,584,1740,10440
2016-06-07 17:10:00,553,525,545,1623,9738
2016-06-07 17:20:00,516,488,509,1513,9078
2016-06-07 17:30:00,468,444,468,1380,8280
2016-06-07 17:40:00,430,408,421,1259,7554
2016-06-07 17:50:00,380,355,373,1108,6648
2016-06-07 18:00:00,339,311,332,982,5892
2016-06-07 18:10:00,300,276,295,871,5226
2016-06-07 18:20:00,258,233,254,745,4470
2016-06-07 18:30:00,215,195,211,621,3726
2016-06-07 18:40:00,177,155,172,504,3024
2016-06-07 18:50:00,109,136,169,414,2484
2016-06-07 19:00:00,93,109,127,329,1974
2016-06-07 19:10:00,74,99,71,244,1464
2016-06-07 19:20:00,55,68,52,175,1050
2016-06-07 19:30:00,46,44,52,142,852
2016-06-07 19:40:00,43,30,60,133,798
2016-06-07 19:50:00,16,17,90,123,738
2016-06-07 20:00:00,15,10,88,113,678
2016-06-07 20:10:00,30,21,49,100,600
2016-06-07 20:20:00,26,23,37,86,516
2016-06-07 20:30:00,9,34,29,72,432
2016-06-07 20:40:00,20,10,27,57,342
2016-06-07 20:50:00,15,10,19,44,264
2016-06-07 21:00:00,9,9,11,29,174
2016-06-07 21:10:00,5,5,6,16,96
2016-06-07 21:20:00,2,2,3,7,42
2016-06-07 21:30:00,0,0,0,0,0
2016-06-07 21:40:00,0,0,0,0,0
2016-06-07 21:50:00,0,0,0,0,0
2016-06-07 22:00:00,0,0,0,0,0
2016-06-07 22:10:00,0,0,0,0,0
2016-06-08 04:00:00,0,0,0,0,0
2016-06-08 04:10:00,0,0,0,0,0
2016-06-08 04:20:00,0,0,0,0,0
2016-06-08 04:30:00,0,0,0,0,0
2016-06-08 04:40:00,0,0,0,0,0
2016-06-08 04:50:00,0,0,0,0,0
2016-06-08 05:00:00,1,1,1,3,18
2016-06-08 05:10:00,4,3,4,11,66
2016-06-08 05:20:00,8,7,10,25,150
2016-06-08 05:30:00,13,10,17,40,240
2016-06-08 05:40:00,20,8,30,58,348
2016-06-08 05:50:00,24,10,31,65,390
2016-06-08 06:00:00,30,14,49,93,558
2016-06-08 06:10:00,59,54,41,154,924
2016-06-08 06:20:00,44,42,55,141,846
2016-06-08 06:30:00,53,54,70,177,1062
2016-06-08 06:40:00,73,69,85,227,1362
2016-06-08 06:50:00,77,106,125,308,1848
2016-06-08 07:00:00,73,121,129,323,1938
2016-06-08 07:10:00,94,130,142,366,2196
2016-06-08 07:20:00,82,126,144,352,2112
2016-06-08 07:30:00,67,145,151,363,2178
2016-06-08 07:40:00,106,118,174,398,2388
2016-06-08 07:50:00,160,110,224,494,2964
2016-06-08 08:00:00,149,111,187,447,2682
2016-06-08 08:10:00,115,152,178,445,2670
2016-06-08 08:20:00,124,108,207,439,2634
2016-06-08 08:30:00,193,197,149,539,3234
2016-06-08 08:40:00,195,163,210,568,3408
2016-06-08 08:50:00,248,155,156,559,3354
2016-06-08 09:00:00,331,157,122,610,3660
2016-06-08 09:10:00,251,218,227,696,4176
2016-06-08 09:20:00,281,262,279,822,4932
2016-06-08 09:30:00,331,313,331,975,5850
2016-06-08 09:40:00,356,333,351,1040,6240
2016-06-08 09:50:00,334,303,325,962,5772
2016-06-08 10:00:00,380,348,372,1100,6600
2016-06-08 10:10:00,357,325,345,1027,6162
2016-06-08 10:20:00,420,389,407,1216,7296
2016-06-08 10:30:00,346,312,332,990,5940
2016-06-08 10:40:00,342,312,332,986,5916
2016-06-08 10:50:00,296,267,287,850,5100
2016-06-08 11:00:00,424,395,418,1237,7422
2016-06-08 11:10:00,412,383,400,1195,7170
2016-06-08 11:20:00,371,340,358,1069,6414
2016-06-08 11:30:00,355,327,345,1027,6162
2016-06-08 11:40:00,401,368,388,1157,6942
2016-06-08 11:50:00,524,487,509,1520,9120
2016-06-08 12:00:00,474,442,463,1379,8274
2016-06-08 12:10:00,627,600,620,1847,11082
2016-06-08 12:20:00,912,889,905,2706,16236
2016-06-08 12:30:00,599,578,596,1773,10638
2016-06-08 12:40:00,886,862,879,2627,15762
2016-06-08 12:50:00,828,801,817,2446,14676
2016-06-08 13:00:00,883,857,871,2611,15666
2016-06-08 13:10:00,990,964,977,2931,17586
2016-06-08 13:20:00,751,727,743,2221,13326
2016-06-08 13:30:00,739,706,729,2174,13044
2016-06-08 13:40:00,672,637,660,1969,11814
2016-06-08 13:50:00,975,930,960,2865,17190
2016-06-08 14:00:00,1012,960,1000,2972,17832
2016-06-08 14:10:00,1009,967,1005,2981,17886
2016-06-08 14:20:00,1018,969,1006,2993,17958
2016-06-08 14:30:00,1006,959,992,2957,17742
2016-06-08 14:40:00,896,864,893,2653,15918
2016-06-08 14:50:00,795,765,790,2350,14100
2016-06-08 15:00:00,935,913,927,2775,16650
2016-06-08 15:10:00,976,967,984,2927,17562
2016-06-08 15:20:00,784,769,781,2334,14004
2016-06-08 15:30:00,662,640,654,1956,11736
2016-06-08 15:40:00,964,944,954,2862,17172
2016-06-08 15:50:00,651,627,641,1919,11514
2016-06-08 16:00:00,900,880,889,2669,16014
2016-06-08 16:10:00,733,713,710,2156,12936
2016-06-08 16:20:00,495,473,490,1458,8748
2016-06-08 16:30:00,526,499,518,1543,9258
2016-06-08 16:40:00,511,483,502,1496,8976
2016-06-08 16:50:00,334,312,330,976,5856
2016-06-08 17:00:00,392,367,385,1144,6864
2016-06-08 17:10:00,519,495,512,1526,9156
2016-06-08 17:20:00,263,224,234,721,4326
2016-06-08 17:30:00,262,238,255,755,4530
2016-06-08 17:40:00,276,247,266,789,4734
2016-06-08 17:50:00,187,162,179,528,3168
2016-06-08 18:00:00,213,190,206,609,3654
2016-06-08 18:10:00,214,110,232,556,3336
2016-06-08 18:20:00,223,171,226,620,3720
2016-06-08 18:30:00,231,205,222,658,3948
2016-06-08 18:40:00,181,154,172,507,3042
2016-06-08 18:50:00,210,185,202,597,3582
2016-06-08 19:00:00,141,117,134,392,2352
2016-06-08 19:10:00,103,43,116,262,1572
2016-06-08 19:20:00,47,40,79,166,996
2016-06-08 19:30:00,36,31,64,131,786
2016-06-08 19:40:00,29,34,64,127,762
2016-06-08 19:50:00,18,21,75,114,684
2016-06-08 20:00:00,22,29,53,104,624
2016-06-08 20:10:00,13,31,52,96,576
2016-06-08 20:20:00,20,21,45,86,516
2016-06-08 20:30:00,29,7,39,75,450
2016-06-08 20:40:00,17,12,35,64,384
2016-06-08 20:50:00,18,8,28,54,324
2016-06-08 21:00:00,7,9,22,38,228
2016-06-08 21:10:00,9,3,11,23,138
2016-06-08 21:20:00,5,1,6,12,72
2016-06-08 21:30:00,1,0,1,2,12
2016-06-08 21:40:00,0,0,0,0,0
2016-06-08 21:50:00,0,0,0,0,0
2016-06-08 22:00:00,0,0,0,0,0
2016-06-08 22:10:00,0,0,0,0,0
2016-06-08 22:20:00,0,0,0,0,0
2016-06-09 03:50:00,0,0,0,0,0
2016-06-09 04:00:00,0,0,0,0,0
2016-06-09 04:10:00,0,0,0,0,0
2016-06-09 04:20:00,0,0,0,0,0
2016-06-09 04:30:00,0,0,0,0,0
2016-06-09 04:40:00,0,1,1,2,12
2016-06-09 04:50:00,3,4,5,12,72
2016-06-09 05:00:00,8,2,12,22,132
2016-06-09 05:10:00,10,4,17,31,186
2016-06-09 05:20:00,12,6,23,41,246
2016-06-09 05:30:00,12,10,28,50,300
2016-06-09 05:40:00,15,11,31,57,342
2016-06-09 05:50:00,17,11,36,64,384
2016-06-09 06:00:00,21,10,42,73,438
2016-06-09 06:10:00,20,17,43,80,480
2016-06-09 06:20:00,25,17,45,87,522
2016-06-09 06:30:00,24,21,50,95,570
2016-06-09 06:40:00,25,30,55,110,660
2016-06-09 06:50:00,33,19,57,109,654
2016-06-09 07:00:00,28,26,53,107,642
2016-06-09 07:10:00,43,102,119,264,1584
2016-06-09 07:20:00,124,103,187,414,2484
2016-06-09 07:30:00,271,88,171,530,3180
2016-06-09 07:40:00,219,219,221,659,3954
2016-06-09 07:50:00,273,252,271,796,4776
2016-06-09 08:00:00,322,301,320,943,5658
2016-06-09 08:10:00,369,345,366,1080,6480
2016-06-09 08:20:00,414,391,411,1216,7296
2016-06-09 08:30:00,479,457,476,1412,8472
2016-06-09 08:40:00,524,500,524,1548,9288
2016-06-09 08:50:00,574,551,573,1698,10188
2016-06-09 09:00:00,618,595,612,1825,10950
2016-06-09 09:10:00,650,626,647,1923,11538
2016-06-09 09:20:00,695,673,690,2058,12348
2016-06-09 09:30:00,741,717,726,2184,13104
2016-06-09 09:40:00,782,747,768,2297,13782
2016-06-09 09:50:00,814,778,803,2395,14370
2016-06-09 10:00:00,840,804,835,2479,14874
2016-06-09 10:10:00,873,829,862,2564,15384
2016-06-09 10:20:00,879,844,871,2594,15564
2016-06-09 10:30:00,894,882,902,2678,16068
2016-06-09 10:40:00,794,775,797,2366,14196
2016-06-09 10:50:00,942,925,944,2811,16866
2016-06-09 11:00:00,943,917,934,2794,16764
2016-06-09 11:10:00,971,939,962,2872,17232
2016-06-09 11:20:00,976,945,981,2902,17412
2016-06-09 11:30:00,988,957,1001,2946,17676
2016-06-09 11:40:00,990,952,978,2920,17520
2016-06-09 11:50:00,1009,974,998,2981,17886
2016-06-09 12:00:00,1020,1004,1019,3043,18258
2016-06-09 12:10:00,996,975,995,2966,17796
2016-06-09 12:20:00,1043,1018,1044,3105,18630
2016-06-09 12:30:00,1047,1014,1042,3103,18618
2016-06-09 12:40:00,1036,1015,1027,3078,18468
2016-06-09 12:50:00,1045,1018,1033,3096,18576
2016-06-09 13:00:00,1051,1020,1038,3109,18654
2016-06-09 13:10:00,1066,1036,1055,3157,18942
2016-06-09 13:20:00,1044,1020,1040,3104,18624
2016-06-09 13:30:00,1017,988,1005,3010,18060
2016-06-09 13:40:00,1107,1078,1095,3280,19680
2016-06-09 13:50:00,800,787,799,2386,14316
2016-06-09 14:00:00,1050,1028,1042,3120,18720
2016-06-09 14:10:00,1051,1034,1056,3141,18846
2016-06-09 14:20:00,994,981,1005,2980,17880
2016-06-09 14:30:00,888,861,881,2630,15780
2016-06-09 14:40:00,1062,1022,1053,3137,18822
2016-06-09 14:50:00,976,952,967,2895,17370
2016-06-09 15:00:00,927,914,923,2764,16584
2016-06-09 15:10:00,902,897,909,2708,16248
2016-06-09 15:20:00,917,897,916,2730,16380
2016-06-09 15:30:00,790,769,783,2342,14052
2016-06-09 15:40:00,856,832,847,2535,15210
2016-06-09 15:50:00,857,834,850,2541,15246
2016-06-09 16:00:00,810,790,812,2412,14472
2016-06-09 16:10:00,784,765,784,2333,13998
2016-06-09 16:20:00,775,754,771,2300,13800
2016-06-09 16:30:00,584,562,578,1724,10344
2016-06-09 16:40:00,359,337,352,1048,6288
2016-06-09 16:50:00,407,385,401,1193,7158
2016-06-09 17:00:00,469,445,461,1375,8250
2016-06-09 17:10:00,384,355,374,1113,6678
2016-06-09 17:20:00,498,471,489,1458,8748
2016-06-09 17:30:00,487,460,474,1421,8526
2016-06-09 17:40:00,448,423,432,1303,7818
2016-06-09 17:50:00,382,358,374,1114,6684
2016-06-09 18:00:00,356,330,346,1032,6192
2016-06-09 18:10:00,280,255,272,807,4842
2016-06-09 18:20:00,184,162,177,523,3138
2016-06-09 18:30:00,160,140,156,456,2736
2016-06-09 18:40:00,236,222,238,696,4176
2016-06-09 18:50:00,171,164,195,530,3180
2016-06-09 19:00:00,156,146,119,421,2526
2016-06-09 19:10:00,171,52,255,478,2868
2016-06-09 19:20:00,161,80,245,486,2916
2016-06-09 19:30:00,116,115,160,391,2346
2016-06-09 19:40:00,88,92,72,252,1512
2016-06-09 19:50:00,66,39,67,172,1032
2016-06-09 20:00:00,31,24,79,134,804
2016-06-09 20:10:00,29,29,48,106,636
2016-06-09 20:20:00,17,28,41,86,516
2016-06-09 20:30:00,17,19,38,74,444
2016-06-09 20:40:00,23,7,32,62,372
2016-06-09 20:50:00,19,9,23,51,306
2016-06-09 21:00:00,9,10,15,34,204
2016-06-09 21:10:00,6,6,9,21,126
2016-06-09 21:20:00,4,3,5,12,72
2016-06-09 21:30:00,1,0,1,2,12
2016-06-09 21:40:00,0,0,0,0,0
2016-06-09 21:50:00,0,0,0,0,0
2016-06-09 22:00:00,0,0,0,0,0
2016-06-09 22:10:00,0,0,0,0,0
2016-06-09 22:20:00,0,0,0,0,0
2016-06-10 03:50:00,0,0,0,0,0
2016-06-10 04:00:00,0,0,0,0,0
2016-06-10 04:10:00,0,0,0,0,0
2016-06-10 04:20:00,0,0,0,0,0
2016-06-10 04:30:00,0,0,0,0,0
2016-06-10 04:40:00,0,0,0,0,0
2016-06-10 04:50:00,3,4,2,9,54
2016-06-10 05:00:00,7,6,6,19,114
2016-06-10 05:10:00,12,7,11,30,180
2016-06-10 05:20:00,15,8,19,42,252
2016-06-10 05:30:00,19,7,28,54,324
2016-06-10 05:40:00,25,6,32,63,378
2016-06-10 05:50:00,24,11,39,74,444
2016-06-10 06:00:00,32,13,49,94,564
2016-06-10 06:10:00,32,18,56,106,636
2016-06-10 06:20:00,30,23,54,107,642
2016-06-10 06:30:00,23,16,81,120,720
2016-06-10 06:40:00,41,33,59,133,798
2016-06-10 06:50:00,51,37,52,140,840
2016-06-10 07:00:00,50,47,56,153,918
2016-06-10 07:10:00,89,94,81,264,1584
2016-06-10 07:20:00,93,115,162,370,2220
2016-06-10 07:30:00,155,29,297,481,2886
2016-06-10 07:40:00,233,192,183,608,3648
2016-06-10 07:50:00,255,231,248,734,4404
2016-06-10 08:00:00,144,121,138,403,2418
2016-06-10 08:10:00,339,314,332,985,5910
2016-06-10 08:20:00,254,234,253,741,4446
2016-06-10 08:30:00,307,277,297,881,5286
2016-06-10 08:40:00,412,374,401,1187,7122
2016-06-10 08:50:00,462,429,454,1345,8070
2016-06-10 10:00:00,296,302,298,896,5376
2016-06-10 10:10:00,711,732,731,2174,13044
2016-06-10 10:20:00,787,807,803,2397,14382
2016-06-10 10:30:00,824,841,838,2503,15018
2016-06-10 10:40:00,802,815,819,2436,14616
2016-06-10 10:50:00,901,925,920,2746,16476
2016-06-10 11:00:00,551,577,571,1699,10194
2016-06-10 11:10:00,967,997,984,2948,17688
2016-06-10 11:20:00,924,956,939,2819,16914
2016-06-10 11:30:00,973,1011,1000,2984,17904
2016-06-10 11:40:00,998,1031,1032,3061,18366
2016-06-10 11:50:00,834,866,847,2547,15282
2016-06-10 12:00:00,882,912,897,2691,16146
2016-06-10 12:10:00,899,925,908,2732,16392
2016-06-10 12:20:00,1021,1038,1024,3083,18498
2016-06-10 12:30:00,1051,1076,1065,3192,19152
2016-06-10 12:40:00,944,963,944,2851,17106
2016-06-10 12:50:00,1066,1091,1077,3234,19404
2016-06-10 13:00:00,1058,1094,1080,3232,19392
2016-06-10 13:10:00,995,1023,1019,3037,18222
2016-06-10 13:20:00,932,955,955,2842,17052
2016-06-10 13:30:00,1058,1079,1080,3217,19302
2016-06-10 13:40:00,1058,1079,1077,3214,19284
2016-06-10 13:50:00,1062,1085,1068,3215,19290
2016-06-10 14:00:00,1040,1064,1050,3154,18924
2016-06-10 14:10:00,1030,1053,1046,3129,18774
2016-06-10 14:20:00,1026,1052,1035,3113,18678
2016-06-10 14:30:00,960,984,969,2913,17478
2016-06-10 14:40:00,986,1011,995,2992,17952
2016-06-10 14:50:00,987,1012,999,2998,17988
2016-06-10 15:00:00,938,969,954,2861,17166
2016-06-10 15:10:00,930,959,946,2835,17010
2016-06-10 15:20:00,912,945,936,2793,16758
2016-06-10 15:30:00,897,927,907,2731,16386
2016-06-10 15:40:00,870,903,887,2660,15960
2016-06-10 15:50:00,844,874,862,2580,15480
2016-06-10 16:00:00,808,847,837,2492,14952
2016-06-10 16:10:00,777,817,804,2398,14388
2016-06-10 16:20:00,742,787,777,2306,13836
2016-06-10 16:30:00,708,739,729,2176,13056
2016-06-10 16:40:00,670,696,690,2056,12336
2016-06-10 16:50:00,641,669,661,1971,11826
2016-06-10 17:00:00,602,631,622,1855,11130
2016-06-10 17:10:00,555,585,578,1718,10308
2016-06-10 17:20:00,510,541,533,1584,9504
2016-06-10 17:30:00,360,387,381,1128,6768
2016-06-10 17:40:00,377,407,397,1181,7086
2016-06-10 17:50:00,356,381,380,1117,6702
2016-06-10 18:00:00,339,360,356,1055,6330
2016-06-10 18:10:00,291,316,309,916,5496
2016-06-10 18:20:00,252,276,273,801,4806
2016-06-10 18:30:00,178,139,168,485,2910
2016-06-10 18:40:00,157,179,176,512,3072
2016-06-10 18:50:00,174,197,192,563,3378
2016-06-10 19:00:00,133,155,152,440,2640
2016-06-10 19:10:00,90,118,110,318,1908
2016-06-10 19:20:00,56,91,71,218,1308
2016-06-10 19:30:00,51,81,55,187,1122
2016-06-10 19:40:00,78,94,80,252,1512
2016-06-10 19:50:00,68,89,65,222,1332
2016-06-10 20:00:00,65,85,58,208,1248
2016-06-10 20:10:00,32,74,58,164,984
2016-06-10 20:20:00,26,60,26,112,672
2016-06-10 20:30:00,20,37,26,83,498
2016-06-10 20:40:00,20,20,21,61,366
2016-06-10 20:50:00,20,19,30,69,414
2016-06-10 21:00:00,20,31,23,74,444
2016-06-10 21:10:00,10,16,10,36,216
2016-06-10 21:20:00,4,5,5,14,84
2016-06-10 21:30:00,1,2,1,4,24
2016-06-10 21:40:00,0,0,0,0,0
2016-06-10 21:50:00,0,0,0,0,0
2016-06-10 22:00:00,0,0,0,0,0
2016-06-10 22:10:00,0,0,0,0,0
2016-06-10 22:20:00,0,0,0,0,0
2016-06-11 03:50:00,0,0,0,0,0
2016-06-11 04:00:00,0,0,0,0,0
2016-06-11 04:10:00,0,0,0,0,0
2016-06-11 04:20:00,0,0,0,0,0
2016-06-11 04:30:00,0,0,0,0,0
2016-06-11 04:40:00,0,1,0,1,6
2016-06-11 04:50:00,1,6,3,10,60
2016-06-11 05:00:00,2,9,7,18,108
2016-06-11 05:10:00,3,13,11,27,162
2016-06-11 05:20:00,4,20,11,35,210
2016-06-11 05:30:00,5,25,12,42,252
2016-06-11 05:40:00,10,24,16,50,300
2016-06-11 05:50:00,9,28,20,57,342
2016-06-11 06:00:00,12,35,21,68,408
2016-06-11 06:10:00,9,40,27,76,456
2016-06-11 06:20:00,18,36,30,84,504
2016-06-11 06:30:00,17,41,34,92,552
2016-06-11 06:40:00,14,51,34,99,594
2016-06-11 06:50:00,19,51,34,104,624
2016-06-11 07:00:00,23,51,37,111,666
2016-06-11 07:10:00,37,118,112,267,1602
2016-06-11 07:20:00,101,146,140,387,2322
2016-06-11 07:30:00,114,242,154,510,3060
2016-06-11 07:40:00,213,233,199,645,3870
2016-06-11 07:50:00,247,274,266,787,4722
2016-06-11 08:00:00,298,325,315,938,5628
2016-06-11 08:10:00,351,374,365,1090,6540
2016-06-11 08:20:00,395,422,410,1227,7362
2016-06-11 08:30:00,436,467,457,1360,8160
2016-06-11 08:40:00,524,560,548,1632,9792
2016-06-11 08:50:00,565,589,575,1729,10374
2016-06-11 09:00:00,611,642,626,1879,11274
2016-06-11 09:10:00,647,686,670,2003,12018
2016-06-11 09:20:00,697,719,707,2123,12738
2016-06-11 09:30:00,737,761,747,2245,13470
2016-06-11 09:40:00,778,805,792,2375,14250
2016-06-11 09:50:00,800,835,825,2460,14760
2016-06-11 10:00:00,833,866,856,2555,15330
2016-06-11 10:10:00,866,895,878,2639,15834
2016-06-11 10:20:00,887,923,908,2718,16308
2016-06-11 10:30:00,911,947,930,2788,16728
2016-06-11 10:40:00,924,954,945,2823,16938
2016-06-11 10:50:00,951,978,965,2894,17364
2016-06-11 11:00:00,957,971,970,2898,17388
2016-06-11 11:10:00,967,1001,988,2956,17736
2016-06-11 11:20:00,992,1031,1019,3042,18252
2016-06-11 11:30:00,885,913,905,2703,16218
2016-06-11 11:40:00,901,926,923,2750,16500
2016-06-11 11:50:00,1045,1064,1052,3161,18966
2016-06-11 12:00:00,1052,1079,1051,3182,19092
2016-06-11 12:10:00,943,965,943,2851,17106
2016-06-11 12:20:00,1088,1115,1099,3302,19812
2016-06-11 12:30:00,1090,1109,1096,3295,19770
2016-06-11 12:40:00,982,1003,993,2978,17868
2016-06-11 12:50:00,1095,1080,1102,3277,19662
2016-06-11 13:00:00,1096,1099,1100,3295,19770
2016-06-11 13:10:00,1069,1098,1080,3247,19482
2016-06-11 13:20:00,1084,1106,1097,3287,19722
2016-06-11 13:30:00,1077,1068,1087,3232,19392
2016-06-11 13:40:00,1089,1040,1089,3218,19308
2016-06-11 13:50:00,1059,1083,1074,3216,19296
2016-06-11 14:00:00,1077,1057,1084,3218,19308
2016-06-11 14:10:00,1066,1034,1072,3172,19032
2016-06-11 14:20:00,1029,1059,1044,3132,18792
2016-06-11 14:30:00,1032,1027,1044,3103,18618
2016-06-11 14:40:00,1040,987,1034,3061,18366
2016-06-11 14:50:00,995,1014,1010,3019,18114
2016-06-11 15:00:00,972,1006,991,2969,17814
2016-06-11 15:10:00,945,979,968,2892,17352
2016-06-11 15:20:00,925,963,953,2841,17046
2016-06-11 15:30:00,917,929,924,2770,16620
2016-06-11 15:40:00,905,881,905,2691,16146
2016-06-11 15:50:00,855,887,868,2610,15660
2016-06-11 16:00:00,830,857,839,2526,15156
2016-06-11 16:10:00,803,824,821,2448,14688
2016-06-11 16:20:00,767,795,783,2345,14070
2016-06-11 16:30:00,726,748,743,2217,13302
2016-06-11 16:40:00,687,714,708,2109,12654
2016-06-11 16:50:00,651,681,674,2006,12036
2016-06-11 17:00:00,608,640,635,1883,11298
2016-06-11 17:10:00,565,605,592,1762,10572
2016-06-11 17:20:00,527,561,553,1641,9846
2016-06-11 17:30:00,484,506,503,1493,8958
2016-06-11 17:40:00,441,468,462,1371,8226
2016-06-11 17:50:00,388,416,411,1215,7290
2016-06-11 18:00:00,350,381,369,1100,6600
2016-06-11 18:10:00,301,332,320,953,5718
2016-06-11 18:20:00,260,286,280,826,4956
2016-06-11 18:30:00,215,236,232,683,4098
2016-06-11 18:40:00,177,199,195,571,3426
2016-06-11 18:50:00,137,160,155,452,2712
2016-06-11 19:00:00,103,125,120,348,2088
2016-06-11 19:10:00,81,109,56,246,1476
2016-06-11 19:20:00,40,61,72,173,1038
2016-06-11 19:30:00,30,53,37,120,720
2016-06-11 19:40:00,29,47,27,103,618
2016-06-11 19:50:00,16,38,41,95,570
2016-06-11 20:00:00,18,29,42,89,534
2016-06-11 20:10:00,14,39,28,81,486
2016-06-11 20:20:00,12,37,26,75,450
2016-06-11 20:30:00,12,31,23,66,396
2016-06-11 20:40:00,9,29,19,57,342
2016-06-11 20:50:00,8,26,13,47,282
2016-06-11 21:00:00,6,21,5,32,192
2016-06-11 21:10:00,3,15,2,20,120
2016-06-11 21:20:00,3,6,1,10,60
2016-06-11 21:30:00,1,2,0,3,18
2016-06-11 21:40:00,0,0,0,0,0
2016-06-11 21:50:00,0,0,0,0,0
2016-06-11 22:00:00,0,0,0,0,0
2016-06-11 22:10:00,0,0,0,0,0
2016-06-11 22:20:00,0,0,0,0,0
2016-06-12 03:50:00,0,0,0,0,0
2016-06-12 04:00:00,0,0,0,0,0
2016-06-12 04:10:00,0,0,0,0,0
2016-06-12 04:20:00,0,0,0,0,0
2016-06-12 04:30:00,0,0,0,0,0
2016-06-12 04:40:00,0,1,1,2,12
2016-06-12 04:50:00,2,3,6,11,66
2016-06-12 05:00:00,7,7,10,24,144
2016-06-12 05:10:00,7,23,14,44,264
2016-06-12 05:20:00,8,31,9,48,288
2016-06-12 05:30:00,8,32,10,50,300
2016-06-12 05:40:00,8,36,11,55,330
2016-06-12 05:50:00,13,33,17,63,378
2016-06-12 06:00:00,15,39,18,72,432
2016-06-12 06:10:00,11,44,27,82,492
2016-06-12 06:20:00,12,44,34,90,540
2016-06-12 06:30:00,11,51,36,98,588
2016-06-12 06:40:00,13,55,37,105,630
2016-06-12 06:50:00,16,50,27,93,558
2016-06-12 07:00:00,28,79,54,161,966
2016-06-12 07:10:00,27,138,136,301,1806
2016-06-12 07:20:00,78,171,156,405,2430
2016-06-12 07:30:00,133,215,173,521,3126
2016-06-12 07:40:00,194,266,190,650,3900
2016-06-12 07:50:00,250,274,266,790,4740
2016-06-12 08:00:00,299,323,314,936,5616
2016-06-12 08:10:00,344,373,362,1079,6474
2016-06-12 08:20:00,383,419,405,1207,7242
2016-06-12 08:30:00,441,466,455,1362,8172
2016-06-12 08:40:00,498,524,514,1536,9216
2016-06-12 08:50:00,550,578,569,1697,10182
2016-06-12 09:00:00,595,625,612,1832,10992
2016-06-12 09:10:00,634,662,643,1939,11634
2016-06-12 09:20:00,672,705,686,2063,12378
2016-06-12 09:30:00,721,751,734,2206,13236
2016-06-12 09:40:00,765,788,769,2322,13932
2016-06-12 09:50:00,798,824,803,2425,14550
2016-06-12 10:00:00,826,857,840,2523,15138
2016-06-12 10:10:00,840,903,884,2627,15762
2016-06-12 10:20:00,832,884,867,2583,15498
2016-06-12 10:30:00,889,927,901,2717,16302
2016-06-12 10:40:00,882,894,874,2650,15900
2016-06-12 10:50:00,939,955,936,2830,16980
2016-06-12 11:00:00,883,906,893,2682,16092
2016-06-12 11:10:00,870,889,868,2627,15762
2016-06-12 11:20:00,977,949,970,2896,17376
2016-06-12 11:30:00,995,981,993,2969,17814
2016-06-12 11:40:00,1005,1019,1031,3055,18330
2016-06-12 11:50:00,941,965,957,2863,17178
2016-06-12 12:00:00,817,856,839,2512,15072
2016-06-12 12:10:00,849,874,848,2571,15426
2016-06-12 12:20:00,652,678,656,1986,11916
2016-06-12 12:30:00,481,505,495,1481,8886
2016-06-12 12:40:00,613,631,623,1867,11202
2016-06-12 12:50:00,693,715,694,2102,12612
2016-06-12 13:00:00,429,452,437,1318,7908
2016-06-12 13:10:00,296,314,306,916,5496
2016-06-12 13:20:00,679,707,690,2076,12456
2016-06-12 13:30:00,543,565,555,1663,9978
2016-06-12 13:40:00,641,664,654,1959,11754
2016-06-12 13:50:00,594,624,614,1832,10992
2016-06-12 14:00:00,551,572,567,1690,10140
2016-06-12 14:10:00,505,528,520,1553,9318
2016-06-12 14:20:00,542,568,555,1665,9990
2016-06-12 14:30:00,870,895,883,2648,15888
2016-06-12 14:40:00,701,709,716,2126,12756
2016-06-12 14:50:00,851,800,850,2501,15006
2016-06-12 15:00:00,1018,970,1011,2999,17994
2016-06-12 15:10:00,673,704,692,2069,12414
2016-06-12 15:20:00,982,1012,996,2990,17940
2016-06-12 15:30:00,762,788,779,2329,13974
2016-06-12 15:40:00,856,884,874,2614,15684
2016-06-12 15:50:00,825,847,832,2504,15024
2016-06-12 16:00:00,553,566,562,1681,10086
2016-06-12 16:10:00,778,739,771,2288,13728
2016-06-12 16:20:00,384,396,395,1175,7050
2016-06-12 16:30:00,450,471,463,1384,8304
2016-06-12 16:40:00,381,402,394,1177,7062
2016-06-12 16:50:00,281,294,295,870,5220
2016-06-12 17:00:00,292,288,301,881,5286
2016-06-12 17:10:00,217,220,230,667,4002
2016-06-12 17:20:00,155,171,169,495,2970
2016-06-12 17:30:00,153,175,169,497,2982
2016-06-12 17:40:00,147,244,173,564,3384
2016-06-12 17:50:00,251,337,232,820,4920
2016-06-12 18:00:00,418,454,441,1313,7878
2016-06-12 18:10:00,389,416,410,1215,7290
2016-06-12 18:20:00,267,293,288,848,5088
2016-06-12 18:30:00,111,133,130,374,2244
2016-06-12 18:40:00,163,192,176,531,3186
2016-06-12 18:50:00,172,201,193,566,3396
2016-06-12 19:00:00,161,187,180,528,3168
2016-06-12 19:10:00,122,58,140,320,1920
2016-06-12 19:20:00,69,61,88,218,1308
2016-06-12 19:30:00,51,52,64,167,1002
2016-06-12 19:40:00,53,65,75,193,1158
2016-06-12 19:50:00,31,55,38,124,744
2016-06-12 20:00:00,18,45,24,87,522
2016-06-12 20:10:00,28,55,40,123,738
2016-06-12 20:20:00,46,58,56,160,960
2016-06-12 20:30:00,38,55,60,153,918
2016-06-12 20:40:00,32,48,42,122,732
2016-06-12 20:50:00,14,25,21,60,360
2016-06-12 21:00:00,7,18,13,38,228
2016-06-12 21:10:00,7,21,13,41,246
2016-06-12 21:20:00,7,21,12,40,240
2016-06-12 21:30:00,3,8,4,15,90
2016-06-12 21:40:00,0,0,0,0,0
2016-06-12 21:50:00,0,0,0,0,0
2016-06-12 22:00:00,0,0,0,0,0
2016-06-12 22:10:00,0,0,0,0,0
2016-06-12 22:20:00,0,0,0,0,0
2016-06-13 03:50:00,0,0,0,0,0
2016-06-13 04:00:00,0,0,0,0,0
2016-06-13 04:10:00,0,0,0,0,0
2016-06-13 04:20:00,0,0,0,0,0
2016-06-13 04:30:00,0,0,0,0,0
2016-06-13 04:40:00,0,0,0,0,0
2016-06-13 04:50:00,1,4,3,8,48
2016-06-13 05:00:00,3,8,3,14,84
2016-06-13 05:10:00,9,13,11,33,198
2016-06-13 05:20:00,13,29,17,59,354
2016-06-13 05:30:00,14,23,18,55,330
2016-06-13 05:40:00,21,29,26,76,456
2016-06-13 05:50:00,25,44,24,93,558
2016-06-13 06:00:00,29,52,29,110,660
2016-06-13 06:10:00,26,65,29,120,720
2016-06-13 06:20:00,43,60,49,152,912
2016-06-13 06:30:00,57,45,70,172,1032
2016-06-13 06:40:00,62,85,67,214,1284
2016-06-13 06:50:00,76,81,82,239,1434
2016-06-13 07:00:00,90,117,105,312,1872
2016-06-13 07:10:00,102,131,138,371,2226
2016-06-13 07:20:00,116,150,135,401,2406
2016-06-13 07:30:00,113,257,120,490,2940
2016-06-13 07:40:00,174,214,155,543,3258
2016-06-13 07:50:00,249,171,148,568,3408
2016-06-13 08:00:00,194,223,202,619,3714
2016-06-13 08:10:00,121,169,304,594,3564
2016-06-13 08:20:00,168,222,309,699,4194
2016-06-13 08:30:00,263,292,285,840,5040
2016-06-13 08:40:00,323,356,348,1027,6162
2016-06-13 08:50:00,279,301,302,882,5292
2016-06-13 09:00:00,261,282,282,825,4950
2016-06-13 09:10:00,310,331,330,971,5826
2016-06-13 09:20:00,441,466,462,1369,8214
2016-06-13 09:30:00,566,588,581,1735,10410
2016-06-13 09:40:00,672,694,691,2057,12342
2016-06-13 09:50:00,459,484,480,1423,8538
2016-06-13 10:00:00,402,429,422,1253,7518
2016-06-13 10:10:00,323,345,343,1011,6066
2016-06-13 10:20:00,282,302,302,886,5316
2016-06-13 10:30:00,357,379,378,1114,6684
2016-06-13 10:40:00,496,519,513,1528,9168
2016-06-13 10:50:00,480,498,500,1478,8868
2016-06-13 11:00:00,392,419,414,1225,7350
2016-06-13 11:10:00,415,442,436,1293,7758
2016-06-13 11:20:00,292,315,310,917,5502
2016-06-13 11:30:00,280,300,298,878,5268
2016-06-13 11:40:00,279,300,298,877,5262
2016-06-13 11:50:00,197,200,196,593,3558
2016-06-13 12:00:00,182,137,167,486,2916
2016-06-13 12:10:00,332,337,338,1007,6042
2016-06-13 12:20:00,279,225,229,733,4398
2016-06-13 12:30:00,103,104,101,308,1848
2016-06-13 12:40:00,114,116,123,353,2118
2016-06-13 12:50:00,138,89,121,348,2088
2016-06-13 13:00:00,85,89,90,264,1584
2016-06-13 13:10:00,182,273,54,509,3054
2016-06-13 13:20:00,228,218,230,676,4056
2016-06-13 13:30:00,93,94,107,294,1764
2016-06-13 13:40:00,45,88,73,206,1236
2016-06-13 13:50:00,62,83,73,218,1308
2016-06-13 14:00:00,141,243,54,438,2628
2016-06-13 14:10:00,326,344,324,994,5964
2016-06-13 14:20:00,276,298,291,865,5190
2016-06-13 14:30:00,193,216,211,620,3720
2016-06-13 14:40:00,250,182,215,647,3882
2016-06-13 14:50:00,232,252,249,733,4398
2016-06-13 15:00:00,224,244,241,709,4254
2016-06-13 15:10:00,254,275,269,798,4788
2016-06-13 15:20:00,319,340,336,995,5970
2016-06-13 15:30:00,329,352,349,1030,6180
2016-06-13 15:40:00,290,314,312,916,5496
2016-06-13 15:50:00,191,213,211,615,3690
2016-06-13 16:00:00,131,152,149,432,2592
2016-06-13 16:10:00,278,236,224,738,4428
2016-06-13 16:20:00,178,198,194,570,3420
2016-06-13 16:30:00,161,182,177,520,3120
2016-06-13 16:40:00,277,183,208,668,4008
2016-06-13 16:50:00,297,313,303,913,5478
2016-06-13 17:00:00,279,298,288,865,5190
2016-06-13 17:10:00,261,283,274,818,4908
2016-06-13 17:20:00,242,266,256,764,4584
2016-06-13 17:30:00,228,256,246,730,4380
2016-06-13 17:40:00,171,220,169,560,3360
2016-06-13 17:50:00,148,174,167,489,2934
2016-06-13 18:00:00,132,156,151,439,2634
2016-06-13 18:10:00,122,199,100,421,2526
2016-06-13 18:20:00,73,87,86,246,1476
2016-06-13 18:30:00,104,133,120,357,2142
2016-06-13 18:40:00,119,138,174,431,2586
2016-06-13 18:50:00,31,192,302,525,3150
2016-06-13 19:00:00,3,183,307,493,2958
2016-06-13 19:10:00,141,311,58,510,3060
2016-06-13 19:20:00,95,110,123,328,1968
2016-06-13 19:30:00,64,67,91,222,1332
2016-06-13 19:40:00,51,56,68,175,1050
2016-06-13 19:50:00,35,46,39,120,720
2016-06-13 20:00:00,51,47,52,150,900
2016-06-13 20:10:00,55,61,80,196,1176
2016-06-13 20:20:00,39,54,41,134,804
2016-06-13 20:30:00,21,30,28,79,474
2016-06-13 20:40:00,17,27,10,54,324
2016-06-13 20:50:00,13,20,9,42,252
2016-06-13 21:00:00,9,14,7,30,180
2016-06-13 21:10:00,3,4,3,10,60
2016-06-13 21:20:00,0,0,0,0,0
2016-06-13 21:30:00,0,0,0,0,0
2016-06-13 21:40:00,0,0,0,0,0
2016-06-13 21:50:00,0,0,0,0,0
2016-06-13 22:00:00,0,0,0,0,0
2016-06-13 22:10:00,0,0,0,0,0
2016-06-14 03:50:00,0,0,0,0,0
2016-06-14 04:00:00,0,0,0,0,0
2016-06-14 04:10:00,0,0,0,0,0
2016-06-14 04:20:00,0,0,0,0,0
2016-06-14 04:30:00,0,0,0,0,0
2016-06-14 04:40:00,0,0,0,0,0
2016-06-14 04:50:00,0,0,0,0,0
2016-06-14 05:00:00,3,6,3,12,72
2016-06-14 05:10:00,5,13,6,24,144
2016-06-14 05:20:00,3,12,5,20,120
2016-06-14 05:30:00,13,25,20,58,348
2016-06-14 05:40:00,27,52,35,114,684
2016-06-14 05:50:00,32,51,32,115,690
2016-06-14 06:00:00,27,73,29,129,774
2016-06-14 06:10:00,48,61,68,177,1062
2016-06-14 06:20:00,27,70,42,139,834
2016-06-14 06:30:00,36,55,31,122,732
2016-06-14 06:40:00,33,72,54,159,954
2016-06-14 06:50:00,27,61,44,132,792
2016-06-14 07:00:00,21,70,32,123,738
2016-06-14 07:10:00,13,89,78,180,1080
2016-06-14 07:20:00,21,82,70,173,1038
2016-06-14 07:30:00,30,70,66,166,996
2016-06-14 07:40:00,36,53,54,143,858
2016-06-14 07:50:00,32,67,67,166,996
2016-06-14 08:00:00,19,97,111,227,1362
2016-06-14 08:10:00,18,86,63,167,1002
2016-06-14 08:20:00,30,72,57,159,954
2016-06-14 08:30:00,31,91,70,192,1152
2016-06-14 08:40:00,26,61,31,118,708
2016-06-14 08:50:00,38,87,62,187,1122
2016-06-14 09:00:00,64,95,91,250,1500
2016-06-14 09:10:00,78,146,121,345,2070
2016-06-14 09:20:00,36,106,90,232,1392
2016-06-14 09:30:00,40,78,60,178,1068
2016-06-14 09:40:00,64,87,66,217,1302
2016-06-14 09:50:00,25,138,128,291,1746
2016-06-14 10:00:00,50,95,96,241,1446
2016-06-14 10:10:00,0,141,142,283,1698
2016-06-14 10:20:00,31,81,62,174,1044
2016-06-14 10:30:00,33,67,42,142,852
2016-06-14 10:40:00,46,82,64,192,1152
2016-06-14 10:50:00,62,80,75,217,1302
2016-06-14 11:00:00,78,71,84,233,1398
2016-06-14 11:10:00,45,91,83,219,1314
2016-06-14 11:20:00,38,97,89,224,1344
2016-06-14 11:30:00,33,108,105,246,1476
2016-06-14 11:40:00,39,114,110,263,1578
2016-06-14 11:50:00,151,213,65,429,2574
2016-06-14 12:00:00,109,215,76,400,2400
2016-06-14 12:10:00,42,142,144,328,1968
2016-06-14 12:20:00,51,151,139,341,2046
2016-06-14 12:30:00,36,135,117,288,1728
2016-06-14 12:40:00,3,138,134,275,1650
2016-06-14 12:50:00,44,104,86,234,1404
2016-06-14 13:00:00,41,99,86,226,1356
2016-06-14 13:10:00,19,103,88,210,1260
2016-06-14 13:20:00,40,103,81,224,1344
2016-06-14 13:30:00,25,76,79,180,1080
2016-06-14 13:40:00,30,61,67,158,948
2016-06-14 13:50:00,13,112,107,232,1392
2016-06-14 14:00:00,6,125,118,249,1494
2016-06-14 14:10:00,25,111,92,228,1368
2016-06-14 14:20:00,10,120,111,241,1446
2016-06-14 14:30:00,27,158,140,325,1950
2016-06-14 14:40:00,71,205,117,393,2358
2016-06-14 14:50:00,44,147,131,322,1932
2016-06-14 15:00:00,71,140,115,326,1956
2016-06-14 15:10:00,7,146,144,297,1782
2016-06-14 15:20:00,45,128,121,294,1764
2016-06-14 15:30:00,18,141,136,295,1770
2016-06-14 15:40:00,21,152,140,313,1878
2016-06-14 15:50:00,36,104,96,236,1416
2016-06-14 16:00:00,48,71,64,183,1098
2016-06-14 16:10:00,27,76,80,183,1098
2016-06-14 16:20:00,36,68,65,169,1014
2016-06-14 16:30:00,35,69,55,159,954
2016-06-14 16:40:00,12,55,33,100,600
2016-06-14 16:50:00,16,101,92,209,1254
2016-06-14 17:00:00,14,112,108,234,1404
2016-06-14 17:10:00,25,91,90,206,1236
2016-06-14 17:20:00,14,58,37,109,654
2016-06-14 17:30:00,12,45,27,84,504
2016-06-14 17:40:00,10,47,29,86,516
2016-06-14 17:50:00,11,53,35,99,594
2016-06-14 18:00:00,12,60,41,113,678
2016-06-14 18:10:00,36,39,33,108,648
2016-06-14 18:20:00,17,52,38,107,642
2016-06-14 18:30:00,23,69,31,123,738
2016-06-14 18:40:00,12,84,75,171,1026
2016-06-14 18:50:00,18,83,63,164,984
2016-06-14 19:00:00,21,78,29,128,768
2016-06-14 19:10:00,27,59,36,122,732
2016-06-14 19:20:00,29,16,37,82,492
2016-06-14 19:30:00,20,23,27,70,420
2016-06-14 19:40:00,2,9,6,17,102
2016-06-14 19:50:00,0,3,1,4,24
2016-06-14 20:00:00,0,0,0,0,0
2016-06-14 20:10:00,3,13,2,18,108
2016-06-14 20:20:00,2,14,1,17,102
2016-06-14 20:30:00,0,3,0,3,18
2016-06-14 20:40:00,1,5,0,6,36
2016-06-14 20:50:00,0,3,1,4,24
2016-06-14 21:00:00,0,0,0,0,0
2016-06-14 21:10:00,0,0,0,0,0
2016-06-14 21:20:00,0,0,0,0,0
2016-06-14 21:30:00,0,0,0,0,0
2016-06-14 21:40:00,0,0,0,0,0
2016-06-15 04:10:00,0,0,0,0,0
2016-06-15 04:20:00,0,0,0,0,0
2016-06-15 04:30:00,0,0,0,0,0
2016-06-15 04:40:00,0,0,0,0,0
2016-06-15 04:50:00,0,0,0,0,0
2016-06-15 05:00:00,1,2,3,6,36
2016-06-15 05:10:00,4,9,5,18,108
2016-06-15 05:20:00,7,21,6,34,204
2016-06-15 05:30:00,7,36,17,60,360
2016-06-15 05:40:00,11,42,18,71,426
2016-06-15 05:50:00,13,39,14,66,396
2016-06-15 06:00:00,18,80,52,150,900
2016-06-15 06:10:00,13,33,22,68,408
2016-06-15 06:20:00,14,26,22,62,372
2016-06-15 06:30:00,43,85,68,196,1176
2016-06-15 06:40:00,32,113,107,252,1512
2016-06-15 06:50:00,27,73,44,144,864
2016-06-15 07:00:00,30,84,60,174,1044
2016-06-15 07:10:00,17,101,86,204,1224
2016-06-15 07:20:00,0,139,137,276,1656
2016-06-15 07:30:00,0,135,141,276,1656
2016-06-15 07:40:00,6,122,127,255,1530
2016-06-15 07:50:00,63,115,102,280,1680
2016-06-15 08:00:00,100,122,130,352,2112
2016-06-15 08:10:00,134,198,214,546,3276
2016-06-15 08:20:00,261,287,276,824,4944
2016-06-15 08:30:00,428,454,440,1322,7932
2016-06-15 08:40:00,433,454,448,1335,8010
2016-06-15 08:50:00,456,474,470,1400,8400
2016-06-15 09:00:00,501,520,514,1535,9210
2016-06-15 09:10:00,504,524,518,1546,9276
2016-06-15 09:20:00,548,571,566,1685,10110
2016-06-15 09:30:00,323,348,341,1012,6072
2016-06-15 09:40:00,374,399,390,1163,6978
2016-06-15 09:50:00,390,413,405,1208,7248
2016-06-15 10:00:00,373,397,388,1158,6948
2016-06-15 10:10:00,445,467,457,1369,8214
2016-06-15 10:20:00,472,492,482,1446,8676
2016-06-15 10:30:00,830,854,834,2518,15108
2016-06-15 10:40:00,769,791,777,2337,14022
2016-06-15 10:50:00,868,890,871,2629,15774
2016-06-15 11:00:00,872,891,881,2644,15864
2016-06-15 11:10:00,851,874,864,2589,15534
2016-06-15 11:20:00,899,919,906,2724,16344
2016-06-15 11:30:00,965,987,972,2924,17544
2016-06-15 11:40:00,604,629,618,1851,11106
2016-06-15 11:50:00,562,589,580,1731,10386
2016-06-15 12:00:00,357,377,369,1103,6618
2016-06-15 12:10:00,350,374,366,1090,6540
2016-06-15 12:20:00,539,564,556,1659,9954
2016-06-15 12:30:00,560,583,576,1719,10314
2016-06-15 12:40:00,557,580,574,1711,10266
2016-06-15 12:50:00,553,578,570,1701,10206
2016-06-15 13:00:00,1088,1106,1109,3303,19818
2016-06-15 13:10:00,472,493,488,1453,8718
2016-06-15 13:20:00,916,942,932,2790,16740
2016-06-15 13:30:00,1007,1028,1012,3047,18282
2016-06-15 13:40:00,979,1000,986,2965,17790
2016-06-15 13:50:00,962,982,975,2919,17514
2016-06-15 14:00:00,969,992,981,2942,17652
2016-06-15 14:10:00,953,982,970,2905,17430
2016-06-15 14:20:00,929,949,938,2816,16896
2016-06-15 14:30:00,950,972,963,2885,17310
2016-06-15 14:40:00,938,961,952,2851,17106
2016-06-15 14:50:00,915,940,928,2783,16698
2016-06-15 15:00:00,844,875,867,2586,15516
2016-06-15 15:10:00,832,874,861,2567,15402
2016-06-15 15:20:00,813,865,854,2532,15192
2016-06-15 15:30:00,792,826,814,2432,14592
2016-06-15 15:40:00,786,812,804,2402,14412
2016-06-15 15:50:00,731,754,749,2234,13404
2016-06-15 16:00:00,752,775,772,2299,13794
2016-06-15 16:10:00,724,753,745,2222,13332
2016-06-15 16:20:00,523,548,542,1613,9678
2016-06-15 16:30:00,332,356,351,1039,6234
2016-06-15 16:40:00,438,464,457,1359,8154
2016-06-15 16:50:00,429,458,449,1336,8016
2016-06-15 17:00:00,393,419,415,1227,7362
2016-06-15 17:10:00,392,421,413,1226,7356
2016-06-15 17:20:00,228,253,248,729,4374
2016-06-15 17:30:00,206,233,225,664,3984
2016-06-15 17:40:00,97,202,161,460,2760
2016-06-15 17:50:00,155,302,134,591,3546
2016-06-15 18:00:00,111,275,64,450,2700
2016-06-15 18:10:00,45,159,158,362,2172
2016-06-15 18:20:00,17,137,138,292,1752
2016-06-15 18:30:00,85,52,113,250,1500
2016-06-15 18:40:00,89,147,155,391,2346
2016-06-15 18:50:00,97,155,131,383,2298
2016-06-15 19:00:00,105,37,127,269,1614
2016-06-15 19:10:00,61,71,92,224,1344
2016-06-15 19:20:00,55,54,69,178,1068
2016-06-15 19:30:00,18,50,37,105,630
2016-06-15 19:40:00,12,37,25,74,444
2016-06-15 19:50:00,11,21,19,51,306
2016-06-15 20:00:00,10,12,14,36,216
2016-06-15 20:10:00,4,11,8,23,138
2016-06-15 20:20:00,3,11,6,20,120
2016-06-15 20:30:00,4,12,6,22,132
2016-06-15 20:40:00,2,4,3,9,54
2016-06-15 20:50:00,0,0,0,0,0
2016-06-15 21:00:00,0,0,0,0,0
2016-06-15 21:10:00,0,0,0,0,0
2016-06-15 21:20:00,0,0,0,0,0
2016-06-15 21:30:00,0,0,0,0,0
2016-06-15 21:40:00,0,0,0,0,0
2016-06-15 21:50:00,0,0,0,0,0
2016-06-16 04:00:00,0,0,0,0,0
2016-06-16 04:10:00,0,0,0,0,0
2016-06-16 04:20:00,0,0,0,0,0
2016-06-16 04:30:00,0,0,0,0,0
2016-06-16 04:40:00,0,0,0,0,0
2016-06-16 04:50:00,0,0,0,0,0
2016-06-16 05:00:00,0,1,1,2,12
2016-06-16 05:10:00,6,8,11,25,150
2016-06-16 05:20:00,10,29,19,58,348
2016-06-16 05:30:00,27,48,29,104,624
2016-06-16 05:40:00,33,59,45,137,822
2016-06-16 05:50:00,38,56,46,140,840
2016-06-16 06:00:00,41,78,64,183,1098
2016-06-16 06:10:00,57,83,73,213,1278
2016-06-16 06:20:00,51,96,96,243,1458
2016-06-16 06:30:00,7,134,138,279,1674
2016-06-16 06:40:00,88,138,136,362,2172
2016-06-16 06:50:00,119,138,166,423,2538
2016-06-16 07:00:00,105,149,160,414,2484
2016-06-16 07:10:00,76,159,163,398,2388
2016-06-16 07:20:00,145,281,94,520,3120
2016-06-16 07:30:00,247,270,260,777,4662
2016-06-16 07:40:00,260,283,273,816,4896
2016-06-16 07:50:00,68,100,93,261,1566
2016-06-16 08:00:00,22,96,85,203,1218
2016-06-16 08:10:00,22,148,140,310,1860
2016-06-16 08:20:00,45,158,133,336,2016
2016-06-16 08:30:00,153,197,143,493,2958
2016-06-16 08:40:00,166,251,136,553,3318
2016-06-16 08:50:00,119,211,70,400,2400
2016-06-16 09:00:00,97,245,129,471,2826
2016-06-16 09:10:00,77,146,155,378,2268
2016-06-16 09:20:00,177,250,154,581,3486
2016-06-16 09:30:00,189,218,172,579,3474
2016-06-16 09:40:00,224,282,218,724,4344
2016-06-16 09:50:00,371,393,387,1151,6906
2016-06-16 10:00:00,373,394,389,1156,6936
2016-06-16 10:10:00,356,379,374,1109,6654
2016-06-16 10:20:00,430,454,447,1331,7986
2016-06-16 10:30:00,373,398,392,1163,6978
2016-06-16 10:40:00,379,402,398,1179,7074
2016-06-16 10:50:00,295,318,313,926,5556
2016-06-16 11:00:00,351,378,365,1094,6564
2016-06-16 11:10:00,473,498,483,1454,8724
2016-06-16 11:20:00,447,475,467,1389,8334
2016-06-16 11:30:00,430,452,446,1328,7968
2016-06-16 11:40:00,429,453,447,1329,7974
2016-06-16 11:50:00,418,439,434,1291,7746
2016-06-16 12:00:00,470,493,478,1441,8646
2016-06-16 12:10:00,487,523,508,1518,9108
2016-06-16 12:20:00,607,641,631,1879,11274
2016-06-16 12:30:00,599,624,618,1841,11046
2016-06-16 12:40:00,565,590,582,1737,10422
2016-06-16 12:50:00,525,550,544,1619,9714
2016-06-16 13:00:00,574,599,591,1764,10584
2016-06-16 13:10:00,529,555,545,1629,9774
2016-06-16 13:20:00,553,578,568,1699,10194
2016-06-16 13:30:00,578,604,595,1777,10662
2016-06-16 13:40:00,591,623,613,1827,10962
2016-06-16 13:50:00,486,512,505,1503,9018
2016-06-16 14:00:00,472,495,490,1457,8742
2016-06-16 14:10:00,494,516,512,1522,9132
2016-06-16 14:20:00,547,570,562,1679,10074
2016-06-16 14:30:00,521,543,533,1597,9582
2016-06-16 14:40:00,449,471,464,1384,8304
2016-06-16 14:50:00,592,614,603,1809,10854
2016-06-16 15:00:00,482,504,496,1482,8892
2016-06-16 15:10:00,347,369,363,1079,6474
2016-06-16 15:20:00,306,321,318,945,5670
2016-06-16 15:30:00,306,328,321,955,5730
2016-06-16 15:40:00,338,369,360,1067,6402
2016-06-16 15:50:00,398,423,412,1233,7398
2016-06-16 16:00:00,450,476,463,1389,8334
2016-06-16 16:10:00,462,484,472,1418,8508
2016-06-16 16:20:00,502,524,510,1536,9216
2016-06-16 16:30:00,517,544,529,1590,9540
2016-06-16 16:40:00,562,588,578,1728,10368
2016-06-16 16:50:00,305,331,323,959,5754
2016-06-16 17:00:00,583,606,593,1782,10692
2016-06-16 17:10:00,450,473,465,1388,8328
2016-06-16 17:20:00,469,492,476,1437,8622
2016-06-16 17:30:00,464,489,479,1432,8592
2016-06-16 17:40:00,409,432,421,1262,7572
2016-06-16 17:50:00,365,386,375,1126,6756
2016-06-16 18:00:00,308,333,320,961,5766
2016-06-16 18:10:00,231,260,250,741,4446
2016-06-16 18:20:00,246,273,265,784,4704
2016-06-16 18:30:00,210,234,229,673,4038
2016-06-16 18:40:00,185,208,200,593,3558
2016-06-16 18:50:00,146,166,158,470,2820
2016-06-16 19:00:00,92,116,109,317,1902
2016-06-16 19:10:00,31,89,75,195,1170
2016-06-16 19:20:00,28,78,33,139,834
2016-06-16 19:30:00,21,84,20,125,750
2016-06-16 19:40:00,13,55,35,103,618
2016-06-16 19:50:00,20,38,34,92,552
2016-06-16 20:00:00,15,40,29,84,504
2016-06-16 20:10:00,31,54,46,131,786
2016-06-16 20:20:00,24,32,32,88,528
2016-06-16 20:30:00,4,18,10,32,192
2016-06-16 20:40:00,1,13,4,18,108
2016-06-16 20:50:00,2,6,3,11,66
2016-06-16 21:00:00,0,6,1,7,42
2016-06-16 21:10:00,0,2,0,2,12
2016-06-16 21:20:00,0,0,0,0,0
2016-06-16 21:30:00,0,0,0,0,0
2016-06-16 21:40:00,0,0,0,0,0
2016-06-16 21:50:00,0,0,0,0,0
2016-06-16 22:00:00,0,0,0,0,0
2016-06-16 22:10:00,0,0,0,0,0
2016-06-16 22:20:00,0,0,0,0,0
2016-06-17 03:50:00,0,0,0,0,0
2016-06-17 04:00:00,0,0,0,0,0
2016-06-17 04:10:00,0,0,0,0,0
2016-06-17 04:20:00,0,0,0,0,0
2016-06-17 04:30:00,0,0,0,0,0
2016-06-17 04:40:00,1,3,3,7,42
2016-06-17 04:50:00,7,15,3,25,150
2016-06-17 05:00:00,6,28,10,44,264
2016-06-17 05:10:00,9,34,25,68,408
2016-06-17 05:20:00,13,37,22,72,432
2016-06-17 05:30:00,13,36,21,70,420
2016-06-17 05:40:00,11,44,19,74,444
2016-06-17 05:50:00,12,36,25,73,438
2016-06-17 06:00:00,27,60,27,114,684
2016-06-17 06:10:00,21,56,31,108,648
2016-06-17 06:20:00,32,64,35,131,786
2016-06-17 06:30:00,32,54,44,130,780
2016-06-17 06:40:00,23,68,55,146,876
2016-06-17 06:50:00,8,87,85,180,1080
2016-06-17 07:00:00,57,87,80,224,1344
2016-06-17 07:10:00,59,105,101,265,1590
2016-06-17 07:20:00,37,79,82,198,1188
2016-06-17 07:30:00,36,92,98,226,1356
2016-06-17 07:40:00,46,110,125,281,1686
2016-06-17 07:50:00,117,183,183,483,2898
2016-06-17 08:00:00,241,264,258,763,4578
2016-06-17 08:10:00,177,186,172,535,3210
2016-06-17 08:20:00,192,212,205,609,3654
2016-06-17 08:30:00,257,278,270,805,4830
2016-06-17 08:40:00,341,361,353,1055,6330
2016-06-17 08:50:00,354,375,370,1099,6594
2016-06-17 09:00:00,336,356,351,1043,6258
2016-06-17 09:10:00,361,381,375,1117,6702
2016-06-17 09:20:00,382,407,399,1188,7128
2016-06-17 09:30:00,444,468,461,1373,8238
2016-06-17 09:40:00,469,496,485,1450,8700
2016-06-17 09:50:00,444,466,455,1365,8190
2016-06-17 10:00:00,648,672,660,1980,11880
2016-06-17 10:10:00,576,600,591,1767,10602
2016-06-17 10:20:00,608,632,625,1865,11190
2016-06-17 10:30:00,431,452,448,1331,7986
2016-06-17 10:40:00,552,575,568,1695,10170
2016-06-17 10:50:00,571,593,586,1750,10500
2016-06-17 11:00:00,636,658,650,1944,11664
2016-06-17 11:10:00,389,417,410,1216,7296
2016-06-17 11:20:00,417,438,433,1288,7728
2016-06-17 11:30:00,534,556,552,1642,9852
2016-06-17 11:40:00,563,586,588,1737,10422
2016-06-17 11:50:00,529,552,547,1628,9768
2016-06-17 12:00:00,556,579,570,1705,10230
2016-06-17 12:10:00,402,429,424,1255,7530
2016-06-17 12:20:00,392,417,413,1222,7332
2016-06-17 12:30:00,554,575,575,1704,10224
2016-06-17 12:40:00,589,611,609,1809,10854
2016-06-17 12:50:00,553,575,566,1694,10164
2016-06-17 13:00:00,478,500,492,1470,8820
2016-06-17 13:10:00,661,689,678,2028,12168
2016-06-17 13:20:00,551,582,570,1703,10218
2016-06-17 13:30:00,468,496,490,1454,8724
2016-06-17 13:40:00,486,513,507,1506,9036
2016-06-17 13:50:00,606,633,620,1859,11154
2016-06-17 14:00:00,845,868,855,2568,15408
2016-06-17 14:10:00,845,863,845,2553,15318
2016-06-17 14:20:00,796,826,820,2442,14652
2016-06-17 14:30:00,907,929,916,2752,16512
2016-06-17 14:40:00,905,920,897,2722,16332
2016-06-17 14:50:00,845,873,857,2575,15450
2016-06-17 15:00:00,783,811,800,2394,14364
2016-06-17 15:10:00,678,702,693,2073,12438
2016-06-17 15:20:00,653,678,669,2000,12000
2016-06-17 15:30:00,712,730,713,2155,12930
2016-06-17 15:40:00,810,832,818,2460,14760
2016-06-17 15:50:00,825,819,843,2487,14922
2016-06-17 16:00:00,787,812,804,2403,14418
2016-06-17 16:10:00,732,753,746,2231,13386
2016-06-17 16:20:00,701,722,718,2141,12846
2016-06-17 16:30:00,669,691,687,2047,12282
2016-06-17 16:40:00,638,655,653,1946,11676
2016-06-17 16:50:00,607,619,616,1842,11052
2016-06-17 17:00:00,578,596,584,1758,10548
2016-06-17 17:10:00,568,589,575,1732,10392
2016-06-17 17:20:00,268,288,280,836,5016
2016-06-17 17:30:00,309,331,326,966,5796
2016-06-17 17:40:00,292,314,311,917,5502
2016-06-17 17:50:00,261,284,279,824,4944
2016-06-17 18:00:00,246,267,262,775,4650
2016-06-17 18:10:00,257,278,275,810,4860
2016-06-17 18:20:00,184,270,197,651,3906
2016-06-17 18:30:00,109,260,128,497,2982
2016-06-17 18:40:00,139,315,34,488,2928
2016-06-17 18:50:00,76,121,121,318,1908
2016-06-17 19:00:00,62,79,91,232,1392
2016-06-17 19:10:00,71,97,100,268,1608
2016-06-17 19:20:00,35,62,53,150,900
2016-06-17 19:30:00,26,63,22,111,666
2016-06-17 19:40:00,28,62,34,124,744
2016-06-17 19:50:00,21,47,23,91,546
2016-06-17 20:00:00,28,66,42,136,816
2016-06-17 20:10:00,52,83,77,212,1272
2016-06-17 20:20:00,75,129,113,317,1902
2016-06-17 20:30:00,67,82,80,229,1374
2016-06-17 20:40:00,57,78,69,204,1224
2016-06-17 20:50:00,31,60,38,129,774
2016-06-17 21:00:00,25,38,25,88,528
2016-06-17 21:10:00,13,20,19,52,312
2016-06-17 21:20:00,6,12,9,27,162
2016-06-17 21:30:00,4,5,3,12,72
2016-06-17 21:40:00,0,0,0,0,0
2016-06-17 21:50:00,0,0,0,0,0
2016-06-17 22:00:00,0,0,0,0,0
2016-06-17 22:10:00,0,0,0,0,0
2016-06-17 22:20:00,0,0,0,0,0
2016-06-18 03:50:00,0,0,0,0,0
2016-06-18 04:00:00,0,0,0,0,0
2016-06-18 04:10:00,0,0,0,0,0
2016-06-18 04:20:00,0,0,0,0,0
2016-06-18 04:30:00,0,0,0,0,0
2016-06-18 04:40:00,0,0,0,0,0
2016-06-18 04:50:00,0,0,0,0,0
2016-06-18 05:00:00,1,1,0,2,12
2016-06-18 05:10:00,7,13,11,31,186
2016-06-18 05:20:00,9,21,14,44,264
2016-06-18 05:30:00,13,24,16,53,318
2016-06-18 05:40:00,17,28,20,65,390
2016-06-18 05:50:00,25,58,33,116,696
2016-06-18 06:00:00,26,56,28,110,660
2016-06-18 06:10:00,26,47,28,101,606
2016-06-18 06:20:00,44,67,51,162,972
2016-06-18 06:30:00,84,117,105,306,1836
2016-06-18 06:40:00,57,121,102,280,1680
2016-06-18 06:50:00,35,77,49,161,966
2016-06-18 07:00:00,37,59,57,153,918
2016-06-18 07:10:00,58,79,81,218,1308
2016-06-18 07:20:00,116,133,137,386,2316
2016-06-18 07:30:00,146,173,173,492,2952
2016-06-18 07:40:00,165,188,184,537,3222
2016-06-18 07:50:00,163,184,182,529,3174
2016-06-18 08:00:00,164,186,184,534,3204
2016-06-18 08:10:00,200,223,221,644,3864
2016-06-18 08:20:00,313,338,330,981,5886
2016-06-18 08:30:00,409,439,427,1275,7650
2016-06-18 08:40:00,423,450,441,1314,7884
2016-06-18 08:50:00,424,447,443,1314,7884
2016-06-18 09:00:00,495,523,517,1535,9210
2016-06-18 09:10:00,462,480,483,1425,8550
2016-06-18 09:20:00,567,591,591,1749,10494
2016-06-18 09:30:00,352,374,376,1102,6612
2016-06-18 09:40:00,720,748,741,2209,13254
2016-06-18 09:50:00,419,444,438,1301,7806
2016-06-18 10:00:00,265,290,286,841,5046
2016-06-18 10:10:00,261,286,283,830,4980
2016-06-18 10:20:00,261,284,283,828,4968
2016-06-18 10:30:00,115,137,135,387,2322
2016-06-18 10:40:00,167,148,173,488,2928
2016-06-18 10:50:00,303,329,324,956,5736
2016-06-18 11:00:00,761,793,789,2343,14058
2016-06-18 11:10:00,613,641,637,1891,11346
2016-06-18 11:20:00,786,816,804,2406,14436
2016-06-18 11:30:00,915,952,934,2801,16806
2016-06-18 11:40:00,725,761,756,2242,13452
2016-06-18 11:50:00,522,552,548,1622,9732
2016-06-18 12:00:00,602,634,631,1867,11202
2016-06-18 12:10:00,689,731,728,2148,12888
2016-06-18 12:20:00,910,938,938,2786,16716
2016-06-18 12:30:00,999,1031,1031,3061,18366
2016-06-18 12:40:00,998,1025,1020,3043,18258
2016-06-18 12:50:00,857,880,879,2616,15696
2016-06-18 13:00:00,539,564,559,1662,9972
2016-06-18 13:10:00,908,929,936,2773,16638
2016-06-18 13:20:00,1007,1032,1026,3065,18390
2016-06-18 13:30:00,907,931,920,2758,16548
2016-06-18 13:40:00,863,890,889,2642,15852
2016-06-18 13:50:00,883,909,903,2695,16170
2016-06-18 14:00:00,899,922,915,2736,16416
2016-06-18 14:10:00,1017,1038,1039,3094,18564
2016-06-18 14:20:00,688,713,710,2111,12666
2016-06-18 14:30:00,390,408,408,1206,7236
2016-06-18 14:40:00,965,991,981,2937,17622
2016-06-18 14:50:00,650,678,672,2000,12000
2016-06-18 15:00:00,802,836,827,2465,14790
2016-06-18 15:10:00,553,583,577,1713,10278
2016-06-18 15:20:00,498,525,520,1543,9258
2016-06-18 15:30:00,468,497,494,1459,8754
2016-06-18 15:40:00,409,436,429,1274,7644
2016-06-18 15:50:00,515,545,536,1596,9576
2016-06-18 16:00:00,691,724,717,2132,12792
2016-06-18 16:10:00,616,654,646,1916,11496
2016-06-18 16:20:00,719,755,740,2214,13284
2016-06-18 16:30:00,685,718,703,2106,12636
2016-06-18 16:40:00,639,676,664,1979,11874
2016-06-18 16:50:00,592,625,612,1829,10974
2016-06-18 17:00:00,559,590,578,1727,10362
2016-06-18 17:10:00,522,551,536,1609,9654
2016-06-18 17:20:00,488,517,504,1509,9054
2016-06-18 17:30:00,438,469,457,1364,8184
2016-06-18 17:40:00,249,277,269,795,4770
2016-06-18 17:50:00,288,318,310,916,5496
2016-06-18 18:00:00,329,357,354,1040,6240
2016-06-18 18:10:00,277,305,297,879,5274
2016-06-18 18:20:00,227,254,245,726,4356
2016-06-18 18:30:00,90,115,110,315,1890
2016-06-18 18:40:00,132,127,140,399,2394
2016-06-18 18:50:00,149,143,147,439,2634
2016-06-18 19:00:00,98,53,108,259,1554
2016-06-18 19:10:00,93,89,107,289,1734
2016-06-18 19:20:00,91,89,102,282,1692
2016-06-18 19:30:00,99,105,115,319,1914
2016-06-18 19:40:00,86,88,97,271,1626
2016-06-18 19:50:00,47,46,59,152,912
2016-06-18 20:00:00,25,65,31,121,726
2016-06-18 20:10:00,30,40,35,105,630
2016-06-18 20:20:00,27,29,36,92,552
2016-06-18 20:30:00,22,26,28,76,456
2016-06-18 20:40:00,26,28,34,88,528
2016-06-18 20:50:00,20,22,28,70,420
2016-06-18 21:00:00,15,18,20,53,318
2016-06-18 21:10:00,8,12,11,31,186
2016-06-18 21:20:00,3,8,5,16,96
2016-06-18 21:30:00,1,2,1,4,24
2016-06-18 21:40:00,0,0,0,0,0
2016-06-18 21:50:00,0,0,0,0,0
2016-06-18 22:00:00,0,0,0,0,0
2016-06-18 22:10:00,0,0,0,0,0
2016-06-19 03:50:00,0,0,0,0,0
2016-06-19 04:00:00,0,0,0,0,0
2016-06-19 04:10:00,0,0,0,0,0
2016-06-19 04:20:00,0,0,0,0,0
2016-06-19 04:30:00,0,0,0,0,0
2016-06-19 04:40:00,0,0,0,0,0
2016-06-19 04:50:00,1,2,1,4,24
2016-06-19 05:00:00,3,9,3,15,90
2016-06-19 05:10:00,7,11,8,26,156
2016-06-19 05:20:00,9,19,11,39,234
2016-06-19 05:30:00,14,25,14,53,318
2016-06-19 05:40:00,20,27,28,75,450
2016-06-19 05:50:00,26,33,32,91,546
2016-06-19 06:00:00,35,55,35,125,750
2016-06-19 06:10:00,52,52,75,179,1074
2016-06-19 06:20:00,54,59,82,195,1170
2016-06-19 06:30:00,82,83,88,253,1518
2016-06-19 06:40:00,77,86,84,247,1482
2016-06-19 06:50:00,85,121,107,313,1878
2016-06-19 07:00:00,104,111,128,343,2058
2016-06-19 07:10:00,83,143,164,390,2340
2016-06-19 07:20:00,145,200,88,433,2598
2016-06-19 07:30:00,142,293,56,491,2946
2016-06-19 07:40:00,137,195,223,555,3330
2016-06-19 07:50:00,180,206,193,579,3474
2016-06-19 08:00:00,192,216,212,620,3720
2016-06-19 08:10:00,223,248,243,714,4284
2016-06-19 08:20:00,225,247,241,713,4278
2016-06-19 08:30:00,269,292,288,849,5094
2016-06-19 08:40:00,266,287,282,835,5010
2016-06-19 08:50:00,261,287,283,831,4986
2016-06-19 09:00:00,233,256,254,743,4458
2016-06-19 09:10:00,363,383,387,1133,6798
2016-06-19 09:20:00,441,464,464,1369,8214
2016-06-19 09:30:00,485,510,508,1503,9018
2016-06-19 09:40:00,420,446,438,1304,7824
2016-06-19 09:50:00,651,676,670,1997,11982
2016-06-19 10:00:00,534,557,553,1644,9864
2016-06-19 10:10:00,839,857,862,2558,15348
2016-06-19 10:20:00,746,771,774,2291,13746
2016-06-19 10:30:00,848,880,874,2602,15612
2016-06-19 10:40:00,915,948,945,2808,16848
2016-06-19 10:50:00,927,952,949,2828,16968
2016-06-19 11:00:00,830,869,860,2559,15354
2016-06-19 11:10:00,877,906,897,2680,16080
2016-06-19 11:20:00,893,933,914,2740,16440
2016-06-19 11:30:00,759,793,776,2328,13968
2016-06-19 11:40:00,814,842,834,2490,14940
2016-06-19 11:50:00,809,832,818,2459,14754
2016-06-19 12:00:00,819,842,831,2492,14952
2016-06-19 12:10:00,791,819,814,2424,14544
2016-06-19 12:20:00,824,844,840,2508,15048
2016-06-19 12:30:00,983,1008,998,2989,17934
2016-06-19 12:40:00,1043,1089,1072,3204,19224
2016-06-19 12:50:00,936,977,976,2889,17334
2016-06-19 13:00:00,954,1009,1012,2975,17850
2016-06-19 13:10:00,1060,1086,1089,3235,19410
2016-06-19 13:20:00,1046,1079,1071,3196,19176
2016-06-19 13:30:00,1063,1093,1094,3250,19500
2016-06-19 13:40:00,1049,1080,1076,3205,19230
2016-06-19 13:50:00,958,995,992,2945,17670
2016-06-19 14:00:00,886,917,910,2713,16278
2016-06-19 14:10:00,801,827,825,2453,14718
2016-06-19 14:20:00,946,988,985,2919,17514
2016-06-19 14:30:00,1016,1032,1034,3082,18492
2016-06-19 14:40:00,918,940,939,2797,16782
2016-06-19 14:50:00,861,890,883,2634,15804
2016-06-19 15:00:00,691,714,707,2112,12672
2016-06-19 15:10:00,718,745,742,2205,13230
2016-06-19 15:20:00,916,943,935,2794,16764
2016-06-19 15:30:00,907,933,931,2771,16626
2016-06-19 15:40:00,669,693,693,2055,12330
2016-06-19 15:50:00,897,923,919,2739,16434
2016-06-19 16:00:00,857,881,878,2616,15696
2016-06-19 16:10:00,766,791,782,2339,14034
2016-06-19 16:20:00,733,761,754,2248,13488
2016-06-19 16:30:00,743,764,763,2270,13620
2016-06-19 16:40:00,678,701,699,2078,12468
2016-06-19 16:50:00,643,662,660,1965,11790
2016-06-19 17:00:00,654,673,667,1994,11964
2016-06-19 17:10:00,543,564,554,1661,9966
2016-06-19 17:20:00,523,543,540,1606,9636
2016-06-19 17:30:00,498,519,519,1536,9216
2016-06-19 17:40:00,428,456,453,1337,8022
2016-06-19 17:50:00,366,389,390,1145,6870
2016-06-19 18:00:00,225,248,243,716,4296
2016-06-19 18:10:00,310,334,327,971,5826
2016-06-19 18:20:00,260,282,272,814,4884
2016-06-19 18:30:00,240,262,255,757,4542
2016-06-19 18:40:00,161,181,177,519,3114
2016-06-19 18:50:00,100,145,140,385,2310
2016-06-19 19:00:00,43,85,62,190,1140
2016-06-19 19:10:00,31,65,31,127,762
2016-06-19 19:20:00,45,66,32,143,858
2016-06-19 19:30:00,64,85,68,217,1302
2016-06-19 19:40:00,99,46,105,250,1500
2016-06-19 19:50:00,72,65,85,222,1332
2016-06-19 20:00:00,44,58,60,162,972
2016-06-19 20:10:00,29,39,36,104,624
2016-06-19 20:20:00,19,35,22,76,456
2016-06-19 20:30:00,20,27,17,64,384
2016-06-19 20:40:00,17,20,17,54,324
2016-06-19 20:50:00,12,16,16,44,264
2016-06-19 21:00:00,7,14,12,33,198
2016-06-19 21:10:00,2,10,6,18,108
2016-06-19 21:20:00,3,2,2,7,42
2016-06-19 21:30:00,0,0,0,0,0
2016-06-19 21:40:00,0,0,0,0,0
2016-06-19 21:50:00,0,0,0,0,0
2016-06-19 22:00:00,0,0,0,0,0
2016-06-19 22:10:00,0,0,0,0,0
2016-06-19 22:20:00,0,0,0,0,0
2016-06-19 22:30:00,0,0,0,0,0
2016-06-20 03:50:00,0,0,0,0,0
2016-06-20 04:00:00,0,0,0,0,0
2016-06-20 04:10:00,0,0,0,0,0
2016-06-20 04:20:00,0,0,0,0,0
2016-06-20 04:30:00,0,0,0,0,0
2016-06-20 04:40:00,1,2,1,4,24
2016-06-20 04:50:00,5,8,1,14,84
2016-06-20 05:00:00,7,14,3,24,144
2016-06-20 05:10:00,8,20,7,35,210
2016-06-20 05:20:00,14,29,13,56,336
2016-06-20 05:30:00,23,41,26,90,540
2016-06-20 05:40:00,22,34,27,83,498
2016-06-20 05:50:00,54,66,66,186,1116
2016-06-20 06:00:00,24,71,31,126,756
2016-06-20 06:10:00,28,61,32,121,726
2016-06-20 06:20:00,59,33,65,157,942
2016-06-20 06:30:00,78,73,85,236,1416
2016-06-20 06:40:00,55,113,110,278,1668
2016-06-20 06:50:00,65,103,99,267,1602
2016-06-20 07:00:00,66,135,125,326,1956
2016-06-20 07:10:00,196,203,151,550,3300
2016-06-20 07:20:00,103,136,128,367,2202
2016-06-20 07:30:00,75,142,142,359,2154
2016-06-20 07:40:00,221,248,245,714,4284
2016-06-20 07:50:00,209,230,227,666,3996
2016-06-20 08:00:00,259,276,274,809,4854
2016-06-20 08:10:00,200,220,216,636,3816
2016-06-20 08:20:00,232,211,171,614,3684
2016-06-20 08:30:00,315,285,259,859,5154
2016-06-20 08:40:00,509,523,530,1562,9372
2016-06-20 08:50:00,620,640,639,1899,11394
2016-06-20 09:00:00,486,508,504,1498,8988
2016-06-20 09:10:00,391,412,408,1211,7266
2016-06-20 09:20:00,587,610,605,1802,10812
2016-06-20 09:30:00,522,543,539,1604,9624
2016-06-20 09:40:00,579,599,598,1776,10656
2016-06-20 09:50:00,560,581,579,1720,10320
2016-06-20 10:00:00,552,578,577,1707,10242
2016-06-20 10:10:00,670,700,699,2069,12414
2016-06-20 10:20:00,777,802,798,2377,14262
2016-06-20 10:30:00,929,951,945,2825,16950
2016-06-20 10:40:00,868,894,892,2654,15924
2016-06-20 10:50:00,932,955,957,2844,17064
2016-06-20 11:00:00,945,972,969,2886,17316
2016-06-20 11:10:00,991,1012,1009,3012,18072
2016-06-20 11:20:00,1033,1060,1051,3144,18864
2016-06-20 11:30:00,819,846,836,2501,15006
2016-06-20 11:40:00,785,813,804,2402,14412
2016-06-20 11:50:00,1031,1060,1051,3142,18852
2016-06-20 12:00:00,967,999,991,2957,17742
2016-06-20 12:10:00,914,952,942,2808,16848
2016-06-20 12:20:00,957,992,986,2935,17610
2016-06-20 12:30:00,974,1002,997,2973,17838
2016-06-20 12:40:00,808,831,824,2463,14778
2016-06-20 12:50:00,657,683,677,2017,12102
2016-06-20 13:00:00,768,796,792,2356,14136
2016-06-20 13:10:00,898,920,918,2736,16416
2016-06-20 13:20:00,410,432,428,1270,7620
2016-06-20 13:30:00,200,222,220,642,3852
2016-06-20 13:40:00,199,246,73,518,3108
2016-06-20 13:50:00,155,146,114,415,2490
2016-06-20 14:00:00,68,192,231,491,2946
2016-06-20 14:10:00,182,325,11,518,3108
2016-06-20 14:20:00,216,246,125,587,3522
2016-06-20 14:30:00,232,257,243,732,4392
2016-06-20 14:40:00,274,294,292,860,5160
2016-06-20 14:50:00,293,314,313,920,5520
2016-06-20 15:00:00,188,209,209,606,3636
2016-06-20 15:10:00,206,140,208,554,3324
2016-06-20 15:20:00,277,243,264,784,4704
2016-06-20 15:30:00,222,241,238,701,4206
2016-06-20 15:40:00,148,215,87,450,2700
2016-06-20 15:50:00,143,273,22,438,2628
2016-06-20 16:00:00,94,214,108,416,2496
2016-06-20 16:10:00,127,112,167,406,2436
2016-06-20 16:20:00,130,185,152,467,2802
2016-06-20 16:30:00,167,229,263,659,3954
2016-06-20 16:40:00,186,145,184,515,3090
2016-06-20 16:50:00,177,217,143,537,3222
2016-06-20 17:00:00,115,115,147,377,2262
2016-06-20 17:10:00,73,125,165,363,2178
2016-06-20 17:20:00,77,73,96,246,1476
2016-06-20 17:30:00,59,45,66,170,1020
2016-06-20 17:40:00,29,54,37,120,720
2016-06-20 17:50:00,33,62,41,136,816
2016-06-20 18:00:00,63,76,51,190,1140
2016-06-20 18:10:00,56,66,63,185,1110
2016-06-20 18:20:00,35,72,40,147,882
2016-06-20 18:30:00,27,71,30,128,768
2016-06-20 18:40:00,28,58,28,114,684
2016-06-20 18:50:00,29,19,36,84,504
2016-06-20 19:00:00,26,16,29,71,426
2016-06-20 19:10:00,20,19,28,67,402
2016-06-20 19:20:00,17,17,23,57,342
2016-06-20 19:30:00,13,14,18,45,270
2016-06-20 19:40:00,10,13,14,37,222
2016-06-20 19:50:00,6,12,10,28,168
2016-06-20 20:00:00,5,8,7,20,120
2016-06-20 20:10:00,4,6,5,15,90
2016-06-20 20:20:00,3,5,3,11,66
2016-06-20 20:30:00,1,3,1,5,30
2016-06-20 20:40:00,0,1,0,1,6
2016-06-20 20:50:00,0,0,0,0,0
2016-06-20 21:00:00,0,0,0,0,0
2016-06-20 21:10:00,0,0,0,0,0
2016-06-20 21:20:00,0,0,0,0,0
2016-06-20 21:30:00,0,0,0,0,0
2016-06-20 21:40:00,0,0,0,0,0
2016-06-20 21:50:00,0,0,0,0,0
2016-06-21 04:10:00,0,0,0,0,0
2016-06-21 04:20:00,0,0,0,0,0
2016-06-21 04:30:00,0,0,0,0,0
2016-06-21 04:40:00,0,0,0,0,0
2016-06-21 04:50:00,0,0,0,0,0
2016-06-21 05:00:00,0,0,0,0,0
2016-06-21 05:10:00,2,3,2,7,42
2016-06-21 05:20:00,7,11,8,26,156
2016-06-21 05:30:00,16,40,18,74,444
2016-06-21 05:40:00,8,21,15,44,264
2016-06-21 05:50:00,21,57,17,95,570
2016-06-21 06:00:00,17,47,19,83,498
2016-06-21 06:10:00,27,57,37,121,726
2016-06-21 06:20:00,56,78,71,205,1230
2016-06-21 06:30:00,55,98,86,239,1434
2016-06-21 06:40:00,81,117,105,303,1818
2016-06-21 06:50:00,64,187,124,375,2250
2016-06-21 07:00:00,66,174,135,375,2250
2016-06-21 07:10:00,117,179,114,410,2460
2016-06-21 07:20:00,173,188,114,475,2850
2016-06-21 07:30:00,131,150,146,427,2562
2016-06-21 07:40:00,177,198,194,569,3414
2016-06-21 07:50:00,171,226,110,507,3042
2016-06-21 08:00:00,171,241,190,602,3612
2016-06-21 08:10:00,330,351,345,1026,6156
2016-06-21 08:20:00,337,362,357,1056,6336
2016-06-21 08:30:00,363,387,381,1131,6786
2016-06-21 08:40:00,400,421,413,1234,7404
2016-06-21 08:50:00,282,304,298,884,5304
2016-06-21 09:00:00,486,510,503,1499,8994
2016-06-21 09:10:00,337,358,354,1049,6294
2016-06-21 09:20:00,190,240,207,637,3822
2016-06-21 09:30:00,575,595,590,1760,10560
2016-06-21 09:40:00,771,793,787,2351,14106
2016-06-21 09:50:00,781,804,799,2384,14304
2016-06-21 10:00:00,371,393,389,1153,6918
2016-06-21 10:10:00,786,810,803,2399,14394
2016-06-21 10:20:00,487,508,503,1498,8988
2016-06-21 10:30:00,230,252,248,730,4380
2016-06-21 10:40:00,317,312,308,937,5622
2016-06-21 10:50:00,500,523,517,1540,9240
2016-06-21 11:00:00,649,670,662,1981,11886
2016-06-21 11:10:00,454,476,467,1397,8382
2016-06-21 11:20:00,415,438,430,1283,7698
2016-06-21 11:30:00,551,575,568,1694,10164
2016-06-21 11:40:00,587,609,604,1800,10800
2016-06-21 11:50:00,451,474,467,1392,8352
2016-06-21 12:00:00,784,805,795,2384,14304
2016-06-21 12:10:00,914,936,920,2770,16620
2016-06-21 12:20:00,924,944,931,2799,16794
2016-06-21 12:30:00,739,754,749,2242,13452
2016-06-21 12:40:00,760,781,774,2315,13890
2016-06-21 12:50:00,1099,1125,1116,3340,20040
2016-06-21 13:00:00,1075,1102,1102,3279,19674
2016-06-21 13:10:00,1089,1110,1110,3309,19854
2016-06-21 13:20:00,975,1001,998,2974,17844
2016-06-21 13:30:00,1085,1119,1113,3317,19902
2016-06-21 13:40:00,1004,1043,1040,3087,18522
2016-06-21 13:50:00,866,901,894,2661,15966
2016-06-21 14:00:00,884,903,897,2684,16104
2016-06-21 14:10:00,618,641,635,1894,11364
2016-06-21 14:20:00,536,555,551,1642,9852
2016-06-21 14:30:00,564,589,583,1736,10416
2016-06-21 14:40:00,554,576,567,1697,10182
2016-06-21 14:50:00,728,758,744,2230,13380
2016-06-21 15:00:00,748,771,757,2276,13656
2016-06-21 15:10:00,636,658,646,1940,11640
2016-06-21 15:20:00,641,666,656,1963,11778
2016-06-21 15:30:00,643,669,655,1967,11802
2016-06-21 15:40:00,782,809,794,2385,14310
2016-06-21 15:50:00,760,781,769,2310,13860
2016-06-21 16:00:00,819,857,847,2523,15138
2016-06-21 16:10:00,785,812,804,2401,14406
2016-06-21 16:20:00,721,750,737,2208,13248
2016-06-21 16:30:00,719,747,741,2207,13242
2016-06-21 16:40:00,673,708,692,2073,12438
2016-06-21 16:50:00,639,674,658,1971,11826
2016-06-21 17:00:00,592,635,617,1844,11064
2016-06-21 17:10:00,555,594,576,1725,10350
2016-06-21 17:20:00,509,548,528,1585,9510
2016-06-21 17:30:00,470,499,486,1455,8730
2016-06-21 17:40:00,430,452,440,1322,7932
2016-06-21 17:50:00,376,399,386,1161,6966
2016-06-21 18:00:00,333,359,351,1043,6258
2016-06-21 18:10:00,242,267,260,769,4614
2016-06-21 18:20:00,251,274,269,794,4764
2016-06-21 18:30:00,203,228,224,655,3930
2016-06-21 18:40:00,163,186,181,530,3180
2016-06-21 18:50:00,133,155,150,438,2628
2016-06-21 19:00:00,101,123,118,342,2052
2016-06-21 19:10:00,68,80,94,242,1452
2016-06-21 19:20:00,43,72,63,178,1068
2016-06-21 19:30:00,24,77,24,125,750
2016-06-21 19:40:00,2,119,2,123,738
2016-06-21 19:50:00,29,56,27,112,672
2016-06-21 20:00:00,25,50,26,101,606
2016-06-21 20:10:00,19,57,29,105,630
2016-06-21 20:20:00,47,70,70,187,1122
2016-06-21 20:30:00,92,48,103,243,1458
2016-06-21 20:40:00,31,56,45,132,792
2016-06-21 20:50:00,22,46,24,92,552
2016-06-21 21:00:00,7,39,20,66,396
2016-06-21 21:10:00,4,32,13,49,294
2016-06-21 21:20:00,5,27,11,43,258
2016-06-21 21:30:00,1,5,3,9,54
2016-06-21 21:40:00,0,0,0,0,0
2016-06-21 21:50:00,0,0,0,0,0
2016-06-21 22:00:00,0,0,0,0,0
2016-06-21 22:10:00,0,0,0,0,0
2016-06-21 22:20:00,0,0,0,0,0
2016-06-22 03:50:00,0,0,0,0,0
2016-06-22 04:00:00,0,0,0,0,0
2016-06-22 04:10:00,0,0,0,0,0
2016-06-22 04:20:00,0,0,0,0,0
2016-06-22 04:30:00,0,0,0,0,0
2016-06-22 04:40:00,1,4,3,8,48
2016-06-22 04:50:00,4,10,8,22,132
2016-06-22 05:00:00,16,35,22,73,438
2016-06-22 05:10:00,13,33,20,66,396
2016-06-22 05:20:00,4,12,11,27,162
2016-06-22 05:30:00,1,5,2,8,48
2016-06-22 05:40:00,1,3,2,6,36
2016-06-22 05:50:00,2,2,7,11,66
2016-06-22 06:00:00,7,17,9,33,198
2016-06-22 06:10:00,25,41,38,104,624
2016-06-22 06:20:00,26,49,51,126,756
2016-06-22 06:30:00,14,34,23,71,426
2016-06-22 06:40:00,11,33,22,66,396
2016-06-22 06:50:00,15,34,29,78,468
2016-06-22 07:00:00,25,47,37,109,654
2016-06-22 07:10:00,36,78,66,180,1080
2016-06-22 07:20:00,33,82,63,178,1068
2016-06-22 07:30:00,20,64,27,111,666
2016-06-22 07:40:00,8,33,21,62,372
2016-06-22 07:50:00,24,68,63,155,930
2016-06-22 08:00:00,33,59,58,150,900
2016-06-22 08:10:00,39,88,84,211,1266
2016-06-22 08:20:00,44,157,150,351,2106
2016-06-22 08:30:00,112,265,56,433,2598
2016-06-22 08:40:00,95,143,107,345,2070
2016-06-22 08:50:00,38,91,83,212,1272
2016-06-22 09:00:00,17,81,45,143,858
2016-06-22 09:10:00,20,51,23,94,564
2016-06-22 09:20:00,32,62,41,135,810
2016-06-22 09:30:00,88,150,62,300,1800
2016-06-22 09:40:00,134,182,93,409,2454
2016-06-22 09:50:00,81,157,110,348,2088
2016-06-22 10:00:00,56,94,88,238,1428
2016-06-22 10:10:00,31,86,55,172,1032
2016-06-22 10:20:00,92,170,74,336,2016
2016-06-22 10:30:00,73,101,84,258,1548
2016-06-22 10:40:00,97,121,113,331,1986
2016-06-22 10:50:00,51,134,179,364,2184
2016-06-22 11:00:00,156,178,128,462,2772
2016-06-22 11:10:00,230,252,248,730,4380
2016-06-22 11:20:00,206,243,211,660,3960
2016-06-22 11:30:00,101,123,119,343,2058
2016-06-22 11:40:00,42,78,54,174,1044
2016-06-22 11:50:00,28,55,19,102,612
2016-06-22 12:00:00,29,95,77,201,1206
2016-06-22 12:10:00,29,82,65,176,1056
2016-06-22 12:20:00,26,99,84,209,1254
2016-06-22 12:30:00,24,71,53,148,888
2016-06-22 12:40:00,25,68,43,136,816
2016-06-22 12:50:00,52,108,91,251,1506
2016-06-22 13:00:00,67,113,103,283,1698
2016-06-22 13:10:00,158,203,186,547,3282
2016-06-22 13:20:00,249,269,266,784,4704
2016-06-22 13:30:00,457,473,470,1400,8400
2016-06-22 13:40:00,594,614,606,1814,10884
2016-06-22 13:50:00,681,701,695,2077,12462
2016-06-22 14:00:00,837,858,848,2543,15258
2016-06-22 14:10:00,988,1010,998,2996,17976
2016-06-22 14:20:00,495,516,510,1521,9126
2016-06-22 14:30:00,535,557,547,1639,9834
2016-06-22 14:40:00,780,801,790,2371,14226
2016-06-22 14:50:00,534,553,546,1633,9798
2016-06-22 15:00:00,722,740,730,2192,13152
2016-06-22 15:10:00,407,427,420,1254,7524
2016-06-22 15:20:00,489,511,502,1502,9012
2016-06-22 15:30:00,703,722,719,2144,12864
2016-06-22 15:40:00,428,453,447,1328,7968
2016-06-22 15:50:00,388,414,411,1213,7278
2016-06-22 16:00:00,544,570,566,1680,10080
2016-06-22 16:10:00,779,798,801,2378,14268
2016-06-22 16:20:00,607,635,628,1870,11220
2016-06-22 16:30:00,703,732,723,2158,12948
2016-06-22 16:40:00,643,671,662,1976,11856
2016-06-22 16:50:00,464,500,491,1455,8730
2016-06-22 17:00:00,324,353,348,1025,6150
2016-06-22 17:10:00,652,686,685,2023,12138
2016-06-22 17:20:00,449,488,480,1417,8502
2016-06-22 17:30:00,479,513,508,1500,9000
2016-06-22 17:40:00,416,449,440,1305,7830
2016-06-22 17:50:00,353,378,376,1107,6642
2016-06-22 18:00:00,315,339,333,987,5922
2016-06-22 18:10:00,267,292,286,845,5070
2016-06-22 18:20:00,207,233,226,666,3996
2016-06-22 18:30:00,198,221,214,633,3798
2016-06-22 18:40:00,176,159,149,484,2904
2016-06-22 18:50:00,68,167,194,429,2574
2016-06-22 19:00:00,119,95,133,347,2082
2016-06-22 19:10:00,65,100,91,256,1536
2016-06-22 19:20:00,34,79,79,192,1152
2016-06-22 19:30:00,38,58,41,137,822
2016-06-22 19:40:00,42,51,46,139,834
2016-06-22 19:50:00,32,62,38,132,792
2016-06-22 20:00:00,24,47,35,106,636
2016-06-22 20:10:00,19,45,31,95,570
2016-06-22 20:20:00,14,45,27,86,516
2016-06-22 20:30:00,7,50,21,78,468
2016-06-22 20:40:00,9,37,20,66,396
2016-06-22 20:50:00,9,30,14,53,318
2016-06-22 21:00:00,6,22,10,38,228
2016-06-22 21:10:00,5,16,6,27,162
2016-06-22 21:20:00,3,7,3,13,78
2016-06-22 21:30:00,0,0,0,0,0
2016-06-22 21:40:00,0,0,0,0,0
2016-06-22 21:50:00,0,0,0,0,0
2016-06-22 22:00:00,0,0,0,0,0
2016-06-22 22:10:00,0,0,0,0,0
2016-06-22 22:20:00,0,0,0,0,0
2016-06-23 03:50:00,0,0,0,0,0
2016-06-23 04:00:00,0,0,0,0,0
2016-06-23 04:10:00,0,0,0,0,0
2016-06-23 04:20:00,0,0,0,0,0
2016-06-23 04:30:00,0,0,0,0,0
2016-06-23 04:40:00,1,3,2,6,36
2016-06-23 04:50:00,6,12,9,27,162
2016-06-23 05:00:00,13,27,17,57,342
2016-06-23 05:10:00,16,36,11,63,378
2016-06-23 05:20:00,12,31,11,54,324
2016-06-23 05:30:00,11,26,10,47,282
2016-06-23 05:40:00,32,26,12,70,420
2016-06-23 05:50:00,40,54,52,146,876
2016-06-23 06:00:00,74,80,78,232,1392
2016-06-23 06:10:00,109,43,126,278,1668
2016-06-23 06:20:00,127,14,131,272,1632
2016-06-23 06:30:00,56,137,158,351,2106
2016-06-23 06:40:00,75,129,107,311,1866
2016-06-23 06:50:00,107,69,123,299,1794
2016-06-23 07:00:00,91,129,116,336,2016
2016-06-23 07:10:00,56,121,122,299,1794
2016-06-23 07:20:00,81,53,112,246,1476
2016-06-23 07:30:00,124,214,126,464,2784
2016-06-23 07:40:00,72,153,151,376,2256
2016-06-23 07:50:00,257,313,267,837,5022
2016-06-23 08:00:00,196,219,212,627,3762
2016-06-23 08:10:00,213,236,234,683,4098
2016-06-23 08:20:00,323,347,344,1014,6084
2016-06-23 08:30:00,412,435,431,1278,7668
2016-06-23 08:40:00,353,377,368,1098,6588
2016-06-23 08:50:00,324,347,338,1009,6054
2016-06-23 09:00:00,463,487,479,1429,8574
2016-06-23 09:10:00,572,597,594,1763,10578
2016-06-23 09:20:00,645,682,674,2001,12006
2016-06-23 09:30:00,677,707,702,2086,12516
2016-06-23 09:40:00,691,716,713,2120,12720
2016-06-23 09:50:00,735,760,755,2250,13500
2016-06-23 10:00:00,475,497,493,1465,8790
2016-06-23 10:10:00,553,571,566,1690,10140
2016-06-23 10:20:00,557,581,576,1714,10284
2016-06-23 10:30:00,551,573,567,1691,10146
2016-06-23 10:40:00,455,479,472,1406,8436
2016-06-23 10:50:00,410,435,429,1274,7644
2016-06-23 11:00:00,395,417,411,1223,7338
2016-06-23 11:10:00,238,263,259,760,4560
2016-06-23 11:20:00,158,182,177,517,3102
2016-06-23 11:30:00,144,169,170,483,2898
2016-06-23 11:40:00,290,132,163,585,3510
2016-06-23 11:50:00,96,179,143,418,2508
2016-06-23 12:00:00,116,195,124,435,2610
2016-06-23 12:10:00,239,245,227,711,4266
2016-06-23 12:20:00,216,237,234,687,4122
2016-06-23 12:30:00,175,197,194,566,3396
2016-06-23 12:40:00,338,358,355,1051,6306
2016-06-23 12:50:00,410,432,428,1270,7620
2016-06-23 13:00:00,450,474,469,1393,8358
2016-06-23 13:10:00,273,298,294,865,5190
2016-06-23 13:20:00,188,244,223,655,3930
2016-06-23 13:30:00,245,269,264,778,4668
2016-06-23 13:40:00,302,325,323,950,5700
2016-06-23 13:50:00,271,293,288,852,5112
2016-06-23 14:00:00,183,205,201,589,3534
2016-06-23 14:10:00,76,124,176,376,2256
2016-06-23 14:20:00,128,130,108,366,2196
2016-06-23 14:30:00,108,90,120,318,1908
2016-06-23 14:40:00,90,127,106,323,1938
2016-06-23 14:50:00,177,169,185,531,3186
2016-06-23 15:00:00,325,302,298,925,5550
2016-06-23 15:10:00,303,323,323,949,5694
2016-06-23 15:20:00,370,391,386,1147,6882
2016-06-23 15:30:00,260,283,278,821,4926
2016-06-23 15:40:00,230,251,247,728,4368
2016-06-23 15:50:00,230,255,251,736,4416
2016-06-23 16:00:00,265,286,283,834,5004
2016-06-23 16:10:00,206,229,225,660,3960
2016-06-23 16:20:00,204,261,145,610,3660
2016-06-23 16:30:00,182,245,109,536,3216
2016-06-23 16:40:00,98,197,96,391,2346
2016-06-23 16:50:00,74,117,99,290,1740
2016-06-23 17:00:00,78,145,118,341,2046
2016-06-23 17:10:00,50,139,131,320,1920
2016-06-23 17:20:00,115,118,146,379,2274
2016-06-23 17:30:00,84,133,138,355,2130
2016-06-23 17:40:00,22,77,70,169,1014
2016-06-23 17:50:00,39,76,64,179,1074
2016-06-23 18:00:00,29,84,61,174,1044
2016-06-23 18:10:00,69,75,55,199,1194
2016-06-23 18:20:00,70,105,93,268,1608
2016-06-23 18:30:00,41,63,53,157,942
2016-06-23 18:40:00,64,80,65,209,1254
2016-06-23 18:50:00,68,72,65,205,1230
2016-06-23 19:00:00,70,92,42,204,1224
2016-06-23 19:10:00,23,31,12,66,396
2016-06-23 19:20:00,84,102,24,210,1260
2016-06-23 19:30:00,82,98,50,230,1380
2016-06-23 19:40:00,45,67,60,172,1032
2016-06-23 19:50:00,24,68,28,120,720
2016-06-23 20:00:00,17,41,19,77,462
2016-06-23 20:10:00,8,8,9,25,150
2016-06-23 20:20:00,27,47,28,102,612
2016-06-23 20:30:00,12,14,14,40,240
2016-06-23 20:40:00,4,3,5,12,72
2016-06-23 20:50:00,8,11,9,28,168
2016-06-23 21:00:00,13,21,19,53,318
2016-06-23 21:10:00,9,13,13,35,210
2016-06-23 21:20:00,5,11,9,25,150
2016-06-23 21:30:00,3,3,3,9,54
2016-06-23 21:40:00,0,0,0,0,0
2016-06-23 21:50:00,0,0,0,0,0
2016-06-23 22:00:00,0,0,0,0,0
2016-06-23 22:10:00,0,0,0,0,0
2016-06-23 22:20:00,0,0,0,0,0
2016-06-24 04:00:00,0,0,0,0,0
2016-06-24 04:10:00,0,0,0,0,0
2016-06-24 04:20:00,0,0,0,0,0
2016-06-24 04:30:00,0,0,0,0,0
2016-06-24 04:40:00,0,0,0,0,0
2016-06-24 04:50:00,0,0,0,0,0
2016-06-24 05:00:00,2,5,3,10,60
2016-06-24 05:10:00,5,9,12,26,156
2016-06-24 05:20:00,11,13,7,31,186
2016-06-24 05:30:00,9,18,9,36,216
2016-06-24 05:40:00,13,12,11,36,216
2016-06-24 05:50:00,12,19,11,42,252
2016-06-24 06:00:00,26,24,31,81,486
2016-06-24 06:10:00,33,30,40,103,618
2016-06-24 06:20:00,19,82,27,128,768
2016-06-24 06:30:00,46,59,62,167,1002
2016-06-24 06:40:00,65,85,71,221,1326
2016-06-24 06:50:00,74,84,94,252,1512
2016-06-24 07:00:00,72,152,133,357,2142
2016-06-24 07:10:00,94,146,162,402,2412
2016-06-24 07:20:00,72,103,123,298,1788
2016-06-24 07:30:00,77,69,114,260,1560
2016-06-24 07:40:00,186,206,167,559,3354
2016-06-24 07:50:00,190,238,273,701,4206
2016-06-24 08:00:00,300,329,321,950,5700
2016-06-24 08:10:00,318,347,340,1005,6030
2016-06-24 08:20:00,188,278,178,644,3864
2016-06-24 08:30:00,230,230,190,650,3900
2016-06-24 08:40:00,483,514,506,1503,9018
2016-06-24 08:50:00,545,570,563,1678,10068
2016-06-24 09:00:00,446,463,457,1366,8196
2016-06-24 09:10:00,428,447,443,1318,7908
2016-06-24 09:20:00,491,514,510,1515,9090
2016-06-24 09:30:00,531,550,545,1626,9756
2016-06-24 09:40:00,420,440,435,1295,7770
2016-06-24 09:50:00,373,393,388,1154,6924
2016-06-24 10:00:00,494,516,512,1522,9132
2016-06-24 10:10:00,492,515,510,1517,9102
2016-06-24 10:20:00,575,594,592,1761,10566
2016-06-24 10:30:00,513,532,532,1577,9462
2016-06-24 10:40:00,436,452,458,1346,8076
2016-06-24 10:50:00,814,834,840,2488,14928
2016-06-24 11:00:00,899,917,915,2731,16386
2016-06-24 11:10:00,667,688,682,2037,12222
2016-06-24 11:20:00,844,860,856,2560,15360
2016-06-24 11:30:00,810,832,831,2473,14838
2016-06-24 11:40:00,806,830,834,2470,14820
2016-06-24 11:50:00,704,739,742,2185,13110
2016-06-24 12:00:00,694,722,722,2138,12828
2016-06-24 12:10:00,891,929,923,2743,16458
2016-06-24 12:20:00,853,881,884,2618,15708
2016-06-24 12:30:00,735,758,758,2251,13506
2016-06-24 12:40:00,611,638,635,1884,11304
2016-06-24 12:50:00,588,614,609,1811,10866
2016-06-24 13:00:00,674,702,701,2077,12462
2016-06-24 13:10:00,698,721,721,2140,12840
2016-06-24 13:20:00,693,719,715,2127,12762
2016-06-24 13:30:00,652,676,672,2000,12000
2016-06-24 13:40:00,784,812,805,2401,14406
2016-06-24 13:50:00,664,686,679,2029,12174
2016-06-24 14:00:00,931,952,941,2824,16944
2016-06-24 14:10:00,814,843,831,2488,14928
2016-06-24 14:20:00,857,900,891,2648,15888
2016-06-24 14:30:00,928,955,944,2827,16962
2016-06-24 14:40:00,892,920,905,2717,16302
2016-06-24 14:50:00,886,907,895,2688,16128
2016-06-24 15:00:00,871,886,877,2634,15804
2016-06-24 15:10:00,855,875,865,2595,15570
2016-06-24 15:20:00,805,826,817,2448,14688
2016-06-24 15:30:00,847,873,862,2582,15492
2016-06-24 15:40:00,808,832,821,2461,14766
2016-06-24 15:50:00,769,791,782,2342,14052
2016-06-24 16:00:00,656,676,671,2003,12018
2016-06-24 16:10:00,521,540,534,1595,9570
2016-06-24 16:20:00,573,595,588,1756,10536
2016-06-24 16:30:00,322,346,342,1010,6060
2016-06-24 16:40:00,180,202,198,580,3480
2016-06-24 16:50:00,109,164,170,443,2658
2016-06-24 17:00:00,188,238,199,625,3750
2016-06-24 17:10:00,105,142,231,478,2868
2016-06-24 17:20:00,146,103,151,400,2400
2016-06-24 17:30:00,190,195,258,643,3858
2016-06-24 17:40:00,231,253,249,733,4398
2016-06-24 17:50:00,154,175,172,501,3006
2016-06-24 18:00:00,136,159,156,451,2706
2016-06-24 18:10:00,256,278,273,807,4842
2016-06-24 18:20:00,136,148,148,432,2592
2016-06-24 18:30:00,85,93,93,271,1626
2016-06-24 18:40:00,160,178,177,515,3090
2016-06-24 18:50:00,104,166,113,383,2298
2016-06-24 19:00:00,71,140,108,319,1914
2016-06-24 19:10:00,81,109,97,287,1722
2016-06-24 19:20:00,96,53,106,255,1530
2016-06-24 19:30:00,114,18,124,256,1536
2016-06-24 19:40:00,47,81,65,193,1158
2016-06-24 19:50:00,59,75,74,208,1248
2016-06-24 20:00:00,36,59,42,137,822
2016-06-24 20:10:00,27,47,33,107,642
2016-06-24 20:20:00,20,44,33,97,582
2016-06-24 20:30:00,14,32,26,72,432
2016-06-24 20:40:00,16,32,26,74,444
2016-06-24 20:50:00,17,30,24,71,426
2016-06-24 21:00:00,23,38,27,88,528
2016-06-24 21:10:00,21,38,26,85,510
2016-06-24 21:20:00,10,24,12,46,276
2016-06-24 21:30:00,10,21,13,44,264
2016-06-24 21:40:00,10,22,15,47,282
2016-06-24 21:50:00,6,12,6,24,144
2016-06-24 22:00:00,0,1,0,1,6
2016-06-24 22:10:00,0,0,0,0,0
2016-06-24 22:20:00,0,0,0,0,0
2016-06-25 03:50:00,0,0,0,0,0
2016-06-25 04:00:00,0,0,0,0,0
2016-06-25 04:10:00,0,0,0,0,0
2016-06-25 04:20:00,0,0,0,0,0
2016-06-25 04:30:00,0,0,0,0,0
2016-06-25 04:40:00,0,0,0,0,0
2016-06-25 04:50:00,1,2,4,7,42
2016-06-25 05:00:00,3,9,10,22,132
2016-06-25 05:10:00,11,17,13,41,246
2016-06-25 05:20:00,10,27,16,53,318
2016-06-25 05:30:00,13,25,14,52,312
2016-06-25 05:40:00,21,44,18,83,498
2016-06-25 05:50:00,24,54,29,107,642
2016-06-25 06:00:00,19,51,36,106,636
2016-06-25 06:10:00,18,54,28,100,600
2016-06-25 06:20:00,30,70,72,172,1032
2016-06-25 06:30:00,50,80,81,211,1266
2016-06-25 06:40:00,65,134,131,330,1980
2016-06-25 06:50:00,69,195,199,463,2778
2016-06-25 07:00:00,57,196,143,396,2376
2016-06-25 07:10:00,73,176,137,386,2316
2016-06-25 07:20:00,32,95,98,225,1350
2016-06-25 07:30:00,58,95,124,277,1662
2016-06-25 07:40:00,62,129,127,318,1908
2016-06-25 07:50:00,142,201,113,456,2736
2016-06-25 08:00:00,161,310,61,532,3192
2016-06-25 08:10:00,213,239,178,630,3780
2016-06-25 08:20:00,272,295,289,856,5136
2016-06-25 08:30:00,404,428,421,1253,7518
2016-06-25 08:40:00,463,488,480,1431,8586
2016-06-25 08:50:00,167,231,247,645,3870
2016-06-25 09:00:00,240,247,248,735,4410
2016-06-25 09:10:00,212,236,229,677,4062
2016-06-25 09:20:00,128,149,111,388,2328
2016-06-25 09:30:00,80,181,125,386,2316
2016-06-25 09:40:00,161,201,134,496,2976
2016-06-25 09:50:00,96,160,156,412,2472
2016-06-25 10:00:00,146,310,84,540,3240
2016-06-25 10:10:00,298,297,290,885,5310
2016-06-25 10:20:00,317,351,340,1008,6048
2016-06-25 10:30:00,207,230,223,660,3960
2016-06-25 10:40:00,168,193,186,547,3282
2016-06-25 10:50:00,394,423,418,1235,7410
2016-06-25 11:00:00,277,303,297,877,5262
2016-06-25 11:10:00,218,245,238,701,4206
2016-06-25 11:20:00,239,264,257,760,4560
2016-06-25 11:30:00,183,204,198,585,3510
2016-06-25 11:40:00,227,224,172,623,3738
2016-06-25 11:50:00,168,190,184,542,3252
2016-06-25 12:00:00,176,197,191,564,3384
2016-06-25 12:10:00,120,142,137,399,2394
2016-06-25 12:20:00,103,126,121,350,2100
2016-06-25 12:30:00,206,235,227,668,4008
2016-06-25 12:40:00,275,302,293,870,5220
2016-06-25 12:50:00,330,364,353,1047,6282
2016-06-25 13:00:00,278,303,297,878,5268
2016-06-25 13:10:00,230,254,248,732,4392
2016-06-25 13:20:00,289,312,303,904,5424
2016-06-25 13:30:00,266,287,277,830,4980
2016-06-25 13:40:00,265,288,279,832,4992
2016-06-25 13:50:00,233,256,249,738,4428
2016-06-25 14:00:00,261,286,280,827,4962
2016-06-25 14:10:00,246,273,262,781,4686
2016-06-25 14:20:00,350,384,371,1105,6630
2016-06-25 14:30:00,549,578,565,1692,10152
2016-06-25 14:40:00,535,556,549,1640,9840
2016-06-25 14:50:00,426,450,443,1319,7914
2016-06-25 15:00:00,154,175,170,499,2994
2016-06-25 15:10:00,98,118,113,329,1974
2016-06-25 15:20:00,97,111,109,317,1902
2016-06-25 15:30:00,211,231,224,666,3996
2016-06-25 15:40:00,191,211,205,607,3642
2016-06-25 15:50:00,210,229,222,661,3966
2016-06-25 16:00:00,223,241,232,696,4176
2016-06-25 16:10:00,280,305,296,881,5286
2016-06-25 16:20:00,291,315,309,915,5490
2016-06-25 16:30:00,215,237,229,681,4086
2016-06-25 16:40:00,147,173,154,474,2844
2016-06-25 16:50:00,129,203,77,409,2454
2016-06-25 17:00:00,60,171,216,447,2682
2016-06-25 17:10:00,139,152,187,478,2868
2016-06-25 17:20:00,107,129,141,377,2262
2016-06-25 17:30:00,93,134,114,341,2046
2016-06-25 17:40:00,60,154,157,371,2226
2016-06-25 17:50:00,28,106,108,242,1452
2016-06-25 18:00:00,68,122,134,324,1944
2016-06-25 18:10:00,111,171,136,418,2508
2016-06-25 18:20:00,130,222,105,457,2742
2016-06-25 18:30:00,124,165,161,450,2700
2016-06-25 18:40:00,171,183,127,481,2886
2016-06-25 18:50:00,59,90,58,207,1242
2016-06-25 19:00:00,35,55,27,117,702
2016-06-25 19:10:00,21,39,20,80,480
2016-06-25 19:20:00,2,6,5,13,78
2016-06-25 19:30:00,0,0,0,0,0
2016-06-25 19:40:00,0,0,0,0,0
2016-06-25 19:50:00,1,2,2,5,30
2016-06-25 20:00:00,2,6,3,11,66
2016-06-25 20:10:00,2,4,2,8,48
2016-06-25 20:20:00,0,0,0,0,0
2016-06-25 20:30:00,0,0,0,0,0
2016-06-25 20:40:00,0,0,0,0,0
2016-06-25 20:50:00,0,0,0,0,0
2016-06-25 21:00:00,0,0,0,0,0
2016-06-25 21:10:00,0,0,0,0,0
2016-06-25 21:20:00,0,0,0,0,0
2016-06-25 21:30:00,0,0,0,0,0
2016-06-25 21:40:00,0,0,0,0,0
2016-06-25 21:50:00,0,0,0,0,0
2016-06-25 22:00:00,0,0,0,0,0
2016-06-25 22:10:00,0,0,0,0,0
2016-06-26 04:10:00,0,0,0,0,0
2016-06-26 04:20:00,0,0,0,0,0
2016-06-26 04:30:00,0,0,0,0,0
2016-06-26 04:40:00,0,0,0,0,0
2016-06-26 04:50:00,1,5,3,9,54
2016-06-26 05:00:00,4,17,7,28,168
2016-06-26 05:10:00,11,23,16,50,300
2016-06-26 05:20:00,9,21,16,46,276
2016-06-26 05:30:00,19,30,27,76,456
2016-06-26 05:40:00,30,45,35,110,660
2016-06-26 05:50:00,35,51,45,131,786
2016-06-26 06:00:00,44,74,80,198,1188
2016-06-26 06:10:00,60,86,74,220,1320
2016-06-26 06:20:00,50,71,61,182,1092
2016-06-26 06:30:00,42,70,62,174,1044
2016-06-26 06:40:00,76,87,90,253,1518
2016-06-26 06:50:00,66,87,71,224,1344
2016-06-26 07:00:00,70,88,67,225,1350
2016-06-26 07:10:00,108,200,105,413,2478
2016-06-26 07:20:00,55,77,47,179,1074
2016-06-26 07:30:00,81,101,89,271,1626
2016-06-26 07:40:00,117,187,99,403,2418
2016-06-26 07:50:00,80,95,61,236,1416
2016-06-26 08:00:00,98,111,94,303,1818
2016-06-26 08:10:00,178,114,160,452,2712
2016-06-26 08:20:00,148,128,134,410,2460
2016-06-26 08:30:00,180,202,194,576,3456
2016-06-26 08:40:00,144,165,162,471,2826
2016-06-26 08:50:00,111,133,123,367,2202
2016-06-26 09:00:00,124,162,159,445,2670
2016-06-26 09:10:00,222,245,244,711,4266
2016-06-26 09:20:00,464,483,479,1426,8556
2016-06-26 09:30:00,370,391,385,1146,6876
2016-06-26 09:40:00,483,509,501,1493,8958
2016-06-26 09:50:00,437,462,458,1357,8142
2016-06-26 10:00:00,479,502,499,1480,8880
2016-06-26 10:10:00,646,668,668,1982,11892
2016-06-26 10:20:00,630,656,656,1942,11652
2016-06-26 10:30:00,641,669,670,1980,11880
2016-06-26 10:40:00,618,646,638,1902,11412
2016-06-26 10:50:00,665,697,685,2047,12282
2016-06-26 11:00:00,593,632,626,1851,11106
2016-06-26 11:10:00,907,938,938,2783,16698
2016-06-26 11:20:00,854,882,877,2613,15678
2016-06-26 11:30:00,853,889,887,2629,15774
2016-06-26 11:40:00,1051,1086,1080,3217,19302
2016-06-26 11:50:00,1096,1139,1114,3349,20094
2016-06-26 12:00:00,701,735,722,2158,12948
2016-06-26 12:10:00,1088,1134,1111,3333,19998
2016-06-26 12:20:00,1080,1115,1103,3298,19788
2016-06-26 12:30:00,1086,1120,1105,3311,19866
2016-06-26 12:40:00,1079,1125,1108,3312,19872
2016-06-26 12:50:00,1086,1116,1108,3310,19860
2016-06-26 13:00:00,1092,1125,1123,3340,20040
2016-06-26 13:10:00,1083,1123,1112,3318,19908
2016-06-26 13:20:00,1080,1112,1107,3299,19794
2016-06-26 13:30:00,1076,1108,1108,3292,19752
2016-06-26 13:40:00,1071,1109,1098,3278,19668
2016-06-26 13:50:00,1058,1098,1094,3250,19500
2016-06-26 14:00:00,1060,1096,1086,3242,19452
2016-06-26 14:10:00,1052,1082,1077,3211,19266
2016-06-26 14:20:00,1038,1062,1064,3164,18984
2016-06-26 14:30:00,1025,1052,1049,3126,18756
2016-06-26 14:40:00,1007,1040,1033,3080,18480
2016-06-26 14:50:00,992,1027,1018,3037,18222
2016-06-26 15:00:00,971,1008,998,2977,17862
2016-06-26 15:10:00,976,1012,1006,2994,17964
2016-06-26 15:20:00,500,521,516,1537,9222
2016-06-26 15:30:00,864,894,879,2637,15822
2016-06-26 15:40:00,898,930,914,2742,16452
2016-06-26 15:50:00,852,873,862,2587,15522
2016-06-26 16:00:00,840,860,851,2551,15306
2016-06-26 16:10:00,608,627,621,1856,11136
2016-06-26 16:20:00,529,554,548,1631,9786
2016-06-26 16:30:00,766,793,787,2346,14076
2016-06-26 16:40:00,684,703,698,2085,12510
2016-06-26 16:50:00,569,588,588,1745,10470
2016-06-26 17:00:00,605,630,628,1863,11178
2016-06-26 17:10:00,465,488,485,1438,8628
2016-06-26 17:20:00,161,199,188,548,3288
2016-06-26 17:30:00,444,464,456,1364,8184
2016-06-26 17:40:00,442,465,462,1369,8214
2016-06-26 17:50:00,368,391,387,1146,6876
2016-06-26 18:00:00,318,339,337,994,5964
2016-06-26 18:10:00,279,301,298,878,5268
2016-06-26 18:20:00,243,267,263,773,4638
2016-06-26 18:30:00,210,233,230,673,4038
2016-06-26 18:40:00,135,174,228,537,3222
2016-06-26 18:50:00,91,153,175,419,2514
2016-06-26 19:00:00,90,119,113,322,1932
2016-06-26 19:10:00,64,84,83,231,1386
2016-06-26 19:20:00,39,70,65,174,1044
2016-06-26 19:30:00,26,70,24,120,720
2016-06-26 19:40:00,28,58,23,109,654
2016-06-26 19:50:00,30,48,25,103,618
2016-06-26 20:00:00,26,36,33,95,570
2016-06-26 20:10:00,26,30,32,88,528
2016-06-26 20:20:00,24,30,26,80,480
2016-06-26 20:30:00,25,28,18,71,426
2016-06-26 20:40:00,19,30,14,63,378
2016-06-26 20:50:00,14,25,17,56,336
2016-06-26 21:00:00,16,28,21,65,390
2016-06-26 21:10:00,10,26,17,53,318
2016-06-26 21:20:00,4,8,5,17,102
2016-06-26 21:30:00,4,12,7,23,138
2016-06-26 21:40:00,2,5,3,10,60
2016-06-26 21:50:00,0,0,0,0,0
2016-06-26 22:00:00,0,0,0,0,0
2016-06-26 22:10:00,0,0,0,0,0
2016-06-26 22:20:00,0,0,0,0,0
2016-06-27 03:50:00,0,0,0,0,0
2016-06-27 04:00:00,0,0,0,0,0
2016-06-27 04:10:00,0,0,0,0,0
2016-06-27 04:20:00,0,0,0,0,0
2016-06-27 04:30:00,0,0,0,0,0
2016-06-27 04:40:00,0,1,0,1,6
2016-06-27 04:50:00,5,10,6,21,126
2016-06-27 05:00:00,5,8,7,20,120
2016-06-27 05:10:00,9,17,11,37,222
2016-06-27 05:20:00,18,28,11,57,342
2016-06-27 05:30:00,21,38,15,74,444
2016-06-27 05:40:00,12,23,21,56,336
2016-06-27 05:50:00,18,26,25,69,414
2016-06-27 06:00:00,17,48,29,94,564
2016-06-27 06:10:00,42,56,54,152,912
2016-06-27 06:20:00,34,54,40,128,768
2016-06-27 06:30:00,35,49,30,114,684
2016-06-27 06:40:00,18,88,23,129,774
2016-06-27 06:50:00,65,60,76,201,1206
2016-06-27 07:00:00,77,78,91,246,1476
2016-06-27 07:10:00,58,57,74,189,1134
2016-06-27 07:20:00,101,121,81,303,1818
2016-06-27 07:30:00,51,55,72,178,1068
2016-06-27 07:40:00,154,264,134,552,3312
2016-06-27 07:50:00,235,270,251,756,4536
2016-06-27 08:00:00,284,309,306,899,5394
2016-06-27 08:10:00,203,225,223,651,3906
2016-06-27 08:20:00,347,370,368,1085,6510
2016-06-27 08:30:00,252,273,272,797,4782
2016-06-27 08:40:00,493,513,512,1518,9108
2016-06-27 08:50:00,366,389,386,1141,6846
2016-06-27 09:00:00,271,293,293,857,5142
2016-06-27 09:10:00,280,307,307,894,5364
2016-06-27 09:20:00,248,271,271,790,4740
2016-06-27 09:30:00,501,526,523,1550,9300
2016-06-27 09:40:00,922,947,941,2810,16860
2016-06-27 09:50:00,441,463,461,1365,8190
2016-06-27 10:00:00,397,419,416,1232,7392
2016-06-27 10:10:00,478,499,488,1465,8790
2016-06-27 10:20:00,534,555,552,1641,9846
2016-06-27 10:30:00,499,520,515,1534,9204
2016-06-27 10:40:00,809,830,821,2460,14760
2016-06-27 10:50:00,925,951,948,2824,16944
2016-06-27 11:00:00,904,935,927,2766,16596
2016-06-27 11:10:00,866,884,870,2620,15720
2016-06-27 11:20:00,437,457,453,1347,8082
2016-06-27 11:30:00,320,346,341,1007,6042
2016-06-27 11:40:00,330,352,349,1031,6186
2016-06-27 11:50:00,667,689,686,2042,12252
2016-06-27 12:00:00,500,521,519,1540,9240
2016-06-27 12:10:00,454,473,471,1398,8388
2016-06-27 12:20:00,829,851,844,2524,15144
2016-06-27 12:30:00,601,626,620,1847,11082
2016-06-27 12:40:00,374,395,391,1160,6960
2016-06-27 12:50:00,257,276,275,808,4848
2016-06-27 13:00:00,239,258,258,755,4530
2016-06-27 13:10:00,96,117,110,323,1938
2016-06-27 13:20:00,220,229,228,677,4062
2016-06-27 13:30:00,66,87,82,235,1410
2016-06-27 13:40:00,65,83,62,210,1260
2016-06-27 13:50:00,227,234,224,685,4110
2016-06-27 14:00:00,300,321,323,944,5664
2016-06-27 14:10:00,256,279,279,814,4884
2016-06-27 14:20:00,125,129,139,393,2358
2016-06-27 14:30:00,139,139,159,437,2622
2016-06-27 14:40:00,192,262,145,599,3594
2016-06-27 14:50:00,258,287,272,817,4902
2016-06-27 15:00:00,277,301,295,873,5238
2016-06-27 15:10:00,214,237,234,685,4110
2016-06-27 15:20:00,177,209,168,554,3324
2016-06-27 15:30:00,51,84,55,190,1140
2016-06-27 15:40:00,63,27,69,159,954
2016-06-27 15:50:00,88,35,92,215,1290
2016-06-27 16:00:00,132,239,122,493,2958
2016-06-27 16:10:00,297,326,322,945,5670
2016-06-27 16:20:00,206,232,229,667,4002
2016-06-27 16:30:00,143,168,163,474,2844
2016-06-27 16:40:00,143,166,160,469,2814
2016-06-27 16:50:00,116,127,134,377,2262
2016-06-27 17:00:00,41,58,70,169,1014
2016-06-27 17:10:00,74,74,85,233,1398
2016-06-27 17:20:00,74,121,115,310,1860
2016-06-27 17:30:00,39,82,78,199,1194
2016-06-27 17:40:00,35,53,53,141,846
2016-06-27 17:50:00,52,42,53,147,882
2016-06-27 18:00:00,76,56,90,222,1332
2016-06-27 18:10:00,87,95,153,335,2010
2016-06-27 18:20:00,96,106,103,305,1830
2016-06-27 18:30:00,95,66,100,261,1566
2016-06-27 18:40:00,18,34,27,79,474
2016-06-27 18:50:00,25,19,33,77,462
2016-06-27 19:00:00,26,43,33,102,612
2016-06-27 19:10:00,8,48,11,67,402
2016-06-27 19:20:00,47,73,65,185,1110
2016-06-27 19:30:00,68,150,170,388,2328
2016-06-27 19:40:00,84,157,175,416,2496
2016-06-27 19:50:00,71,116,135,322,1932
2016-06-27 20:00:00,90,56,96,242,1452
2016-06-27 20:10:00,60,70,84,214,1284
2016-06-27 20:20:00,39,61,55,155,930
2016-06-27 20:30:00,26,61,24,111,666
2016-06-27 20:40:00,28,45,29,102,612
2016-06-27 20:50:00,17,31,18,66,396
2016-06-27 21:00:00,10,15,12,37,222
2016-06-27 21:10:00,4,12,9,25,150
2016-06-27 21:20:00,3,8,4,15,90
2016-06-27 21:30:00,1,3,2,6,36
2016-06-27 21:40:00,0,0,0,0,0
2016-06-27 21:50:00,0,0,0,0,0
2016-06-27 22:00:00,0,0,0,0,0
2016-06-27 22:10:00,0,0,0,0,0
2016-06-27 22:20:00,0,0,0,0,0
2016-06-28 03:50:00,0,0,0,0,0
2016-06-28 04:00:00,0,0,0,0,0
2016-06-28 04:10:00,0,0,0,0,0
2016-06-28 04:20:00,0,0,0,0,0
2016-06-28 04:30:00,0,0,0,0,0
2016-06-28 04:40:00,0,1,0,1,6
2016-06-28 04:50:00,1,5,4,10,60
2016-06-28 05:00:00,5,9,7,21,126
2016-06-28 05:10:00,12,34,10,56,336
2016-06-28 05:20:00,26,47,15,88,528
2016-06-28 05:30:00,17,40,14,71,426
2016-06-28 05:40:00,28,58,32,118,708
2016-06-28 05:50:00,47,73,57,177,1062
2016-06-28 06:00:00,31,92,68,191,1146
2016-06-28 06:10:00,31,69,49,149,894
2016-06-28 06:20:00,27,64,62,153,918
2016-06-28 06:30:00,29,89,77,195,1170
2016-06-28 06:40:00,30,71,65,166,996
2016-06-28 06:50:00,31,55,50,136,816
2016-06-28 07:00:00,37,57,56,150,900
2016-06-28 07:10:00,22,73,57,152,912
2016-06-28 07:20:00,57,115,112,284,1704
2016-06-28 07:30:00,74,172,213,459,2754
2016-06-28 07:40:00,155,247,131,533,3198
2016-06-28 07:50:00,248,306,227,781,4686
2016-06-28 08:00:00,384,405,394,1183,7098
2016-06-28 08:10:00,304,326,315,945,5670
2016-06-28 08:20:00,273,294,287,854,5124
2016-06-28 08:30:00,291,312,304,907,5442
2016-06-28 08:40:00,248,270,263,781,4686
2016-06-28 08:50:00,243,264,257,764,4584
2016-06-28 09:00:00,278,299,289,866,5196
2016-06-28 09:10:00,320,340,330,990,5940
2016-06-28 09:20:00,442,465,458,1365,8190
2016-06-28 09:30:00,409,432,425,1266,7596
2016-06-28 09:40:00,456,477,471,1404,8424
2016-06-28 09:50:00,311,334,327,972,5832
2016-06-28 10:00:00,337,360,353,1050,6300
2016-06-28 10:10:00,461,483,475,1419,8514
2016-06-28 10:20:00,448,471,464,1383,8298
2016-06-28 10:30:00,482,506,500,1488,8928
2016-06-28 10:40:00,630,656,647,1933,11598
2016-06-28 10:50:00,1004,1033,1021,3058,18348
2016-06-28 11:00:00,945,978,967,2890,17340
2016-06-28 11:10:00,1003,1031,1021,3055,18330
2016-06-28 11:20:00,1009,1030,1022,3061,18366
2016-06-28 11:30:00,1016,1032,1029,3077,18462
2016-06-28 11:40:00,1015,1032,1025,3072,18432
2016-06-28 11:50:00,1041,1060,1053,3154,18924
2016-06-28 12:00:00,1051,1072,1057,3180,19080
2016-06-28 12:10:00,1070,1097,1086,3253,19518
2016-06-28 12:20:00,819,842,836,2497,14982
2016-06-28 12:30:00,807,830,825,2462,14772
2016-06-28 12:40:00,914,930,930,2774,16644
2016-06-28 12:50:00,1124,1140,1135,3399,20394
2016-06-28 13:00:00,960,984,971,2915,17490
2016-06-28 13:10:00,886,906,907,2699,16194
2016-06-28 13:20:00,1301,1324,1315,3940,23640
2016-06-28 13:30:00,1070,1111,1088,3269,19614
2016-06-28 13:40:00,858,888,880,2626,15756
2016-06-28 13:50:00,1011,1031,1029,3071,18426
2016-06-28 14:00:00,756,780,768,2304,13824
2016-06-28 14:10:00,810,828,827,2465,14790
2016-06-28 14:20:00,353,371,368,1092,6552
2016-06-28 14:30:00,389,415,409,1213,7278
2016-06-28 14:40:00,971,1001,999,2971,17826
2016-06-28 14:50:00,1048,1087,1074,3209,19254
2016-06-28 15:00:00,911,955,941,2807,16842
2016-06-28 15:10:00,854,899,880,2633,15798
2016-06-28 15:20:00,1016,1048,1026,3090,18540
2016-06-28 15:30:00,992,1013,997,3002,18012
2016-06-28 15:40:00,904,916,911,2731,16386
2016-06-28 15:50:00,847,864,852,2563,15378
2016-06-28 16:00:00,824,849,844,2517,15102
2016-06-28 16:10:00,773,807,796,2376,14256
2016-06-28 16:20:00,740,776,764,2280,13680
2016-06-28 16:30:00,629,665,656,1950,11700
2016-06-28 16:40:00,363,392,384,1139,6834
2016-06-28 16:50:00,513,541,533,1587,9522
2016-06-28 17:00:00,366,397,388,1151,6906
2016-06-28 17:10:00,135,201,204,540,3240
2016-06-28 17:20:00,192,215,210,617,3702
2016-06-28 17:30:00,356,378,372,1106,6636
2016-06-28 17:40:00,428,449,440,1317,7902
2016-06-28 17:50:00,370,395,388,1153,6918
2016-06-28 18:00:00,325,349,335,1009,6054
2016-06-28 18:10:00,280,307,295,882,5292
2016-06-28 18:20:00,241,269,255,765,4590
2016-06-28 18:30:00,198,223,212,633,3798
2016-06-28 18:40:00,159,184,177,520,3120
2016-06-28 18:50:00,135,161,153,449,2694
2016-06-28 19:00:00,97,122,115,334,2004
2016-06-28 19:10:00,86,63,101,250,1500
2016-06-28 19:20:00,17,83,81,181,1086
2016-06-28 19:30:00,35,60,33,128,768
2016-06-28 19:40:00,30,58,51,139,834
2016-06-28 19:50:00,26,60,55,141,846
2016-06-28 20:00:00,32,58,44,134,804
2016-06-28 20:10:00,20,85,23,128,768
2016-06-28 20:20:00,53,46,17,116,696
2016-06-28 20:30:00,23,33,32,88,528
2016-06-28 20:40:00,12,35,24,71,426
2016-06-28 20:50:00,6,33,18,57,342
2016-06-28 21:00:00,4,24,12,40,240
2016-06-28 21:10:00,2,16,7,25,150
2016-06-28 21:20:00,4,5,5,14,84
2016-06-28 21:30:00,1,3,1,5,30
2016-06-28 21:40:00,0,0,0,0,0
2016-06-28 21:50:00,0,0,0,0,0
2016-06-28 22:00:00,0,0,0,0,0
2016-06-28 22:10:00,0,0,0,0,0
2016-06-28 22:20:00,0,0,0,0,0
2016-06-29 04:00:00,0,0,0,0,0
2016-06-29 04:10:00,0,0,0,0,0
2016-06-29 04:20:00,0,0,0,0,0
2016-06-29 04:30:00,0,0,0,0,0
2016-06-29 04:40:00,0,0,0,0,0
2016-06-29 04:50:00,0,1,0,1,6
2016-06-29 05:00:00,4,6,5,15,90
2016-06-29 05:10:00,7,20,10,37,222
2016-06-29 05:20:00,16,27,17,60,360
2016-06-29 05:30:00,19,39,25,83,498
2016-06-29 05:40:00,37,73,39,149,894
2016-06-29 05:50:00,51,60,45,156,936
2016-06-29 06:00:00,27,79,25,131,786
2016-06-29 06:10:00,32,61,38,131,786
2016-06-29 06:20:00,25,39,31,95,570
2016-06-29 06:30:00,17,38,28,83,498
2016-06-29 06:40:00,28,56,33,117,702
2016-06-29 06:50:00,23,82,27,132,792
2016-06-29 07:00:00,39,76,63,178,1068
2016-06-29 07:10:00,53,125,121,299,1794
2016-06-29 07:20:00,124,240,96,460,2760
2016-06-29 07:30:00,164,321,0,485,2910
2016-06-29 07:40:00,101,132,245,478,2868
2016-06-29 07:50:00,171,330,9,510,3060
2016-06-29 08:00:00,65,168,101,334,2004
2016-06-29 08:10:00,60,141,130,331,1986
2016-06-29 08:20:00,87,154,149,390,2340
2016-06-29 08:30:00,88,160,162,410,2460
2016-06-29 08:40:00,125,267,48,440,2640
2016-06-29 08:50:00,95,164,128,387,2322
2016-06-29 09:00:00,55,98,80,233,1398
2016-06-29 09:10:00,50,107,95,252,1512
2016-06-29 09:20:00,60,86,71,217,1302
2016-06-29 09:30:00,102,127,114,343,2058
2016-06-29 09:40:00,99,128,124,351,2106
2016-06-29 09:50:00,103,128,135,366,2196
2016-06-29 10:00:00,127,113,143,383,2298
2016-06-29 10:10:00,62,98,77,237,1422
2016-06-29 10:20:00,74,116,98,288,1728
2016-06-29 10:30:00,77,105,96,278,1668
2016-06-29 10:40:00,101,121,124,346,2076
2016-06-29 10:50:00,46,155,163,364,2184
2016-06-29 11:00:00,46,140,140,326,1956
2016-06-29 11:10:00,83,103,116,302,1812
2016-06-29 11:20:00,66,78,100,244,1464
2016-06-29 11:30:00,46,89,80,215,1290
2016-06-29 11:40:00,43,113,112,268,1608
2016-06-29 11:50:00,76,119,107,302,1812
2016-06-29 12:00:00,88,131,123,342,2052
2016-06-29 12:10:00,77,164,181,422,2532
2016-06-29 12:20:00,187,283,172,642,3852
2016-06-29 12:30:00,259,282,276,817,4902
2016-06-29 12:40:00,420,444,438,1302,7812
2016-06-29 12:50:00,307,329,324,960,5760
2016-06-29 13:00:00,243,263,258,764,4584
2016-06-29 13:10:00,252,274,267,793,4758
2016-06-29 13:20:00,479,504,496,1479,8874
2016-06-29 13:30:00,487,511,508,1506,9036
2016-06-29 13:40:00,556,582,575,1713,10278
2016-06-29 13:50:00,857,883,871,2611,15666
2016-06-29 14:00:00,1006,1030,1019,3055,18330
2016-06-29 14:10:00,622,654,642,1918,11508
2016-06-29 14:20:00,877,905,893,2675,16050
2016-06-29 14:30:00,1026,1045,1037,3108,18648
2016-06-29 14:40:00,1007,1023,1015,3045,18270
2016-06-29 14:50:00,980,1006,1000,2986,17916
2016-06-29 15:00:00,970,983,985,2938,17628
2016-06-29 15:10:00,974,998,993,2965,17790
2016-06-29 15:20:00,692,716,708,2116,12696
2016-06-29 15:30:00,337,359,353,1049,6294
2016-06-29 15:40:00,753,775,766,2294,13764
2016-06-29 15:50:00,780,804,795,2379,14274
2016-06-29 16:00:00,270,294,290,854,5124
2016-06-29 16:10:00,343,360,360,1063,6378
2016-06-29 16:20:00,412,427,428,1267,7602
2016-06-29 16:30:00,740,752,754,2246,13476
2016-06-29 16:40:00,734,742,745,2221,13326
2016-06-29 16:50:00,635,659,657,1951,11706
2016-06-29 17:00:00,531,553,553,1637,9822
2016-06-29 17:10:00,484,509,504,1497,8982
2016-06-29 17:20:00,494,522,515,1531,9186
2016-06-29 17:30:00,467,488,486,1441,8646
2016-06-29 17:40:00,435,466,456,1357,8142
2016-06-29 17:50:00,372,400,394,1166,6996
2016-06-29 18:00:00,324,348,341,1013,6078
2016-06-29 18:10:00,281,303,295,879,5274
2016-06-29 18:20:00,240,259,251,750,4500
2016-06-29 18:30:00,197,221,215,633,3798
2016-06-29 18:40:00,184,293,40,517,3102
2016-06-29 18:50:00,146,136,131,413,2478
2016-06-29 19:00:00,141,118,127,386,2316
2016-06-29 19:10:00,70,58,86,214,1284
2016-06-29 19:20:00,120,132,155,407,2442
2016-06-29 19:30:00,116,63,135,314,1884
2016-06-29 19:40:00,91,71,102,264,1584
2016-06-29 19:50:00,69,85,83,237,1422
2016-06-29 20:00:00,107,39,124,270,1620
2016-06-29 20:10:00,69,78,88,235,1410
2016-06-29 20:20:00,36,78,43,157,942
2016-06-29 20:30:00,35,24,15,74,444
2016-06-29 20:40:00,10,16,16,42,252
2016-06-29 20:50:00,8,22,10,40,240
2016-06-29 21:00:00,12,23,11,46,276
2016-06-29 21:10:00,10,10,16,36,216
2016-06-29 21:20:00,3,6,10,19,114
2016-06-29 21:30:00,1,2,1,4,24
2016-06-29 21:40:00,0,0,0,0,0
2016-06-29 21:50:00,0,0,0,0,0
2016-06-29 22:00:00,0,0,0,0,0
2016-06-29 22:10:00,0,0,0,0,0
2016-06-29 22:20:00,0,0,0,0,0
2016-06-30 04:10:00,0,0,0,0,0
2016-06-30 04:20:00,0,0,0,0,0
2016-06-30 04:30:00,0,0,0,0,0
2016-06-30 04:40:00,0,0,0,0,0
2016-06-30 04:50:00,0,0,0,0,0
2016-06-30 05:00:00,0,0,0,0,0
2016-06-30 05:10:00,3,2,3,8,48
2016-06-30 05:20:00,7,6,9,22,132
2016-06-30 05:30:00,15,19,22,56,336
2016-06-30 05:40:00,15,20,24,59,354
2016-06-30 05:50:00,20,27,28,75,450
2016-06-30 06:00:00,24,52,30,106,636
2016-06-30 06:10:00,28,67,36,131,786
2016-06-30 06:20:00,8,86,85,179,1074
2016-06-30 06:30:00,33,60,73,166,996
2016-06-30 06:40:00,53,54,75,182,1092
2016-06-30 06:50:00,61,57,77,195,1170
2016-06-30 07:00:00,30,35,34,99,594
2016-06-30 07:10:00,26,49,27,102,612
2016-06-30 07:20:00,29,50,25,104,624
2016-06-30 07:30:00,25,50,21,96,576
2016-06-30 07:40:00,27,50,26,103,618
2016-06-30 07:50:00,33,74,47,154,924
2016-06-30 08:00:00,30,82,49,161,966
2016-06-30 08:10:00,36,110,110,256,1536
2016-06-30 08:20:00,95,83,102,280,1680
2016-06-30 08:30:00,97,70,110,277,1662
2016-06-30 08:40:00,43,78,60,181,1086
2016-06-30 08:50:00,73,94,69,236,1416
2016-06-30 09:00:00,84,86,80,250,1500
2016-06-30 09:10:00,94,148,178,420,2520
2016-06-30 09:20:00,87,161,197,445,2670
2016-06-30 09:30:00,227,212,213,652,3912
2016-06-30 09:40:00,288,308,301,897,5382
2016-06-30 09:50:00,262,284,279,825,4950
2016-06-30 10:00:00,415,437,434,1286,7716
2016-06-30 10:10:00,394,414,410,1218,7308
2016-06-30 10:20:00,331,352,349,1032,6192
2016-06-30 10:30:00,302,324,321,947,5682
2016-06-30 10:40:00,351,371,365,1087,6522
2016-06-30 10:50:00,449,467,456,1372,8232
2016-06-30 11:00:00,605,627,616,1848,11088
2016-06-30 11:10:00,389,411,406,1206,7236
2016-06-30 11:20:00,466,488,485,1439,8634
2016-06-30 11:30:00,1079,1104,1097,3280,19680
2016-06-30 11:40:00,746,764,755,2265,13590
2016-06-30 11:50:00,650,670,660,1980,11880
2016-06-30 12:00:00,560,583,579,1722,10332
2016-06-30 12:10:00,383,405,402,1190,7140
2016-06-30 12:20:00,339,361,358,1058,6348
2016-06-30 12:30:00,147,168,165,480,2880
2016-06-30 12:40:00,239,246,157,642,3852
2016-06-30 12:50:00,403,423,420,1246,7476
2016-06-30 13:00:00,435,458,454,1347,8082
2016-06-30 13:10:00,530,552,549,1631,9786
2016-06-30 13:20:00,176,198,203,577,3462
2016-06-30 13:30:00,225,205,206,636,3816
2016-06-30 13:40:00,603,619,608,1830,10980
2016-06-30 13:50:00,370,390,383,1143,6858
2016-06-30 14:00:00,287,306,299,892,5352
2016-06-30 14:10:00,173,198,187,558,3348
2016-06-30 14:20:00,70,87,85,242,1452
2016-06-30 14:30:00,104,132,115,351,2106
2016-06-30 14:40:00,89,123,126,338,2028
2016-06-30 14:50:00,216,239,229,684,4104
2016-06-30 15:00:00,213,231,229,673,4038
2016-06-30 15:10:00,292,316,312,920,5520
2016-06-30 15:20:00,310,329,328,967,5802
2016-06-30 15:30:00,294,318,314,926,5556
2016-06-30 15:40:00,248,273,268,789,4734
2016-06-30 15:50:00,265,291,284,840,5040
2016-06-30 16:00:00,361,387,378,1126,6756
2016-06-30 16:10:00,705,731,714,2150,12900
2016-06-30 16:20:00,341,368,358,1067,6402
2016-06-30 16:30:00,387,421,410,1218,7308
2016-06-30 16:40:00,488,525,514,1527,9162
2016-06-30 16:50:00,385,422,417,1224,7344
2016-06-30 17:00:00,535,570,570,1675,10050
2016-06-30 17:10:00,511,543,543,1597,9582
2016-06-30 17:20:00,307,337,333,977,5862
2016-06-30 17:30:00,270,297,294,861,5166
2016-06-30 17:40:00,325,357,348,1030,6180
2016-06-30 17:50:00,254,286,276,816,4896
2016-06-30 18:00:00,287,316,308,911,5466
2016-06-30 18:10:00,252,276,266,794,4764
2016-06-30 18:20:00,235,259,250,744,4464
2016-06-30 18:30:00,157,188,179,524,3144
2016-06-30 18:40:00,80,140,91,311,1866
2016-06-30 18:50:00,128,137,117,382,2292
2016-06-30 19:00:00,153,154,84,391,2346
2016-06-30 19:10:00,153,111,156,420,2520
2016-06-30 19:20:00,146,142,121,409,2454
2016-06-30 19:30:00,112,145,80,337,2022
2016-06-30 19:40:00,56,82,59,197,1182
2016-06-30 19:50:00,30,65,19,114,684
2016-06-30 20:00:00,29,41,31,101,606
2016-06-30 20:10:00,14,51,41,106,636
2016-06-30 20:20:00,53,75,66,194,1164
2016-06-30 20:30:00,49,75,67,191,1146
2016-06-30 20:40:00,25,69,29,123,738
2016-06-30 20:50:00,18,49,21,88,528
2016-06-30 21:00:00,11,7,7,25,150
2016-06-30 21:10:00,4,9,6,19,114
2016-06-30 21:20:00,4,5,5,14,84
2016-06-30 21:30:00,0,0,0,0,0
2016-06-30 21:40:00,0,0,0,0,0
2016-06-30 21:50:00,0,0,0,0,0
2016-06-30 22:00:00,0,0,0,0,0
2016-06-30 22:10:00,0,0,0,0,0
2016-07-01 04:10:00,0,0,0,0,0
2016-07-01 04:20:00,0,0,0,0,0
2016-07-01 04:30:00,0,0,0,0,0
2016-07-01 04:40:00,0,0,0,0,0
2016-07-01 04:50:00,0,0,0,0,0
2016-07-01 05:00:00,0,0,0,0,0
2016-07-01 05:10:00,2,6,3,11,66
2016-07-01 05:20:00,13,33,18,64,384
2016-07-01 05:30:00,10,31,17,58,348
2016-07-01 05:40:00,6,21,11,38,228
2016-07-01 05:50:00,4,7,7,18,108
2016-07-01 06:00:00,20,44,22,86,516
2016-07-01 06:10:00,23,42,25,90,540
2016-07-01 06:20:00,10,21,16,47,282
2016-07-01 06:30:00,70,81,91,242,1452
2016-07-01 06:40:00,49,95,108,252,1512
2016-07-01 06:50:00,49,114,133,296,1776
2016-07-01 07:00:00,147,258,85,490,2940
2016-07-01 07:10:00,85,122,121,328,1968
2016-07-01 07:20:00,147,133,126,406,2436
2016-07-01 07:30:00,98,79,120,297,1782
2016-07-01 07:40:00,89,135,152,376,2256
2016-07-01 07:50:00,101,127,111,339,2034
2016-07-01 08:00:00,46,173,245,464,2784
2016-07-01 08:10:00,149,187,176,512,3072
2016-07-01 08:20:00,181,204,200,585,3510
2016-07-01 08:30:00,332,355,355,1042,6252
2016-07-01 08:40:00,336,358,357,1051,6306
2016-07-01 08:50:00,418,444,440,1302,7812
2016-07-01 09:00:00,326,350,346,1022,6132
2016-07-01 09:10:00,173,196,192,561,3366
2016-07-01 09:20:00,235,257,254,746,4476
2016-07-01 09:30:00,141,152,153,446,2676
2016-07-01 09:40:00,71,90,81,242,1452
2016-07-01 09:50:00,92,145,92,329,1974
2016-07-01 10:00:00,226,184,160,570,3420
2016-07-01 10:10:00,99,147,146,392,2352
2016-07-01 10:20:00,299,326,309,934,5604
2016-07-01 10:30:00,272,294,288,854,5124
2016-07-01 10:40:00,167,195,78,440,2640
2016-07-01 10:50:00,200,184,144,528,3168
2016-07-01 11:00:00,232,253,248,733,4398
2016-07-01 11:10:00,121,191,159,471,2826
2016-07-01 11:20:00,123,149,146,418,2508
2016-07-01 11:30:00,156,166,117,439,2634
2016-07-01 11:40:00,250,276,263,789,4734
2016-07-01 11:50:00,286,310,304,900,5400
2016-07-01 12:00:00,207,231,227,665,3990
2016-07-01 12:10:00,223,234,243,700,4200
2016-07-01 12:20:00,131,130,148,409,2454
2016-07-01 12:30:00,190,212,209,611,3666
2016-07-01 12:40:00,341,361,357,1059,6354
2016-07-01 12:50:00,574,600,592,1766,10596
2016-07-01 13:00:00,244,265,260,769,4614
2016-07-01 13:10:00,185,181,184,550,3300
2016-07-01 13:20:00,80,80,96,256,1536
2016-07-01 13:30:00,134,185,152,471,2826
2016-07-01 13:40:00,38,59,41,138,828
2016-07-01 13:50:00,44,50,65,159,954
2016-07-01 14:00:00,188,195,204,587,3522
2016-07-01 14:10:00,271,296,292,859,5154
2016-07-01 14:20:00,274,301,298,873,5238
2016-07-01 14:30:00,244,270,266,780,4680
2016-07-01 14:40:00,504,537,530,1571,9426
2016-07-01 14:50:00,643,672,669,1984,11904
2016-07-01 15:00:00,223,248,243,714,4284
2016-07-01 15:10:00,274,300,295,869,5214
2016-07-01 15:20:00,236,266,265,767,4602
2016-07-01 15:30:00,107,132,126,365,2190
2016-07-01 15:40:00,103,139,81,323,1938
2016-07-01 15:50:00,113,163,93,369,2214
2016-07-01 16:00:00,169,234,191,594,3564
2016-07-01 16:10:00,128,109,134,371,2226
2016-07-01 16:20:00,133,122,127,382,2292
2016-07-01 16:30:00,89,96,112,297,1782
2016-07-01 16:40:00,94,96,137,327,1962
2016-07-01 16:50:00,95,69,110,274,1644
2016-07-01 17:00:00,73,136,126,335,2010
2016-07-01 17:10:00,45,96,88,229,1374
2016-07-01 17:20:00,94,72,105,271,1626
2016-07-01 17:30:00,155,228,132,515,3090
2016-07-01 17:40:00,215,240,236,691,4146
2016-07-01 17:50:00,293,321,320,934,5604
2016-07-01 18:00:00,208,235,228,671,4026
2016-07-01 18:10:00,159,186,180,525,3150
2016-07-01 18:20:00,87,96,104,287,1722
2016-07-01 18:30:00,48,85,104,237,1422
2016-07-01 18:40:00,39,142,138,319,1914
2016-07-01 18:50:00,49,101,114,264,1584
2016-07-01 19:00:00,56,68,72,196,1176
2016-07-01 19:10:00,31,75,63,169,1014
2016-07-01 19:20:00,26,46,29,101,606
2016-07-01 19:30:00,39,43,50,132,792
2016-07-01 19:40:00,32,59,41,132,792
2016-07-01 19:50:00,27,62,46,135,810
2016-07-01 20:00:00,15,39,29,83,498
2016-07-01 20:10:00,4,14,10,28,168
2016-07-01 20:20:00,4,8,7,19,114
2016-07-01 20:30:00,4,11,8,23,138
2016-07-01 20:40:00,0,2,1,3,18
2016-07-01 20:50:00,1,3,2,6,36
2016-07-01 21:00:00,0,0,0,0,0
2016-07-01 21:10:00,1,4,4,9,54
2016-07-01 21:20:00,2,11,6,19,114
2016-07-01 21:30:00,1,2,2,5,30
2016-07-01 21:40:00,0,0,0,0,0
2016-07-01 21:50:00,0,0,0,0,0
2016-07-01 22:00:00,0,0,0,0,0
2016-07-02 04:40:00,0,0,0,0,0
2016-07-02 04:50:00,0,0,0,0,0
2016-07-02 05:00:00,0,0,0,0,0
2016-07-02 05:10:00,0,0,0,0,0
2016-07-02 05:20:00,0,0,0,0,0
2016-07-02 05:30:00,9,8,9,26,156
2016-07-02 05:40:00,3,4,3,10,60
2016-07-02 05:50:00,6,12,7,25,150
2016-07-02 06:00:00,5,7,5,17,102
2016-07-02 06:10:00,13,18,20,51,306
2016-07-02 06:20:00,37,59,39,135,810
2016-07-02 06:30:00,22,28,23,73,438
2016-07-02 06:40:00,45,60,50,155,930
2016-07-02 06:50:00,55,80,61,196,1176
2016-07-02 07:00:00,51,76,71,198,1188
2016-07-02 07:10:00,74,57,89,220,1320
2016-07-02 07:20:00,112,52,124,288,1728
2016-07-02 07:30:00,166,126,156,448,2688
2016-07-02 07:40:00,221,195,165,581,3486
2016-07-02 07:50:00,198,257,200,655,3930
2016-07-02 08:00:00,110,134,131,375,2250
2016-07-02 08:10:00,135,261,46,442,2652
2016-07-02 08:20:00,107,112,135,354,2124
2016-07-02 08:30:00,154,103,162,419,2514
2016-07-02 08:40:00,129,121,129,379,2274
2016-07-02 08:50:00,101,118,154,373,2238
2016-07-02 09:00:00,86,95,98,279,1674
2016-07-02 09:10:00,174,182,81,437,2622
2016-07-02 09:20:00,174,264,87,525,3150
2016-07-02 09:30:00,293,234,250,777,4662
2016-07-02 09:40:00,263,285,281,829,4974
2016-07-02 09:50:00,374,401,396,1171,7026
2016-07-02 10:00:00,398,427,423,1248,7488
2016-07-02 10:10:00,349,373,376,1098,6588
2016-07-02 10:20:00,417,452,444,1313,7878
2016-07-02 10:30:00,450,488,479,1417,8502
2016-07-02 10:40:00,491,536,528,1555,9330
2016-07-02 10:50:00,560,599,587,1746,10476
2016-07-02 11:00:00,584,618,610,1812,10872
2016-07-02 11:10:00,783,824,820,2427,14562
2016-07-02 11:20:00,578,614,606,1798,10788
2016-07-02 11:30:00,765,797,800,2362,14172
2016-07-02 11:40:00,765,799,787,2351,14106
2016-07-02 11:50:00,666,694,687,2047,12282
2016-07-02 12:00:00,747,783,774,2304,13824
2016-07-02 12:10:00,795,837,826,2458,14748
2016-07-02 12:20:00,778,823,812,2413,14478
2016-07-02 12:30:00,857,896,890,2643,15858
2016-07-02 12:40:00,792,829,824,2445,14670
2016-07-02 12:50:00,858,898,886,2642,15852
2016-07-02 13:00:00,897,937,919,2753,16518
2016-07-02 13:10:00,739,773,764,2276,13656
2016-07-02 13:20:00,830,871,854,2555,15330
2016-07-02 13:30:00,931,977,960,2868,17208
2016-07-02 13:40:00,938,974,963,2875,17250
2016-07-02 13:50:00,984,1023,1008,3015,18090
2016-07-02 14:00:00,961,995,977,2933,17598
2016-07-02 14:10:00,882,924,908,2714,16284
2016-07-02 14:20:00,832,875,864,2571,15426
2016-07-02 14:30:00,877,916,908,2701,16206
2016-07-02 14:40:00,868,909,903,2680,16080
2016-07-02 14:50:00,911,942,941,2794,16764
2016-07-02 15:00:00,853,899,896,2648,15888
2016-07-02 15:10:00,989,1025,1018,3032,18192
2016-07-02 15:20:00,637,669,662,1968,11808
2016-07-02 15:30:00,658,686,683,2027,12162
2016-07-02 15:40:00,861,889,887,2637,15822
2016-07-02 15:50:00,856,893,886,2635,15810
2016-07-02 16:00:00,779,810,804,2393,14358
2016-07-02 16:10:00,809,840,835,2484,14904
2016-07-02 16:20:00,756,781,784,2321,13926
2016-07-02 16:30:00,721,750,740,2211,13266
2016-07-02 16:40:00,694,720,715,2129,12774
2016-07-02 16:50:00,645,669,670,1984,11904
2016-07-02 17:00:00,599,621,623,1843,11058
2016-07-02 17:10:00,561,584,582,1727,10362
2016-07-02 17:20:00,517,541,536,1594,9564
2016-07-02 17:30:00,466,499,491,1456,8736
2016-07-02 17:40:00,425,452,445,1322,7932
2016-07-02 17:50:00,372,396,390,1158,6948
2016-07-02 18:00:00,325,347,345,1017,6102
2016-07-02 18:10:00,277,299,296,872,5232
2016-07-02 18:20:00,228,251,248,727,4362
2016-07-02 18:30:00,84,98,91,273,1638
2016-07-02 18:40:00,171,144,135,450,2700
2016-07-02 18:50:00,151,165,152,468,2808
2016-07-02 19:00:00,88,112,108,308,1848
2016-07-02 19:10:00,76,84,91,251,1506
2016-07-02 19:20:00,52,82,55,189,1134
2016-07-02 19:30:00,51,79,59,189,1134
2016-07-02 19:40:00,52,58,63,173,1038
2016-07-02 19:50:00,29,70,38,137,822
2016-07-02 20:00:00,28,49,31,108,648
2016-07-02 20:10:00,32,17,43,92,552
2016-07-02 20:20:00,33,23,27,83,498
2016-07-02 20:30:00,25,14,34,73,438
2016-07-02 20:40:00,17,18,26,61,366
2016-07-02 20:50:00,13,15,21,49,294
2016-07-02 21:00:00,9,12,14,35,210
2016-07-02 21:10:00,4,9,9,22,132
2016-07-02 21:20:00,2,6,4,12,72
2016-07-02 21:30:00,1,2,1,4,24
2016-07-02 21:40:00,0,0,0,0,0
2016-07-02 21:50:00,0,0,0,0,0
2016-07-02 22:00:00,0,0,0,0,0
2016-07-02 22:10:00,0,0,0,0,0
2016-07-02 22:20:00,0,0,0,0,0
2016-07-03 03:50:00,0,0,0,0,0
2016-07-03 04:00:00,0,0,0,0,0
2016-07-03 04:10:00,0,0,0,0,0
2016-07-03 04:20:00,0,0,0,0,0
2016-07-03 04:30:00,0,0,0,0,0
2016-07-03 04:40:00,0,2,0,2,12
2016-07-03 04:50:00,2,5,1,8,48
2016-07-03 05:00:00,3,1,2,6,36
2016-07-03 05:10:00,0,0,0,0,0
2016-07-03 05:20:00,1,0,0,1,6
2016-07-03 05:30:00,16,7,4,27,162
2016-07-03 05:40:00,20,26,14,60,360
2016-07-03 05:50:00,41,53,47,141,846
2016-07-03 06:00:00,18,35,25,78,468
2016-07-03 06:10:00,13,34,19,66,396
2016-07-03 06:20:00,19,34,24,77,462
2016-07-03 06:30:00,23,54,26,103,618
2016-07-03 06:40:00,34,73,53,160,960
2016-07-03 06:50:00,113,139,127,379,2274
2016-07-03 07:00:00,66,89,83,238,1428
2016-07-03 07:10:00,53,62,69,184,1104
2016-07-03 07:20:00,54,119,125,298,1788
2016-07-03 07:30:00,78,112,102,292,1752
2016-07-03 07:40:00,167,189,186,542,3252
2016-07-03 07:50:00,225,250,249,724,4344
2016-07-03 08:00:00,259,283,279,821,4926
2016-07-03 08:10:00,338,360,358,1056,6336
2016-07-03 08:20:00,388,413,409,1210,7260
2016-07-03 08:30:00,292,317,316,925,5550
2016-07-03 08:40:00,285,308,303,896,5376
2016-07-03 08:50:00,275,299,297,871,5226
2016-07-03 09:00:00,445,470,463,1378,8268
2016-07-03 09:10:00,688,711,712,2111,12666
2016-07-03 09:20:00,619,639,640,1898,11388
2016-07-03 09:30:00,240,261,257,758,4548
2016-07-03 09:40:00,112,132,128,372,2232
2016-07-03 09:50:00,187,206,201,594,3564
2016-07-03 10:00:00,85,110,90,285,1710
2016-07-03 10:10:00,562,557,567,1686,10116
2016-07-03 10:20:00,636,651,658,1945,11670
2016-07-03 10:30:00,889,911,903,2703,16218
2016-07-03 10:40:00,735,757,749,2241,13446
2016-07-03 10:50:00,658,680,671,2009,12054
2016-07-03 11:00:00,913,929,927,2769,16614
2016-07-03 11:10:00,67,86,76,229,1374
2016-07-03 11:20:00,140,145,145,430,2580
2016-07-03 11:30:00,1026,1057,1036,3119,18714
2016-07-03 11:40:00,625,651,637,1913,11478
2016-07-03 11:50:00,144,171,168,483,2898
2016-07-03 12:00:00,32,74,38,144,864
2016-07-03 12:10:00,53,83,45,181,1086
2016-07-03 12:20:00,344,361,353,1058,6348
2016-07-03 12:30:00,185,204,202,591,3546
2016-07-03 12:40:00,228,249,249,726,4356
2016-07-03 12:50:00,491,512,509,1512,9072
2016-07-03 13:00:00,276,299,295,870,5220
2016-07-03 13:10:00,225,246,243,714,4284
2016-07-03 13:20:00,262,283,280,825,4950
2016-07-03 13:30:00,210,231,228,669,4014
2016-07-03 13:40:00,330,354,351,1035,6210
2016-07-03 13:50:00,370,390,388,1148,6888
2016-07-03 14:00:00,88,98,101,287,1722
2016-07-03 14:10:00,124,143,140,407,2442
2016-07-03 14:20:00,282,300,294,876,5256
2016-07-03 14:30:00,647,668,654,1969,11814
2016-07-03 14:40:00,419,443,435,1297,7782
2016-07-03 14:50:00,84,106,102,292,1752
2016-07-03 15:00:00,160,182,179,521,3126
2016-07-03 15:10:00,209,228,306,743,4458
2016-07-03 15:20:00,877,894,895,2666,15996
2016-07-03 15:30:00,901,915,914,2730,16380
2016-07-03 15:40:00,968,985,978,2931,17586
2016-07-03 15:50:00,769,790,783,2342,14052
2016-07-03 16:00:00,129,151,147,427,2562
2016-07-03 16:10:00,91,142,133,366,2196
2016-07-03 16:20:00,620,632,626,1878,11268
2016-07-03 16:30:00,638,661,654,1953,11718
2016-07-03 16:40:00,501,523,518,1542,9252
2016-07-03 16:50:00,213,235,231,679,4074
2016-07-03 17:00:00,295,321,314,930,5580
2016-07-03 17:10:00,119,140,140,399,2394
2016-07-03 17:20:00,139,189,115,443,2658
2016-07-03 17:30:00,534,567,560,1661,9966
2016-07-03 17:40:00,439,466,462,1367,8202
2016-07-03 17:50:00,132,157,156,445,2670
2016-07-03 18:00:00,59,75,44,178,1068
2016-07-03 18:10:00,193,176,152,521,3126
2016-07-03 18:20:00,202,223,220,645,3870
2016-07-03 18:30:00,212,233,231,676,4056
2016-07-03 18:40:00,66,74,76,216,1296
2016-07-03 18:50:00,30,38,34,102,612
2016-07-03 19:00:00,89,51,102,242,1452
2016-07-03 19:10:00,107,123,118,348,2088
2016-07-03 19:20:00,135,148,88,371,2226
2016-07-03 19:30:00,115,126,71,312,1872
2016-07-03 19:40:00,21,42,26,89,534
2016-07-03 19:50:00,31,43,34,108,648
2016-07-03 20:00:00,66,53,66,185,1110
2016-07-03 20:10:00,69,52,74,195,1170
2016-07-03 20:20:00,54,53,46,153,918
2016-07-03 20:30:00,50,49,43,142,852
2016-07-03 20:40:00,21,43,28,92,552
2016-07-03 20:50:00,18,19,23,60,360
2016-07-03 21:00:00,15,20,22,57,342
2016-07-03 21:10:00,10,14,12,36,216
2016-07-03 21:20:00,5,8,7,20,120
2016-07-03 21:30:00,1,2,1,4,24
2016-07-03 21:40:00,0,0,0,0,0
2016-07-03 21:50:00,0,0,0,0,0
2016-07-03 22:00:00,0,0,0,0,0
2016-07-03 22:10:00,0,0,0,0,0
2016-07-03 22:20:00,0,0,0,0,0
2016-07-04 04:00:00,0,0,0,0,0
2016-07-04 04:10:00,0,0,0,0,0
2016-07-04 04:20:00,0,0,0,0,0
2016-07-04 04:30:00,0,0,0,0,0
2016-07-04 04:40:00,0,0,0,0,0
2016-07-04 04:50:00,0,0,0,0,0
2016-07-04 05:00:00,2,2,1,5,30
2016-07-04 05:10:00,4,7,4,15,90
2016-07-04 05:20:00,8,11,9,28,168
2016-07-04 05:30:00,24,32,27,83,498
2016-07-04 05:40:00,25,43,37,105,630
2016-07-04 05:50:00,28,43,31,102,612
2016-07-04 06:00:00,55,51,64,170,1020
2016-07-04 06:10:00,37,60,42,139,834
2016-07-04 06:20:00,21,36,26,83,498
2016-07-04 06:30:00,30,20,41,91,546
2016-07-04 06:40:00,30,32,37,99,594
2016-07-04 06:50:00,41,42,40,123,738
2016-07-04 07:00:00,41,66,57,164,984
2016-07-04 07:10:00,63,102,91,256,1536
2016-07-04 07:20:00,152,152,155,459,2754
2016-07-04 07:30:00,85,108,74,267,1602
2016-07-04 07:40:00,119,161,282,562,3372
2016-07-04 07:50:00,228,250,248,726,4356
2016-07-04 08:00:00,272,298,294,864,5184
2016-07-04 08:10:00,329,356,351,1036,6216
2016-07-04 08:20:00,379,402,396,1177,7062
2016-07-04 08:30:00,429,458,452,1339,8034
2016-07-04 08:40:00,487,512,508,1507,9042
2016-07-04 08:50:00,541,572,558,1671,10026
2016-07-04 09:00:00,598,625,609,1832,10992
2016-07-04 09:10:00,645,675,660,1980,11880
2016-07-04 09:20:00,704,739,733,2176,13056
2016-07-04 09:30:00,723,754,750,2227,13362
2016-07-04 09:40:00,779,817,807,2403,14418
2016-07-04 09:50:00,830,865,853,2548,15288
2016-07-04 10:00:00,779,813,803,2395,14370
2016-07-04 10:10:00,890,930,916,2736,16416
2016-07-04 10:20:00,698,733,719,2150,12900
2016-07-04 10:30:00,913,949,937,2799,16794
2016-07-04 10:40:00,958,997,985,2940,17640
2016-07-04 10:50:00,1032,1059,1038,3129,18774
2016-07-04 11:00:00,763,786,780,2329,13974
2016-07-04 11:10:00,993,1012,1015,3020,18120
2016-07-04 11:20:00,1045,1062,1061,3168,19008
2016-07-04 11:30:00,533,556,550,1639,9834
2016-07-04 11:40:00,301,326,319,946,5676
2016-07-04 11:50:00,448,471,467,1386,8316
2016-07-04 12:00:00,577,599,599,1775,10650
2016-07-04 12:10:00,711,735,731,2177,13062
2016-07-04 12:20:00,414,438,434,1286,7716
2016-07-04 12:30:00,805,829,827,2461,14766
2016-07-04 12:40:00,1053,1077,1073,3203,19218
2016-07-04 12:50:00,1097,1128,1124,3349,20094
2016-07-04 13:00:00,1035,1060,1052,3147,18882
2016-07-04 13:10:00,1059,1084,1072,3215,19290
2016-07-04 13:20:00,1082,1109,1100,3291,19746
2016-07-04 13:30:00,924,949,941,2814,16884
2016-07-04 13:40:00,989,1017,1012,3018,18108
2016-07-04 13:50:00,1054,1087,1078,3219,19314
2016-07-04 14:00:00,1038,1068,1068,3174,19044
2016-07-04 14:10:00,932,966,965,2863,17178
2016-07-04 14:20:00,848,884,878,2610,15660
2016-07-04 14:30:00,675,713,705,2093,12558
2016-07-04 14:40:00,834,865,861,2560,15360
2016-07-04 14:50:00,1030,1062,1058,3150,18900
2016-07-04 15:00:00,987,1021,1017,3025,18150
2016-07-04 15:10:00,673,701,697,2071,12426
2016-07-04 15:20:00,827,863,854,2544,15264
2016-07-04 15:30:00,852,890,877,2619,15714
2016-07-04 15:40:00,808,835,826,2469,14814
2016-07-04 15:50:00,509,536,530,1575,9450
2016-07-04 16:00:00,581,607,603,1791,10746
2016-07-04 16:10:00,817,846,842,2505,15030
2016-07-04 16:20:00,716,746,745,2207,13242
2016-07-04 16:30:00,702,737,729,2168,13008
2016-07-04 16:40:00,670,707,700,2077,12462
2016-07-04 16:50:00,621,649,651,1921,11526
2016-07-04 17:00:00,590,608,609,1807,10842
2016-07-04 17:10:00,545,575,564,1684,10104
2016-07-04 17:20:00,504,538,525,1567,9402
2016-07-04 17:30:00,404,430,420,1254,7524
2016-07-04 17:40:00,297,341,321,959,5754
2016-07-04 17:50:00,317,342,337,996,5976
2016-07-04 18:00:00,160,184,180,524,3144
2016-07-04 18:10:00,199,193,210,602,3612
2016-07-04 18:20:00,214,232,229,675,4050
2016-07-04 18:30:00,193,213,209,615,3690
2016-07-04 18:40:00,150,172,168,490,2940
2016-07-04 18:50:00,115,124,150,389,2334
2016-07-04 19:00:00,85,69,103,257,1542
2016-07-04 19:10:00,73,66,83,222,1332
2016-07-04 19:20:00,85,93,100,278,1668
2016-07-04 19:30:00,37,72,65,174,1044
2016-07-04 19:40:00,49,67,75,191,1146
2016-07-04 19:50:00,110,23,115,248,1488
2016-07-04 20:00:00,51,62,73,186,1116
2016-07-04 20:10:00,34,65,47,146,876
2016-07-04 20:20:00,10,33,22,65,390
2016-07-04 20:30:00,12,26,17,55,330
2016-07-04 20:40:00,11,30,11,52,312
2016-07-04 20:50:00,7,18,9,34,204
2016-07-04 21:00:00,3,13,6,22,132
2016-07-04 21:10:00,2,7,3,12,72
2016-07-04 21:20:00,1,2,1,4,24
2016-07-04 21:30:00,0,0,0,0,0
2016-07-04 21:40:00,0,0,0,0,0
2016-07-04 21:50:00,0,0,0,0,0
2016-07-04 22:00:00,0,0,0,0,0
2016-07-04 22:10:00,0,0,0,0,0
2016-07-05 04:00:00,0,0,0,0,0
2016-07-05 04:10:00,0,0,0,0,0
2016-07-05 04:20:00,0,0,0,0,0
2016-07-05 04:30:00,0,0,0,0,0
2016-07-05 04:40:00,0,0,0,0,0
2016-07-05 04:50:00,0,0,0,0,0
2016-07-05 05:00:00,1,8,7,16,96
2016-07-05 05:10:00,3,19,6,28,168
2016-07-05 05:20:00,2,6,13,21,126
2016-07-05 05:30:00,2,7,17,26,156
2016-07-05 05:40:00,8,23,15,46,276
2016-07-05 05:50:00,29,55,37,121,726
2016-07-05 06:00:00,37,64,56,157,942
2016-07-05 06:10:00,56,81,79,216,1296
2016-07-05 06:20:00,33,61,66,160,960
2016-07-05 06:30:00,54,60,67,181,1086
2016-07-05 06:40:00,91,50,96,237,1422
2016-07-05 06:50:00,114,213,81,408,2448
2016-07-05 07:00:00,102,179,64,345,2070
2016-07-05 07:10:00,65,155,153,373,2238
2016-07-05 07:20:00,117,212,92,421,2526
2016-07-05 07:30:00,248,156,137,541,3246
2016-07-05 07:40:00,157,154,148,459,2754
2016-07-05 07:50:00,228,251,247,726,4356
2016-07-05 08:00:00,183,204,200,587,3522
2016-07-05 08:10:00,283,305,301,889,5334
2016-07-05 08:20:00,186,208,212,606,3636
2016-07-05 08:30:00,180,226,164,570,3420
2016-07-05 08:40:00,425,447,439,1311,7866
2016-07-05 08:50:00,398,421,410,1229,7374
2016-07-05 09:00:00,369,391,380,1140,6840
2016-07-05 09:10:00,224,244,239,707,4242
2016-07-05 09:20:00,241,262,257,760,4560
2016-07-05 09:30:00,128,149,147,424,2544
2016-07-05 09:40:00,117,123,110,350,2100
2016-07-05 09:50:00,102,191,74,367,2202
2016-07-05 10:00:00,117,276,132,525,3150
2016-07-05 10:10:00,234,272,236,742,4452
2016-07-05 10:20:00,152,195,239,586,3516
2016-07-05 10:30:00,90,121,114,325,1950
2016-07-05 10:40:00,106,136,131,373,2238
2016-07-05 10:50:00,153,183,211,547,3282
2016-07-05 11:00:00,84,188,153,425,2550
2016-07-05 11:10:00,57,145,204,406,2436
2016-07-05 11:20:00,72,90,93,255,1530
2016-07-05 11:30:00,62,81,70,213,1278
2016-07-05 11:40:00,109,101,105,315,1890
2016-07-05 11:50:00,204,209,189,602,3612
2016-07-05 12:00:00,209,229,219,657,3942
2016-07-05 12:10:00,37,78,55,170,1020
2016-07-05 12:20:00,56,130,117,303,1818
2016-07-05 12:30:00,34,135,127,296,1776
2016-07-05 12:40:00,181,143,198,522,3132
2016-07-05 12:50:00,101,151,235,487,2922
2016-07-05 13:00:00,79,133,157,369,2214
2016-07-05 13:10:00,169,134,180,483,2898
2016-07-05 13:20:00,129,156,131,416,2496
2016-07-05 13:30:00,83,189,111,383,2298
2016-07-05 13:40:00,105,217,181,503,3018
2016-07-05 13:50:00,226,247,213,686,4116
2016-07-05 14:00:00,143,165,160,468,2808
2016-07-05 14:10:00,37,95,59,191,1146
2016-07-05 14:20:00,54,113,91,258,1548
2016-07-05 14:30:00,35,71,54,160,960
2016-07-05 14:40:00,23,44,20,87,522
2016-07-05 14:50:00,119,191,142,452,2712
2016-07-05 15:00:00,37,96,72,205,1230
2016-07-05 15:10:00,37,110,95,242,1452
2016-07-05 15:20:00,38,153,119,310,1860
2016-07-05 15:30:00,281,272,248,801,4806
2016-07-05 15:40:00,288,307,301,896,5376
2016-07-05 15:50:00,284,303,297,884,5304
2016-07-05 16:00:00,180,204,195,579,3474
2016-07-05 16:10:00,179,229,166,574,3444
2016-07-05 16:20:00,244,244,246,734,4404
2016-07-05 16:30:00,320,342,338,1000,6000
2016-07-05 16:40:00,252,274,267,793,4758
2016-07-05 16:50:00,258,283,276,817,4902
2016-07-05 17:00:00,312,337,328,977,5862
2016-07-05 17:10:00,235,257,251,743,4458
2016-07-05 17:20:00,118,176,152,446,2676
2016-07-05 17:30:00,68,116,133,317,1902
2016-07-05 17:40:00,79,71,97,247,1482
2016-07-05 17:50:00,68,63,78,209,1254
2016-07-05 18:00:00,94,98,103,295,1770
2016-07-05 18:10:00,35,36,42,113,678
2016-07-05 18:20:00,17,23,25,65,390
2016-07-05 18:30:00,15,49,29,93,558
2016-07-05 18:40:00,50,62,64,176,1056
2016-07-05 18:50:00,79,121,94,294,1764
2016-07-05 19:00:00,24,98,88,210,1260
2016-07-05 19:10:00,46,119,110,275,1650
2016-07-05 19:20:00,141,157,142,440,2640
2016-07-05 19:30:00,167,123,151,441,2646
2016-07-05 19:40:00,34,58,40,132,792
2016-07-05 19:50:00,48,61,49,158,948
2016-07-05 20:00:00,27,47,38,112,672
2016-07-05 20:10:00,11,11,17,39,234
2016-07-05 20:20:00,19,19,28,66,396
2016-07-05 20:30:00,10,12,14,36,216
2016-07-05 20:40:00,16,17,14,47,282
2016-07-05 20:50:00,1,7,2,10,60
2016-07-05 21:00:00,0,0,0,0,0
2016-07-05 21:20:00,0,0,0,0,0
2016-07-05 21:30:00,0,0,0,0,0
2016-07-05 21:40:00,0,0,0,0,0
2016-07-06 04:20:00,0,0,0,0,0
2016-07-06 04:30:00,0,0,0,0,0
2016-07-06 04:40:00,0,0,0,0,0
2016-07-06 04:50:00,0,0,0,0,0
2016-07-06 05:00:00,0,0,0,0,0
2016-07-06 05:10:00,0,0,0,0,0
2016-07-06 05:20:00,0,0,0,0,0
2016-07-06 05:30:00,0,0,0,0,0
2016-07-06 05:40:00,1,1,2,4,24
2016-07-06 05:50:00,11,9,12,32,192
2016-07-06 06:00:00,11,12,12,35,210
2016-07-06 06:10:00,7,9,8,24,144
2016-07-06 06:20:00,18,15,21,54,324
2016-07-06 06:30:00,32,32,33,97,582
2016-07-06 06:40:00,97,79,78,254,1524
2016-07-06 06:50:00,62,55,72,189,1134
2016-07-06 07:00:00,134,127,44,305,1830
2016-07-06 07:10:00,105,146,112,363,2178
2016-07-06 07:20:00,105,124,77,306,1836
2016-07-06 07:30:00,91,106,95,292,1752
2016-07-06 07:40:00,76,86,88,250,1500
2016-07-06 07:50:00,72,108,94,274,1644
2016-07-06 08:00:00,151,138,115,404,2424
2016-07-06 08:10:00,174,190,189,553,3318
2016-07-06 08:20:00,218,238,236,692,4152
2016-07-06 08:30:00,214,237,233,684,4104
2016-07-06 08:40:00,340,362,358,1060,6360
2016-07-06 08:50:00,349,373,370,1092,6552
2016-07-06 09:00:00,323,344,342,1009,6054
2016-07-06 09:10:00,434,455,455,1344,8064
2016-07-06 09:20:00,649,667,665,1981,11886
2016-07-06 09:30:00,694,716,716,2126,12756
2016-07-06 09:40:00,764,785,780,2329,13974
2016-07-06 09:50:00,797,818,818,2433,14598
2016-07-06 10:00:00,722,750,747,2219,13314
2016-07-06 10:10:00,756,775,773,2304,13824
2016-07-06 10:20:00,754,776,772,2302,13812
2016-07-06 10:30:00,953,972,964,2889,17334
2016-07-06 10:40:00,1015,1042,1037,3094,18564
2016-07-06 10:50:00,899,931,926,2756,16536
2016-07-06 11:00:00,1002,1026,1019,3047,18282
2016-07-06 11:10:00,1031,1055,1048,3134,18804
2016-07-06 11:20:00,920,945,937,2802,16812
2016-07-06 11:30:00,879,901,893,2673,16038
2016-07-06 11:40:00,806,823,809,2438,14628
2016-07-06 11:50:00,902,929,922,2753,16518
2016-07-06 12:00:00,1057,1081,1074,3212,19272
2016-07-06 12:10:00,750,770,763,2283,13698
2016-07-06 12:20:00,1067,1089,1077,3233,19398
2016-07-06 12:30:00,1089,1107,1105,3301,19806
2016-07-06 12:40:00,1031,1051,1048,3130,18780
2016-07-06 12:50:00,1104,1126,1112,3342,20052
2016-07-06 13:00:00,1110,1137,1124,3371,20226
2016-07-06 13:10:00,1089,1119,1117,3325,19950
2016-07-06 13:20:00,1072,1090,1090,3252,19512
2016-07-06 13:30:00,1093,1125,1118,3336,20016
2016-07-06 13:40:00,908,935,929,2772,16632
2016-07-06 13:50:00,974,1007,1002,2983,17898
2016-07-06 14:00:00,902,927,924,2753,16518
2016-07-06 14:10:00,911,937,929,2777,16662
2016-07-06 14:20:00,1052,1086,1081,3219,19314
2016-07-06 14:30:00,1035,1062,1057,3154,18924
2016-07-06 14:40:00,1006,1041,1035,3082,18492
2016-07-06 14:50:00,995,1031,1021,3047,18282
2016-07-06 15:00:00,983,1021,1013,3017,18102
2016-07-06 15:10:00,966,997,994,2957,17742
2016-07-06 15:20:00,878,904,902,2684,16104
2016-07-06 15:30:00,919,946,950,2815,16890
2016-07-06 15:40:00,884,933,932,2749,16494
2016-07-06 15:50:00,886,923,917,2726,16356
2016-07-06 16:00:00,805,843,839,2487,14922
2016-07-06 16:10:00,647,673,675,1995,11970
2016-07-06 16:20:00,798,828,831,2457,14742
2016-07-06 16:30:00,668,695,699,2062,12372
2016-07-06 16:40:00,713,739,743,2195,13170
2016-07-06 16:50:00,634,661,664,1959,11754
2016-07-06 17:00:00,613,640,639,1892,11352
2016-07-06 17:10:00,496,528,526,1550,9300
2016-07-06 17:20:00,300,331,324,955,5730
2016-07-06 17:30:00,492,528,518,1538,9228
2016-07-06 17:40:00,339,369,361,1069,6414
2016-07-06 17:50:00,327,352,350,1029,6174
2016-07-06 18:00:00,350,374,372,1096,6576
2016-07-06 18:10:00,234,258,255,747,4482
2016-07-06 18:20:00,183,209,209,601,3606
2016-07-06 18:30:00,125,151,148,424,2544
2016-07-06 18:40:00,105,84,124,313,1878
2016-07-06 18:50:00,108,116,143,367,2202
2016-07-06 19:00:00,73,78,84,235,1410
2016-07-06 19:10:00,89,70,101,260,1560
2016-07-06 19:20:00,80,72,79,231,1386
2016-07-06 19:30:00,72,54,78,204,1224
2016-07-06 19:40:00,76,62,82,220,1320
2016-07-06 19:50:00,62,54,66,182,1092
2016-07-06 20:00:00,67,47,71,185,1110
2016-07-06 20:10:00,60,43,70,173,1038
2016-07-06 20:20:00,41,75,36,152,912
2016-07-06 20:30:00,33,54,34,121,726
2016-07-06 20:40:00,36,59,30,125,750
2016-07-06 20:50:00,21,31,28,80,480
2016-07-06 21:00:00,18,21,20,59,354
2016-07-06 21:10:00,10,11,14,35,210
2016-07-06 21:20:00,5,7,7,19,114
2016-07-06 21:30:00,2,3,2,7,42
2016-07-06 21:40:00,0,0,0,0,0
2016-07-06 21:50:00,0,0,0,0,0
2016-07-06 22:00:00,0,0,0,0,0
2016-07-06 22:10:00,0,0,0,0,0
2016-07-06 22:20:00,0,0,0,0,0
2016-07-07 04:00:00,0,0,0,0,0
2016-07-07 04:10:00,0,0,0,0,0
2016-07-07 04:20:00,0,0,0,0,0
2016-07-07 04:30:00,0,0,0,0,0
2016-07-07 04:40:00,0,0,0,0,0
2016-07-07 04:50:00,1,0,1,2,12
2016-07-07 05:00:00,3,5,3,11,66
2016-07-07 05:10:00,7,5,9,21,126
2016-07-07 05:20:00,11,10,10,31,186
2016-07-07 05:30:00,14,14,15,43,258
2016-07-07 05:40:00,18,18,23,59,354
2016-07-07 05:50:00,20,17,27,64,384
2016-07-07 06:00:00,21,16,31,68,408
2016-07-07 06:10:00,23,24,32,79,474
2016-07-07 06:20:00,26,26,34,86,516
2016-07-07 06:30:00,22,43,32,97,582
2016-07-07 06:40:00,34,41,31,106,636
2016-07-07 06:50:00,27,59,29,115,690
2016-07-07 07:00:00,28,68,28,124,744
2016-07-07 07:10:00,64,59,67,190,1140
2016-07-07 07:20:00,119,120,78,317,1902
2016-07-07 07:30:00,160,119,152,431,2586
2016-07-07 07:40:00,247,170,141,558,3348
2016-07-07 07:50:00,271,201,223,695,4170
2016-07-07 08:00:00,272,293,289,854,5124
2016-07-07 08:10:00,328,348,343,1019,6114
2016-07-07 08:20:00,376,394,393,1163,6978
2016-07-07 08:30:00,425,443,440,1308,7848
2016-07-07 08:40:00,468,487,482,1437,8622
2016-07-07 08:50:00,531,556,553,1640,9840
2016-07-07 09:00:00,589,619,613,1821,10926
2016-07-07 09:10:00,641,669,660,1970,11820
2016-07-07 09:20:00,687,707,703,2097,12582
2016-07-07 09:30:00,731,749,749,2229,13374
2016-07-07 09:40:00,776,795,795,2366,14196
2016-07-07 09:50:00,810,827,827,2464,14784
2016-07-07 10:00:00,610,630,628,1868,11208
2016-07-07 10:10:00,881,896,890,2667,16002
2016-07-07 10:20:00,896,916,905,2717,16302
2016-07-07 10:30:00,914,939,930,2783,16698
2016-07-07 10:40:00,937,965,961,2863,17178
2016-07-07 10:50:00,846,865,866,2577,15462
2016-07-07 11:00:00,619,644,641,1904,11424
2016-07-07 11:10:00,932,958,951,2841,17046
2016-07-07 11:20:00,1021,1049,1036,3106,18636
2016-07-07 11:30:00,1024,1058,1048,3130,18780
2016-07-07 11:40:00,1029,1061,1046,3136,18816
2016-07-07 11:50:00,728,761,749,2238,13428
2016-07-07 12:00:00,408,435,426,1269,7614
2016-07-07 12:10:00,529,555,546,1630,9780
2016-07-07 12:20:00,342,365,358,1065,6390
2016-07-07 12:30:00,437,467,458,1362,8172
2016-07-07 12:40:00,725,761,752,2238,13428
2016-07-07 12:50:00,969,1000,989,2958,17748
2016-07-07 13:00:00,1027,1057,1043,3127,18762
2016-07-07 13:10:00,1045,1062,1055,3162,18972
2016-07-07 13:20:00,522,540,534,1596,9576
2016-07-07 13:30:00,744,756,753,2253,13518
2016-07-07 13:40:00,840,853,856,2549,15294
2016-07-07 13:50:00,413,431,433,1277,7662
2016-07-07 14:00:00,435,452,458,1345,8070
2016-07-07 14:10:00,672,692,693,2057,12342
2016-07-07 14:20:00,774,795,797,2366,14196
2016-07-07 14:30:00,833,854,853,2540,15240
2016-07-07 14:40:00,676,691,697,2064,12384
2016-07-07 14:50:00,360,381,380,1121,6726
2016-07-07 15:00:00,238,264,259,761,4566
2016-07-07 15:10:00,199,223,218,640,3840
2016-07-07 15:20:00,302,325,320,947,5682
2016-07-07 15:30:00,197,221,218,636,3816
2016-07-07 15:40:00,233,262,276,771,4626
2016-07-07 15:50:00,317,339,335,991,5946
2016-07-07 16:00:00,274,294,291,859,5154
2016-07-07 16:10:00,234,205,222,661,3966
2016-07-07 16:20:00,372,405,398,1175,7050
2016-07-07 16:30:00,114,131,128,373,2238
2016-07-07 16:40:00,128,147,152,427,2562
2016-07-07 16:50:00,201,225,222,648,3888
2016-07-07 17:00:00,78,87,97,262,1572
2016-07-07 17:10:00,173,314,127,614,3684
2016-07-07 17:20:00,201,190,200,591,3546
2016-07-07 17:30:00,169,204,198,571,3426
2016-07-07 17:40:00,108,212,125,445,2670
2016-07-07 17:50:00,123,222,106,451,2706
2016-07-07 18:00:00,241,316,234,791,4746
2016-07-07 18:10:00,160,200,222,582,3492
2016-07-07 18:20:00,138,238,129,505,3030
2016-07-07 18:30:00,191,114,187,492,2952
2016-07-07 18:40:00,153,65,174,392,2352
2016-07-07 18:50:00,113,112,135,360,2160
2016-07-07 19:00:00,140,117,197,454,2724
2016-07-07 19:10:00,123,114,132,369,2214
2016-07-07 19:20:00,114,55,121,290,1740
2016-07-07 19:30:00,78,74,87,239,1434
2016-07-07 19:40:00,84,102,95,281,1686
2016-07-07 19:50:00,59,37,66,162,972
2016-07-07 20:00:00,23,44,31,98,588
2016-07-07 20:10:00,25,33,33,91,546
2016-07-07 20:20:00,18,25,25,68,408
2016-07-07 20:30:00,22,25,32,79,474
2016-07-07 20:40:00,10,11,12,33,198
2016-07-07 20:50:00,9,13,10,32,192
2016-07-07 21:00:00,3,5,3,11,66
2016-07-07 21:10:00,4,3,4,11,66
2016-07-07 21:20:00,0,0,0,0,0
2016-07-07 21:30:00,0,0,0,0,0
2016-07-07 21:40:00,0,0,0,0,0
2016-07-07 21:50:00,0,0,0,0,0
2016-07-07 22:00:00,0,0,0,0,0
2016-07-07 22:10:00,0,0,0,0,0
2016-07-08 04:10:00,0,0,0,0,0
2016-07-08 04:20:00,0,0,0,0,0
2016-07-08 04:30:00,0,0,0,0,0
2016-07-08 04:40:00,0,0,0,0,0
2016-07-08 04:50:00,0,0,0,0,0
2016-07-08 05:00:00,2,3,2,7,42
2016-07-08 05:10:00,3,4,3,10,60
2016-07-08 05:20:00,6,9,6,21,126
2016-07-08 05:30:00,6,11,10,27,162
2016-07-08 05:40:00,17,36,23,76,456
2016-07-08 05:50:00,15,23,17,55,330
2016-07-08 06:00:00,5,8,6,19,114
2016-07-08 06:10:00,23,47,25,95,570
2016-07-08 06:20:00,23,72,29,124,744
2016-07-08 06:30:00,36,66,57,159,954
2016-07-08 06:40:00,55,68,60,183,1098
2016-07-08 06:50:00,56,75,67,198,1188
2016-07-08 07:00:00,90,123,113,326,1956
2016-07-08 07:10:00,86,147,178,411,2466
2016-07-08 07:20:00,77,146,147,370,2220
2016-07-08 07:30:00,64,155,148,367,2202
2016-07-08 07:40:00,39,86,90,215,1290
2016-07-08 07:50:00,64,55,82,201,1206
2016-07-08 08:00:00,65,142,157,364,2184
2016-07-08 08:10:00,170,241,146,557,3342
2016-07-08 08:20:00,198,221,224,643,3858
2016-07-08 08:30:00,243,268,262,773,4638
2016-07-08 08:40:00,439,464,457,1360,8160
2016-07-08 08:50:00,356,382,376,1114,6684
2016-07-08 09:00:00,337,370,363,1070,6420
2016-07-08 09:10:00,477,519,508,1504,9024
2016-07-08 09:20:00,511,528,521,1560,9360
2016-07-08 09:30:00,350,366,365,1081,6486
2016-07-08 09:40:00,646,662,668,1976,11856
2016-07-08 09:50:00,768,780,785,2333,13998
2016-07-08 10:00:00,794,809,813,2416,14496
2016-07-08 10:10:00,827,845,843,2515,15090
2016-07-08 10:20:00,835,855,854,2544,15264
2016-07-08 10:30:00,892,919,908,2719,16314
2016-07-08 10:40:00,758,779,777,2314,13884
2016-07-08 10:50:00,679,698,701,2078,12468
2016-07-08 11:00:00,931,953,949,2833,16998
2016-07-08 11:10:00,490,518,512,1520,9120
2016-07-08 11:20:00,744,778,770,2292,13752
2016-07-08 11:30:00,992,1026,1015,3033,18198
2016-07-08 11:40:00,1003,1035,1022,3060,18360
2016-07-08 11:50:00,984,1011,1004,2999,17994
2016-07-08 12:00:00,985,1015,1006,3006,18036
2016-07-08 12:10:00,1040,1076,1065,3181,19086
2016-07-08 12:20:00,996,1024,1013,3033,18198
2016-07-08 12:30:00,947,977,968,2892,17352
2016-07-08 12:40:00,810,844,836,2490,14940
2016-07-08 12:50:00,719,753,747,2219,13314
2016-07-08 13:00:00,670,702,693,2065,12390
2016-07-08 13:10:00,531,556,549,1636,9816
2016-07-08 13:20:00,892,909,914,2715,16290
2016-07-08 13:30:00,981,1006,1005,2992,17952
2016-07-08 13:40:00,1039,1068,1071,3178,19068
2016-07-08 13:50:00,1018,1050,1045,3113,18678
2016-07-08 14:00:00,924,956,948,2828,16968
2016-07-08 14:10:00,758,782,779,2319,13914
2016-07-08 14:20:00,648,669,664,1981,11886
2016-07-08 14:30:00,508,532,526,1566,9396
2016-07-08 14:40:00,269,292,288,849,5094
2016-07-08 14:50:00,175,198,195,568,3408
2016-07-08 15:00:00,99,122,119,340,2040
2016-07-08 15:10:00,67,79,86,232,1392
2016-07-08 15:20:00,80,82,91,253,1518
2016-07-08 15:30:00,122,169,173,464,2784
2016-07-08 15:40:00,100,101,110,311,1866
2016-07-08 15:50:00,64,116,146,326,1956
2016-07-08 16:00:00,160,190,109,459,2754
2016-07-08 16:10:00,150,203,23,376,2256
2016-07-08 16:20:00,132,155,101,388,2328
2016-07-08 16:30:00,133,122,135,390,2340
2016-07-08 16:40:00,89,114,99,302,1812
2016-07-08 16:50:00,55,95,81,231,1386
2016-07-08 17:00:00,63,89,74,226,1356
2016-07-08 17:10:00,43,77,40,160,960
2016-07-08 17:20:00,58,96,87,241,1446
2016-07-08 17:30:00,39,84,43,166,996
2016-07-08 17:40:00,17,92,81,190,1140
2016-07-08 17:50:00,47,78,54,179,1074
2016-07-08 18:00:00,29,50,22,101,606
2016-07-08 18:10:00,21,76,21,118,708
2016-07-08 18:20:00,56,58,39,153,918
2016-07-08 18:30:00,29,36,30,95,570
2016-07-08 18:40:00,30,37,32,99,594
2016-07-08 18:50:00,26,38,25,89,534
2016-07-08 19:00:00,20,49,21,90,540
2016-07-08 19:10:00,25,32,29,86,516
2016-07-08 19:20:00,19,24,24,67,402
2016-07-08 19:30:00,10,12,12,34,204
2016-07-08 19:40:00,6,8,7,21,126
2016-07-08 19:50:00,4,7,4,15,90
2016-07-08 20:00:00,7,18,5,30,180
2016-07-08 20:10:00,7,12,10,29,174
2016-07-08 20:20:00,2,3,2,7,42
2016-07-08 20:30:00,1,2,2,5,30
2016-07-08 20:40:00,0,0,0,0,0
2016-07-08 20:50:00,0,0,0,0,0
2016-07-08 21:00:00,0,0,0,0,0
2016-07-08 21:10:00,1,2,1,4,24
2016-07-08 21:20:00,0,0,0,0,0
2016-07-08 21:30:00,0,0,0,0,0
2016-07-08 21:40:00,0,0,0,0,0
2016-07-08 21:50:00,0,0,0,0,0
2016-07-09 04:00:00,0,0,0,0,0
2016-07-09 04:10:00,0,0,0,0,0
2016-07-09 04:20:00,0,0,0,0,0
2016-07-09 04:30:00,0,0,0,0,0
2016-07-09 04:40:00,0,0,0,0,0
2016-07-09 04:50:00,0,0,0,0,0
2016-07-09 05:00:00,0,0,0,0,0
2016-07-09 05:10:00,0,0,0,0,0
2016-07-09 05:20:00,0,0,0,0,0
2016-07-09 05:30:00,1,1,2,4,24
2016-07-09 05:40:00,3,3,2,8,48
2016-07-09 05:50:00,8,11,9,28,168
2016-07-09 06:00:00,13,21,17,51,306
2016-07-09 06:10:00,20,34,26,80,480
2016-07-09 06:20:00,31,70,51,152,912
2016-07-09 06:30:00,71,102,95,268,1608
2016-07-09 06:40:00,60,97,97,254,1524
2016-07-09 06:50:00,72,108,98,278,1668
2016-07-09 07:00:00,91,125,82,298,1788
2016-07-09 07:10:00,62,126,117,305,1830
2016-07-09 07:20:00,51,79,67,197,1182
2016-07-09 07:30:00,76,119,113,308,1848
2016-07-09 07:40:00,113,131,79,323,1938
2016-07-09 07:50:00,197,234,211,642,3852
2016-07-09 08:00:00,237,263,257,757,4542
2016-07-09 08:10:00,283,306,301,890,5340
2016-07-09 08:20:00,332,359,356,1047,6282
2016-07-09 08:30:00,269,289,289,847,5082
2016-07-09 08:40:00,340,364,362,1066,6396
2016-07-09 08:50:00,503,525,520,1548,9288
2016-07-09 09:00:00,359,382,376,1117,6702
2016-07-09 09:10:00,319,345,339,1003,6018
2016-07-09 09:20:00,552,581,578,1711,10266
2016-07-09 09:30:00,501,537,531,1569,9414
2016-07-09 09:40:00,436,466,462,1364,8184
2016-07-09 09:50:00,597,631,625,1853,11118
2016-07-09 10:00:00,586,621,613,1820,10920
2016-07-09 10:10:00,573,604,597,1774,10644
2016-07-09 10:20:00,413,439,435,1287,7722
2016-07-09 10:30:00,445,473,467,1385,8310
2016-07-09 10:40:00,382,409,401,1192,7152
2016-07-09 10:50:00,850,869,866,2585,15510
2016-07-09 11:00:00,909,936,929,2774,16644
2016-07-09 11:10:00,548,578,570,1696,10176
2016-07-09 11:20:00,293,316,313,922,5532
2016-07-09 11:30:00,743,766,760,2269,13614
2016-07-09 11:40:00,813,837,825,2475,14850
2016-07-09 11:50:00,902,929,921,2752,16512
2016-07-09 12:00:00,1065,1095,1082,3242,19452
2016-07-09 12:10:00,1067,1095,1079,3241,19446
2016-07-09 12:20:00,629,659,651,1939,11634
2016-07-09 12:30:00,631,657,648,1936,11616
2016-07-09 12:40:00,806,840,831,2477,14862
2016-07-09 12:50:00,1001,1034,1017,3052,18312
2016-07-09 13:00:00,1055,1096,1083,3234,19404
2016-07-09 13:10:00,1005,1059,1046,3110,18660
2016-07-09 13:20:00,1021,1061,1044,3126,18756
2016-07-09 13:30:00,981,1017,1005,3003,18018
2016-07-09 13:40:00,1039,1079,1068,3186,19116
2016-07-09 13:50:00,1040,1078,1064,3182,19092
2016-07-09 14:00:00,1054,1085,1066,3205,19230
2016-07-09 14:10:00,1011,1048,1040,3099,18594
2016-07-09 14:20:00,1027,1069,1055,3151,18906
2016-07-09 14:30:00,1014,1048,1029,3091,18546
2016-07-09 14:40:00,918,953,943,2814,16884
2016-07-09 14:50:00,842,866,866,2574,15444
2016-07-09 15:00:00,869,900,895,2664,15984
2016-07-09 15:10:00,700,727,728,2155,12930
2016-07-09 15:20:00,805,833,829,2467,14802
2016-07-09 15:30:00,574,597,599,1770,10620
2016-07-09 15:40:00,534,551,553,1638,9828
2016-07-09 15:50:00,578,602,602,1782,10692
2016-07-09 16:00:00,561,586,585,1732,10392
2016-07-09 16:10:00,503,530,527,1560,9360
2016-07-09 16:20:00,510,534,530,1574,9444
2016-07-09 16:30:00,442,464,465,1371,8226
2016-07-09 16:40:00,467,491,488,1446,8676
2016-07-09 16:50:00,402,425,422,1249,7494
2016-07-09 17:00:00,400,419,418,1237,7422
2016-07-09 17:10:00,389,411,409,1209,7254
2016-07-09 17:20:00,343,364,360,1067,6402
2016-07-09 17:30:00,270,295,288,853,5118
2016-07-09 17:40:00,243,267,263,773,4638
2016-07-09 17:50:00,260,286,283,829,4974
2016-07-09 18:00:00,219,242,239,700,4200
2016-07-09 18:10:00,179,202,198,579,3474
2016-07-09 18:20:00,183,205,202,590,3540
2016-07-09 18:30:00,143,166,163,472,2832
2016-07-09 18:40:00,130,114,200,444,2664
2016-07-09 18:50:00,88,155,183,426,2556
2016-07-09 19:00:00,102,128,152,382,2292
2016-07-09 19:10:00,130,70,143,343,2058
2016-07-09 19:20:00,87,49,99,235,1410
2016-07-09 19:30:00,64,31,89,184,1104
2016-07-09 19:40:00,62,32,72,166,996
2016-07-09 19:50:00,29,58,30,117,702
2016-07-09 20:00:00,13,76,24,113,678
2016-07-09 20:10:00,28,28,37,93,558
2016-07-09 20:20:00,30,20,39,89,534
2016-07-09 20:30:00,26,27,34,87,522
2016-07-09 20:40:00,20,21,25,66,396
2016-07-09 20:50:00,8,15,14,37,222
2016-07-09 21:00:00,10,17,15,42,252
2016-07-09 21:10:00,12,14,16,42,252
2016-07-09 21:20:00,5,8,6,19,114
2016-07-09 21:30:00,0,0,0,0,0
2016-07-09 21:40:00,0,0,0,0,0
2016-07-09 21:50:00,0,0,0,0,0
2016-07-09 22:00:00,0,0,0,0,0
2016-07-09 22:10:00,0,0,0,0,0
2016-07-10 04:30:00,0,0,0,0,0
2016-07-10 04:40:00,0,0,0,0,0
2016-07-10 04:50:00,0,0,0,0,0
2016-07-10 05:00:00,0,0,0,0,0
2016-07-10 05:10:00,0,0,0,0,0
2016-07-10 05:20:00,0,0,0,0,0
2016-07-10 05:30:00,0,0,0,0,0
2016-07-10 05:40:00,1,0,1,2,12
2016-07-10 05:50:00,0,1,1,2,12
2016-07-10 06:00:00,9,12,12,33,198
2016-07-10 06:10:00,15,18,23,56,336
2016-07-10 06:20:00,7,11,12,30,180
2016-07-10 06:30:00,9,16,14,39,234
2016-07-10 06:40:00,6,13,9,28,168
2016-07-10 06:50:00,8,16,5,29,174
2016-07-10 07:00:00,8,26,14,48,288
2016-07-10 07:10:00,13,20,21,54,324
2016-07-10 07:20:00,5,8,7,20,120
2016-07-10 07:30:00,12,13,17,42,252
2016-07-10 07:40:00,14,13,21,48,288
2016-07-10 07:50:00,33,47,42,122,732
2016-07-10 08:00:00,20,40,26,86,516
2016-07-10 08:10:00,11,26,21,58,348
2016-07-10 08:20:00,26,35,32,93,558
2016-07-10 08:30:00,29,24,39,92,552
2016-07-10 08:40:00,29,74,49,152,912
2016-07-10 08:50:00,103,93,116,312,1872
2016-07-10 09:00:00,61,120,114,295,1770
2016-07-10 09:10:00,30,107,106,243,1458
2016-07-10 09:20:00,58,108,98,264,1584
2016-07-10 09:30:00,82,77,85,244,1464
2016-07-10 09:40:00,62,150,154,366,2196
2016-07-10 09:50:00,152,206,130,488,2928
2016-07-10 10:00:00,97,139,121,357,2142
2016-07-10 10:10:00,79,185,193,457,2742
2016-07-10 10:20:00,119,165,211,495,2970
2016-07-10 10:30:00,96,135,164,395,2370
2016-07-10 10:40:00,187,271,187,645,3870
2016-07-10 10:50:00,162,242,117,521,3126
2016-07-10 11:00:00,65,126,167,358,2148
2016-07-10 11:10:00,106,56,125,287,1722
2016-07-10 11:20:00,245,284,282,811,4866
2016-07-10 11:30:00,564,588,585,1737,10422
2016-07-10 11:40:00,219,242,238,699,4194
2016-07-10 11:50:00,93,113,114,320,1920
2016-07-10 12:00:00,110,123,95,328,1968
2016-07-10 12:10:00,197,154,124,475,2850
2016-07-10 12:20:00,114,139,103,356,2136
2016-07-10 12:30:00,71,99,73,243,1458
2016-07-10 12:40:00,196,149,128,473,2838
2016-07-10 12:50:00,266,148,104,518,3108
2016-07-10 13:00:00,291,164,145,600,3600
2016-07-10 13:10:00,223,246,242,711,4266
2016-07-10 13:20:00,204,226,224,654,3924
2016-07-10 13:30:00,232,255,251,738,4428
2016-07-10 13:40:00,521,546,536,1603,9618
2016-07-10 13:50:00,518,540,531,1589,9534
2016-07-10 14:00:00,494,517,512,1523,9138
2016-07-10 14:10:00,478,500,497,1475,8850
2016-07-10 14:20:00,598,621,621,1840,11040
2016-07-10 14:30:00,570,595,591,1756,10536
2016-07-10 14:40:00,403,426,422,1251,7506
2016-07-10 14:50:00,256,278,274,808,4848
2016-07-10 15:00:00,309,334,330,973,5838
2016-07-10 15:10:00,204,228,223,655,3930
2016-07-10 15:20:00,207,230,161,598,3588
2016-07-10 15:30:00,239,260,255,754,4524
2016-07-10 15:40:00,267,292,285,844,5064
2016-07-10 15:50:00,272,291,290,853,5118
2016-07-10 16:00:00,268,290,285,843,5058
2016-07-10 16:10:00,341,372,365,1078,6468
2016-07-10 16:20:00,316,341,333,990,5940
2016-07-10 16:30:00,297,321,313,931,5586
2016-07-10 16:40:00,293,316,310,919,5514
2016-07-10 16:50:00,273,297,292,862,5172
2016-07-10 17:00:00,360,385,377,1122,6732
2016-07-10 17:10:00,374,396,384,1154,6924
2016-07-10 17:20:00,351,375,365,1091,6546
2016-07-10 17:30:00,136,160,152,448,2688
2016-07-10 17:40:00,180,149,159,488,2928
2016-07-10 17:50:00,242,174,116,532,3192
2016-07-10 18:00:00,170,230,121,521,3126
2016-07-10 18:10:00,168,199,178,545,3270
2016-07-10 18:20:00,159,244,100,503,3018
2016-07-10 18:30:00,112,253,66,431,2586
2016-07-10 18:40:00,61,96,114,271,1626
2016-07-10 18:50:00,110,23,126,259,1554
2016-07-10 19:00:00,46,65,70,181,1086
2016-07-10 19:10:00,35,57,51,143,858
2016-07-10 19:20:00,20,48,25,93,558
2016-07-10 19:30:00,18,39,11,68,408
2016-07-10 19:40:00,12,38,16,66,396
2016-07-10 19:50:00,9,18,9,36,216
2016-07-10 20:00:00,5,6,7,18,108
2016-07-10 20:10:00,0,0,0,0,0
2016-07-10 20:20:00,0,0,0,0,0
2016-07-10 20:30:00,1,2,4,7,42
2016-07-10 20:40:00,0,1,2,3,18
2016-07-10 20:50:00,0,0,1,1,6
2016-07-10 21:00:00,0,0,0,0,0
2016-07-10 21:10:00,0,0,0,0,0
2016-07-10 21:30:00,0,0,0,0,0
2016-07-10 21:40:00,0,0,0,0,0
2016-07-10 21:50:00,0,0,0,0,0
2016-07-10 22:00:00,0,0,0,0,0
2016-07-11 04:10:00,0,0,0,0,0
2016-07-11 04:20:00,0,0,0,0,0
2016-07-11 04:30:00,0,0,0,0,0
2016-07-11 04:40:00,0,0,0,0,0
2016-07-11 04:50:00,0,0,0,0,0
2016-07-11 05:00:00,1,1,1,3,18
2016-07-11 05:10:00,2,1,2,5,30
2016-07-11 05:20:00,0,0,0,0,0
2016-07-11 05:30:00,5,7,3,15,90
2016-07-11 05:40:00,13,16,10,39,234
2016-07-11 05:50:00,29,49,31,109,654
2016-07-11 06:00:00,53,43,63,159,954
2016-07-11 06:10:00,33,61,35,129,774
2016-07-11 06:20:00,56,40,65,161,966
2016-07-11 06:30:00,58,57,76,191,1146
2016-07-11 06:40:00,62,81,74,217,1302
2016-07-11 06:50:00,61,80,78,219,1314
2016-07-11 07:00:00,73,66,86,225,1350
2016-07-11 07:10:00,78,67,96,241,1446
2016-07-11 07:20:00,87,71,97,255,1530
2016-07-11 07:30:00,80,81,94,255,1530
2016-07-11 07:40:00,35,95,99,229,1374
2016-07-11 07:50:00,109,153,120,382,2292
2016-07-11 08:00:00,206,250,215,671,4026
2016-07-11 08:10:00,212,232,237,681,4086
2016-07-11 08:20:00,231,250,248,729,4374
2016-07-11 08:30:00,238,259,257,754,4524
2016-07-11 08:40:00,281,308,304,893,5358
2016-07-11 08:50:00,432,454,447,1333,7998
2016-07-11 09:00:00,543,570,566,1679,10074
2016-07-11 09:10:00,602,627,624,1853,11118
2016-07-11 09:20:00,652,675,669,1996,11976
2016-07-11 09:30:00,702,726,710,2138,12828
2016-07-11 09:40:00,723,766,760,2249,13494
2016-07-11 09:50:00,755,807,808,2370,14220
2016-07-11 10:00:00,794,837,835,2466,14796
2016-07-11 10:10:00,836,860,860,2556,15336
2016-07-11 10:20:00,860,886,884,2630,15780
2016-07-11 10:30:00,880,906,911,2697,16182
2016-07-11 10:40:00,904,924,928,2756,16536
2016-07-11 10:50:00,913,955,960,2828,16968
2016-07-11 11:00:00,932,982,990,2904,17424
2016-07-11 11:10:00,752,801,804,2357,14142
2016-07-11 11:20:00,527,548,553,1628,9768
2016-07-11 11:30:00,405,424,427,1256,7536
2016-07-11 11:40:00,337,355,358,1050,6300
2016-07-11 11:50:00,485,498,502,1485,8910
2016-07-11 12:00:00,271,288,290,849,5094
2016-07-11 12:10:00,205,162,181,548,3288
2016-07-11 12:20:00,269,292,290,851,5106
2016-07-11 12:30:00,205,231,226,662,3972
2016-07-11 12:40:00,406,428,429,1263,7578
2016-07-11 12:50:00,289,314,313,916,5496
2016-07-11 13:00:00,314,335,337,986,5916
2016-07-11 13:10:00,440,462,462,1364,8184
2016-07-11 13:20:00,355,378,377,1110,6660
2016-07-11 13:30:00,705,726,724,2155,12930
2016-07-11 13:40:00,960,952,971,2883,17298
2016-07-11 13:50:00,860,861,867,2588,15528
2016-07-11 14:00:00,1077,1083,1087,3247,19482
2016-07-11 14:10:00,1019,1029,1031,3079,18474
2016-07-11 14:20:00,1020,1028,1037,3085,18510
2016-07-11 14:30:00,1016,1040,1035,3091,18546
2016-07-11 14:40:00,989,1010,1011,3010,18060
2016-07-11 14:50:00,989,1012,1014,3015,18090
2016-07-11 15:00:00,1006,1018,1021,3045,18270
2016-07-11 15:10:00,603,626,624,1853,11118
2016-07-11 15:20:00,750,780,775,2305,13830
2016-07-11 15:30:00,859,877,879,2615,15690
2016-07-11 15:40:00,857,859,868,2584,15504
2016-07-11 15:50:00,820,841,845,2506,15036
2016-07-11 16:00:00,603,644,638,1885,11310
2016-07-11 16:10:00,351,378,374,1103,6618
2016-07-11 16:20:00,221,250,245,716,4296
2016-07-11 16:30:00,681,724,710,2115,12690
2016-07-11 16:40:00,443,478,470,1391,8346
2016-07-11 16:50:00,611,646,632,1889,11334
2016-07-11 17:00:00,352,383,375,1110,6660
2016-07-11 17:10:00,228,253,246,727,4362
2016-07-11 17:20:00,214,234,229,677,4062
2016-07-11 17:30:00,190,209,203,602,3612
2016-07-11 17:40:00,135,170,138,443,2658
2016-07-11 17:50:00,198,258,243,699,4194
2016-07-11 18:00:00,130,153,147,430,2580
2016-07-11 18:10:00,107,148,163,418,2508
2016-07-11 18:20:00,235,261,257,753,4518
2016-07-11 18:30:00,122,148,142,412,2472
2016-07-11 18:40:00,166,192,187,545,3270
2016-07-11 18:50:00,93,114,157,364,2184
2016-07-11 19:00:00,112,71,138,321,1926
2016-07-11 19:10:00,107,48,116,271,1626
2016-07-11 19:20:00,91,116,99,306,1836
2016-07-11 19:30:00,88,101,103,292,1752
2016-07-11 19:40:00,58,31,58,147,882
2016-07-11 19:50:00,44,35,46,125,750
2016-07-11 20:00:00,26,22,34,82,492
2016-07-11 20:10:00,53,44,48,145,870
2016-07-11 20:20:00,61,36,71,168,1008
2016-07-11 20:30:00,15,11,20,46,276
2016-07-11 20:40:00,11,9,14,34,204
2016-07-11 20:50:00,4,7,6,17,102
2016-07-11 21:00:00,1,1,1,3,18
2016-07-11 21:10:00,0,0,0,0,0
2016-07-11 21:20:00,0,0,0,0,0
2016-07-11 21:30:00,0,0,0,0,0
2016-07-11 21:40:00,0,0,0,0,0
2016-07-11 21:50:00,0,0,0,0,0
2016-07-11 22:00:00,0,0,0,0,0
2016-07-12 04:20:00,0,0,0,0,0
2016-07-12 04:30:00,0,0,0,0,0
2016-07-12 04:40:00,0,0,0,0,0
2016-07-12 04:50:00,0,0,0,0,0
2016-07-12 05:00:00,0,0,0,0,0
2016-07-12 05:10:00,5,3,5,13,78
2016-07-12 05:20:00,6,3,5,14,84
2016-07-12 05:30:00,10,14,12,36,216
2016-07-12 05:40:00,16,22,24,62,372
2016-07-12 05:50:00,15,18,20,53,318
2016-07-12 06:00:00,17,20,25,62,372
2016-07-12 06:10:00,46,42,52,140,840
2016-07-12 06:20:00,60,44,68,172,1032
2016-07-12 06:30:00,28,37,35,100,600
2016-07-12 06:40:00,20,32,23,75,450
2016-07-12 06:50:00,60,87,69,216,1296
2016-07-12 07:00:00,95,108,101,304,1824
2016-07-12 07:10:00,67,122,113,302,1812
2016-07-12 07:20:00,69,125,100,294,1764
2016-07-12 07:30:00,72,83,86,241,1446
2016-07-12 07:40:00,151,193,123,467,2802
2016-07-12 07:50:00,177,196,184,557,3342
2016-07-12 08:00:00,191,213,208,612,3672
2016-07-12 08:10:00,208,230,222,660,3960
2016-07-12 08:20:00,318,341,334,993,5958
2016-07-12 08:30:00,337,358,354,1049,6294
2016-07-12 08:40:00,455,476,469,1400,8400
2016-07-12 08:50:00,467,489,489,1445,8670
2016-07-12 09:00:00,575,597,590,1762,10572
2016-07-12 09:10:00,351,372,367,1090,6540
2016-07-12 09:20:00,269,291,288,848,5088
2016-07-12 09:30:00,269,291,288,848,5088
2016-07-12 09:40:00,191,210,214,615,3690
2016-07-12 09:50:00,329,348,347,1024,6144
2016-07-12 10:00:00,832,852,846,2530,15180
2016-07-12 10:10:00,847,866,861,2574,15444
2016-07-12 10:20:00,864,882,880,2626,15756
2016-07-12 10:30:00,907,924,929,2760,16560
2016-07-12 10:40:00,941,964,957,2862,17172
2016-07-12 10:50:00,960,980,979,2919,17514
2016-07-12 11:00:00,987,1004,1001,2992,17952
2016-07-12 11:10:00,1020,1035,1034,3089,18534
2016-07-12 11:20:00,1025,1046,1040,3111,18666
2016-07-12 11:30:00,954,980,970,2904,17424
2016-07-12 11:40:00,964,988,982,2934,17604
2016-07-12 11:50:00,1036,1060,1052,3148,18888
2016-07-12 12:00:00,1052,1074,1066,3192,19152
2016-07-12 12:10:00,1033,1050,1043,3126,18756
2016-07-12 12:20:00,910,928,918,2756,16536
2016-07-12 12:30:00,1051,1068,1067,3186,19116
2016-07-12 12:40:00,798,815,817,2430,14580
2016-07-12 12:50:00,1044,1059,1056,3159,18954
2016-07-12 13:00:00,642,663,661,1966,11796
2016-07-12 13:10:00,1043,1061,1060,3164,18984
2016-07-12 13:20:00,1112,1131,1129,3372,20232
2016-07-12 13:30:00,1127,1158,1148,3433,20598
2016-07-12 13:40:00,1058,1100,1085,3243,19458
2016-07-12 13:50:00,977,1005,995,2977,17862
2016-07-12 14:00:00,1061,1079,1069,3209,19254
2016-07-12 14:10:00,1060,1081,1072,3213,19278
2016-07-12 14:20:00,1047,1066,1056,3169,19014
2016-07-12 14:30:00,1030,1049,1042,3121,18726
2016-07-12 14:40:00,816,836,831,2483,14898
2016-07-12 14:50:00,986,1009,1001,2996,17976
2016-07-12 15:00:00,980,1003,994,2977,17862
2016-07-12 15:10:00,946,962,951,2859,17154
2016-07-12 15:20:00,943,961,956,2860,17160
2016-07-12 15:30:00,893,916,909,2718,16308
2016-07-12 15:40:00,844,873,868,2585,15510
2016-07-12 15:50:00,827,852,847,2526,15156
2016-07-12 16:00:00,792,821,815,2428,14568
2016-07-12 16:10:00,741,774,766,2281,13686
2016-07-12 16:20:00,683,720,701,2104,12624
2016-07-12 16:30:00,515,553,534,1602,9612
2016-07-12 16:40:00,323,352,341,1016,6096
2016-07-12 16:50:00,453,494,479,1426,8556
2016-07-12 17:00:00,276,305,299,880,5280
2016-07-12 17:10:00,284,311,302,897,5382
2016-07-12 17:20:00,343,368,360,1071,6426
2016-07-12 17:30:00,124,150,143,417,2502
2016-07-12 17:40:00,69,127,117,313,1878
2016-07-12 17:50:00,82,179,226,487,2922
2016-07-12 18:00:00,222,247,245,714,4284
2016-07-12 18:10:00,247,268,262,777,4662
2016-07-12 18:20:00,203,227,219,649,3894
2016-07-12 18:30:00,125,129,135,389,2334
2016-07-12 18:40:00,73,127,139,339,2034
2016-07-12 18:50:00,75,147,175,397,2382
2016-07-12 19:00:00,72,114,123,309,1854
2016-07-12 19:10:00,44,102,95,241,1446
2016-07-12 19:20:00,48,66,55,169,1014
2016-07-12 19:30:00,37,50,53,140,840
2016-07-12 19:40:00,40,61,58,159,954
2016-07-12 19:50:00,58,61,64,183,1098
2016-07-12 20:00:00,66,64,67,197,1182
2016-07-12 20:10:00,35,33,41,109,654
2016-07-12 20:20:00,19,24,28,71,426
2016-07-12 20:30:00,18,24,25,67,402
2016-07-12 20:40:00,23,27,31,81,486
2016-07-12 20:50:00,20,20,29,69,414
2016-07-12 21:00:00,9,15,12,36,216
2016-07-12 21:10:00,3,7,5,15,90
2016-07-12 21:20:00,1,2,2,5,30
2016-07-12 21:30:00,0,0,0,0,0
2016-07-12 21:40:00,0,0,0,0,0
2016-07-12 21:50:00,0,0,0,0,0
2016-07-12 22:00:00,0,0,0,0,0
2016-07-12 22:10:00,0,0,0,0,0
2016-07-13 04:10:00,0,0,0,0,0
2016-07-13 04:20:00,0,0,0,0,0
2016-07-13 04:30:00,0,0,0,0,0
2016-07-13 04:40:00,0,0,0,0,0
2016-07-13 04:50:00,0,0,0,0,0
2016-07-13 05:00:00,2,6,3,11,66
2016-07-13 05:10:00,5,9,4,18,108
2016-07-13 05:20:00,7,12,7,26,156
2016-07-13 05:30:00,5,15,9,29,174
2016-07-13 05:40:00,9,16,14,39,234
2016-07-13 05:50:00,15,17,17,49,294
2016-07-13 06:00:00,18,16,24,58,348
2016-07-13 06:10:00,19,25,26,70,420
2016-07-13 06:20:00,20,32,30,82,492
2016-07-13 06:30:00,13,49,30,92,552
2016-07-13 06:40:00,20,48,35,103,618
2016-07-13 06:50:00,24,54,34,112,672
2016-07-13 07:00:00,14,91,16,121,726
2016-07-13 07:10:00,29,59,27,115,690
2016-07-13 07:20:00,76,105,83,264,1584
2016-07-13 07:30:00,94,145,150,389,2334
2016-07-13 07:40:00,120,216,174,510,3060
2016-07-13 07:50:00,258,185,200,643,3858
2016-07-13 08:00:00,251,273,268,792,4752
2016-07-13 08:10:00,303,325,318,946,5676
2016-07-13 08:20:00,353,379,374,1106,6636
2016-07-13 08:30:00,401,427,422,1250,7500
2016-07-13 08:40:00,427,453,451,1331,7986
2016-07-13 08:50:00,421,445,439,1305,7830
2016-07-13 09:00:00,582,606,595,1783,10698
2016-07-13 09:10:00,626,648,644,1918,11508
2016-07-13 09:20:00,668,686,687,2041,12246
2016-07-13 09:30:00,725,740,740,2205,13230
2016-07-13 09:40:00,752,773,764,2289,13734
2016-07-13 09:50:00,784,812,799,2395,14370
2016-07-13 10:00:00,819,844,839,2502,15012
2016-07-13 10:10:00,832,854,854,2540,15240
2016-07-13 10:20:00,881,908,902,2691,16146
2016-07-13 10:30:00,896,922,920,2738,16428
2016-07-13 10:40:00,917,943,945,2805,16830
2016-07-13 10:50:00,945,964,963,2872,17232
2016-07-13 11:00:00,952,998,982,2932,17592
2016-07-13 11:10:00,977,1011,999,2987,17922
2016-07-13 11:20:00,991,1021,1010,3022,18132
2016-07-13 11:30:00,1005,1034,1022,3061,18366
2016-07-13 11:40:00,1008,1048,1034,3090,18540
2016-07-13 11:50:00,1025,1054,1046,3125,18750
2016-07-13 12:00:00,1039,1076,1067,3182,19092
2016-07-13 12:10:00,1096,1116,1110,3322,19932
2016-07-13 12:20:00,822,844,841,2507,15042
2016-07-13 12:30:00,221,244,240,705,4230
2016-07-13 12:40:00,413,436,432,1281,7686
2016-07-13 12:50:00,900,929,922,2751,16506
2016-07-13 13:00:00,1095,1128,1121,3344,20064
2016-07-13 13:10:00,1081,1099,1090,3270,19620
2016-07-13 13:20:00,1066,1096,1080,3242,19452
2016-07-13 13:30:00,1059,1084,1077,3220,19320
2016-07-13 13:40:00,1050,1074,1071,3195,19170
2016-07-13 13:50:00,1055,1074,1073,3202,19212
2016-07-13 14:00:00,1051,1074,1068,3193,19158
2016-07-13 14:10:00,1043,1063,1058,3164,18984
2016-07-13 14:20:00,1031,1056,1050,3137,18822
2016-07-13 14:30:00,1018,1044,1037,3099,18594
2016-07-13 14:40:00,1006,1029,1024,3059,18354
2016-07-13 14:50:00,980,999,1000,2979,17874
2016-07-13 15:00:00,975,999,999,2973,17838
2016-07-13 15:10:00,948,995,980,2923,17538
2016-07-13 15:20:00,942,979,967,2888,17328
2016-07-13 15:30:00,916,949,937,2802,16812
2016-07-13 15:40:00,692,720,714,2126,12756
2016-07-13 15:50:00,472,500,494,1466,8796
2016-07-13 16:00:00,432,463,454,1349,8094
2016-07-13 16:10:00,466,488,484,1438,8628
2016-07-13 16:20:00,430,452,450,1332,7992
2016-07-13 16:30:00,180,202,198,580,3480
2016-07-13 16:40:00,267,289,280,836,5016
2016-07-13 16:50:00,281,312,304,897,5382
2016-07-13 17:00:00,262,293,287,842,5052
2016-07-13 17:10:00,461,497,490,1448,8688
2016-07-13 17:20:00,209,239,233,681,4086
2016-07-13 17:30:00,237,265,258,760,4560
2016-07-13 17:40:00,190,358,137,685,4110
2016-07-13 17:50:00,334,435,315,1084,6504
2016-07-13 18:00:00,236,260,257,753,4518
2016-07-13 18:10:00,153,211,143,507,3042
2016-07-13 18:20:00,132,155,150,437,2622
2016-07-13 18:30:00,163,187,181,531,3186
2016-07-13 18:40:00,145,167,164,476,2856
2016-07-13 18:50:00,83,120,61,264,1584
2016-07-13 19:00:00,84,128,105,317,1902
2016-07-13 19:10:00,49,74,45,168,1008
2016-07-13 19:20:00,51,59,45,155,930
2016-07-13 19:30:00,45,52,47,144,864
2016-07-13 19:40:00,31,48,39,118,708
2016-07-13 19:50:00,22,52,26,100,600
2016-07-13 20:00:00,25,47,18,90,540
2016-07-13 20:10:00,21,42,18,81,486
2016-07-13 20:20:00,21,37,15,73,438
2016-07-13 20:30:00,18,20,24,62,372
2016-07-13 20:40:00,13,23,16,52,312
2016-07-13 20:50:00,9,17,13,39,234
2016-07-13 21:00:00,6,12,7,25,150
2016-07-13 21:10:00,3,6,3,12,72
2016-07-13 21:20:00,1,1,1,3,18
2016-07-13 21:30:00,0,0,0,0,0
2016-07-13 21:40:00,0,0,0,0,0
2016-07-13 21:50:00,0,0,0,0,0
2016-07-13 22:00:00,0,0,0,0,0
2016-07-14 04:10:00,0,0,0,0,0
2016-07-14 04:20:00,0,0,0,0,0
2016-07-14 04:30:00,0,0,0,0,0
2016-07-14 04:40:00,0,0,0,0,0
2016-07-14 04:50:00,0,0,0,0,0
2016-07-14 05:00:00,0,1,1,2,12
2016-07-14 05:10:00,2,3,2,7,42
2016-07-14 05:20:00,8,17,14,39,234
2016-07-14 05:30:00,13,22,20,55,330
2016-07-14 05:40:00,13,14,20,47,282
2016-07-14 05:50:00,14,17,22,53,318
2016-07-14 06:00:00,13,19,18,50,300
2016-07-14 06:10:00,12,26,16,54,324
2016-07-14 06:20:00,17,46,24,87,522
2016-07-14 06:30:00,36,74,52,162,972
2016-07-14 06:40:00,32,68,37,137,822
2016-07-14 06:50:00,22,72,25,119,714
2016-07-14 07:00:00,22,75,32,129,774
2016-07-14 07:10:00,44,57,55,156,936
2016-07-14 07:20:00,103,149,142,394,2364
2016-07-14 07:30:00,230,254,247,731,4386
2016-07-14 07:40:00,159,183,178,520,3120
2016-07-14 07:50:00,168,189,138,495,2970
2016-07-14 08:00:00,289,154,197,640,3840
2016-07-14 08:10:00,223,243,240,706,4236
2016-07-14 08:20:00,203,227,223,653,3918
2016-07-14 08:30:00,259,281,278,818,4908
2016-07-14 08:40:00,471,495,486,1452,8712
2016-07-14 08:50:00,378,398,393,1169,7014
2016-07-14 09:00:00,401,417,417,1235,7410
2016-07-14 09:10:00,222,242,239,703,4218
2016-07-14 09:20:00,206,227,225,658,3948
2016-07-14 09:30:00,259,280,279,818,4908
2016-07-14 09:40:00,246,267,264,777,4662
2016-07-14 09:50:00,265,285,285,835,5010
2016-07-14 10:00:00,337,361,357,1055,6330
2016-07-14 10:10:00,627,655,647,1929,11574
2016-07-14 10:20:00,424,446,440,1310,7860
2016-07-14 10:30:00,454,474,471,1399,8394
2016-07-14 10:40:00,512,536,532,1580,9480
2016-07-14 10:50:00,405,427,423,1255,7530
2016-07-14 11:00:00,461,484,479,1424,8544
2016-07-14 11:10:00,539,566,557,1662,9972
2016-07-14 11:20:00,591,613,599,1803,10818
2016-07-14 11:30:00,257,281,273,811,4866
2016-07-14 11:40:00,219,243,235,697,4182
2016-07-14 11:50:00,291,315,309,915,5490
2016-07-14 12:00:00,332,354,350,1036,6216
2016-07-14 12:10:00,687,711,705,2103,12618
2016-07-14 12:20:00,663,686,676,2025,12150
2016-07-14 12:30:00,1016,1038,1030,3084,18504
2016-07-14 12:40:00,705,734,728,2167,13002
2016-07-14 12:50:00,684,714,705,2103,12618
2016-07-14 13:00:00,471,495,488,1454,8724
2016-07-14 13:10:00,547,572,565,1684,10104
2016-07-14 13:20:00,325,345,344,1014,6084
2016-07-14 13:30:00,441,460,458,1359,8154
2016-07-14 13:40:00,1050,1065,1065,3180,19080
2016-07-14 13:50:00,1137,1165,1156,3458,20748
2016-07-14 14:00:00,454,485,476,1415,8490
2016-07-14 14:10:00,433,462,459,1354,8124
2016-07-14 14:20:00,936,958,971,2865,17190
2016-07-14 14:30:00,627,651,648,1926,11556
2016-07-14 14:40:00,956,983,975,2914,17484
2016-07-14 14:50:00,762,790,785,2337,14022
2016-07-14 15:00:00,827,853,853,2533,15198
2016-07-14 15:10:00,639,668,667,1974,11844
2016-07-14 15:20:00,559,588,585,1732,10392
2016-07-14 15:30:00,506,544,537,1587,9522
2016-07-14 15:40:00,589,624,616,1829,10974
2016-07-14 15:50:00,484,517,509,1510,9060
2016-07-14 16:00:00,366,396,388,1150,6900
2016-07-14 16:10:00,262,288,281,831,4986
2016-07-14 16:20:00,254,279,272,805,4830
2016-07-14 16:30:00,183,208,203,594,3564
2016-07-14 16:40:00,236,228,251,715,4290
2016-07-14 16:50:00,394,421,414,1229,7374
2016-07-14 17:00:00,209,233,227,669,4014
2016-07-14 17:10:00,141,291,135,567,3402
2016-07-14 17:20:00,69,247,207,523,3138
2016-07-14 17:30:00,0,158,289,447,2682
2016-07-14 17:40:00,136,284,23,443,2658
2016-07-14 17:50:00,141,211,72,424,2544
2016-07-14 18:00:00,137,83,169,389,2334
2016-07-14 18:10:00,69,132,137,338,2028
2016-07-14 18:20:00,70,59,86,215,1290
2016-07-14 18:30:00,67,78,77,222,1332
2016-07-14 18:40:00,70,39,92,201,1206
2016-07-14 18:50:00,63,36,73,172,1032
2016-07-14 19:00:00,93,63,89,245,1470
2016-07-14 19:10:00,81,78,92,251,1506
2016-07-14 19:20:00,98,65,92,255,1530
2016-07-14 19:30:00,31,42,36,109,654
2016-07-14 19:40:00,52,47,63,162,972
2016-07-14 19:50:00,43,42,43,128,768
2016-07-14 20:00:00,15,23,24,62,372
2016-07-14 20:10:00,20,21,27,68,408
2016-07-14 20:20:00,10,14,17,41,246
2016-07-14 20:30:00,2,3,4,9,54
2016-07-14 20:40:00,0,0,0,0,0
2016-07-14 20:50:00,0,0,0,0,0
2016-07-14 21:00:00,0,0,0,0,0
2016-07-14 21:10:00,0,0,0,0,0
2016-07-14 21:20:00,0,0,0,0,0
2016-07-14 21:30:00,0,0,0,0,0
2016-07-14 21:40:00,0,0,0,0,0
2016-07-14 21:50:00,0,0,0,0,0
2016-07-14 22:00:00,0,0,0,0,0
2016-07-14 22:10:00,0,0,0,0,0
2016-07-15 04:30:00,0,0,0,0,0
2016-07-15 04:40:00,0,0,0,0,0
2016-07-15 04:50:00,0,0,0,0,0
2016-07-15 05:00:00,0,0,0,0,0
2016-07-15 05:10:00,0,0,0,0,0
2016-07-15 05:20:00,0,0,0,0,0
2016-07-15 05:30:00,0,0,0,0,0
2016-07-15 05:40:00,1,0,1,2,12
2016-07-15 05:50:00,6,5,6,17,102
2016-07-15 06:00:00,12,13,14,39,234
2016-07-15 06:10:00,23,18,26,67,402
2016-07-15 06:20:00,18,27,27,72,432
2016-07-15 06:30:00,11,44,27,82,492
2016-07-15 06:40:00,17,26,25,68,408
2016-07-15 06:50:00,19,30,26,75,450
2016-07-15 07:00:00,20,37,32,89,534
2016-07-15 07:10:00,22,60,30,112,672
2016-07-15 07:20:00,42,56,46,144,864
2016-07-15 07:30:00,42,59,54,155,930
2016-07-15 07:40:00,68,85,78,231,1386
2016-07-15 07:50:00,85,104,95,284,1704
2016-07-15 08:00:00,69,91,85,245,1470
2016-07-15 08:10:00,72,86,88,246,1476
2016-07-15 08:20:00,93,72,94,259,1554
2016-07-15 08:30:00,108,75,120,303,1818
2016-07-15 08:40:00,128,105,140,373,2238
2016-07-15 08:50:00,143,188,88,419,2514
2016-07-15 09:00:00,203,248,132,583,3498
2016-07-15 09:10:00,188,289,13,490,2940
2016-07-15 09:20:00,226,149,185,560,3360
2016-07-15 09:30:00,233,248,239,720,4320
2016-07-15 09:40:00,237,261,254,752,4512
2016-07-15 09:50:00,503,529,522,1554,9324
2016-07-15 10:00:00,391,416,416,1223,7338
2016-07-15 10:10:00,352,375,372,1099,6594
2016-07-15 10:20:00,407,430,426,1263,7578
2016-07-15 10:30:00,452,479,474,1405,8430
2016-07-15 10:40:00,726,761,751,2238,13428
2016-07-15 10:50:00,826,857,851,2534,15204
2016-07-15 11:00:00,654,687,681,2022,12132
2016-07-15 11:10:00,689,721,707,2117,12702
2016-07-15 11:20:00,588,614,603,1805,10830
2016-07-15 11:30:00,624,657,648,1929,11574
2016-07-15 11:40:00,713,738,732,2183,13098
2016-07-15 11:50:00,672,699,691,2062,12372
2016-07-15 12:00:00,574,583,598,1755,10530
2016-07-15 12:10:00,954,976,972,2902,17412
2016-07-15 12:20:00,1112,1102,1124,3338,20028
2016-07-15 12:30:00,623,644,643,1910,11460
2016-07-15 12:40:00,530,539,556,1625,9750
2016-07-15 12:50:00,691,698,713,2102,12612
2016-07-15 13:00:00,835,859,860,2554,15324
2016-07-15 13:10:00,606,627,627,1860,11160
2016-07-15 13:20:00,460,477,481,1418,8508
2016-07-15 13:30:00,586,601,605,1792,10752
2016-07-15 13:40:00,321,340,341,1002,6012
2016-07-15 13:50:00,496,510,513,1519,9114
2016-07-15 14:00:00,571,588,589,1748,10488
2016-07-15 14:10:00,682,702,706,2090,12540
2016-07-15 14:20:00,579,602,603,1784,10704
2016-07-15 14:30:00,617,638,639,1894,11364
2016-07-15 14:40:00,563,587,586,1736,10416
2016-07-15 14:50:00,455,477,474,1406,8436
2016-07-15 15:00:00,411,436,433,1280,7680
2016-07-15 15:10:00,444,467,464,1375,8250
2016-07-15 15:20:00,374,399,397,1170,7020
2016-07-15 15:30:00,459,493,488,1440,8640
2016-07-15 15:40:00,565,601,593,1759,10554
2016-07-15 15:50:00,540,577,573,1690,10140
2016-07-15 16:00:00,506,534,536,1576,9456
2016-07-15 16:10:00,656,687,692,2035,12210
2016-07-15 16:20:00,301,325,326,952,5712
2016-07-15 16:30:00,344,372,372,1088,6528
2016-07-15 16:40:00,424,457,454,1335,8010
2016-07-15 16:50:00,443,471,473,1387,8322
2016-07-15 17:00:00,261,284,281,826,4956
2016-07-15 17:10:00,329,353,347,1029,6174
2016-07-15 17:20:00,318,346,342,1006,6036
2016-07-15 17:30:00,213,238,234,685,4110
2016-07-15 17:40:00,199,220,218,637,3822
2016-07-15 17:50:00,236,258,256,750,4500
2016-07-15 18:00:00,160,181,180,521,3126
2016-07-15 18:10:00,121,131,144,396,2376
2016-07-15 18:20:00,88,171,183,442,2652
2016-07-15 18:30:00,37,157,142,336,2016
2016-07-15 18:40:00,108,107,66,281,1686
2016-07-15 18:50:00,124,141,11,276,1656
2016-07-15 19:00:00,75,92,49,216,1296
2016-07-15 19:10:00,81,99,57,237,1422
2016-07-15 19:20:00,121,141,77,339,2034
2016-07-15 19:30:00,119,139,82,340,2040
2016-07-15 19:40:00,146,182,160,488,2928
2016-07-15 19:50:00,121,139,99,359,2154
2016-07-15 20:00:00,62,77,31,170,1020
2016-07-15 20:10:00,31,72,28,131,786
2016-07-15 20:20:00,52,56,46,154,924
2016-07-15 20:30:00,65,40,57,162,972
2016-07-15 20:40:00,39,49,37,125,750
2016-07-15 20:50:00,25,27,29,81,486
2016-07-15 21:00:00,10,9,11,30,180
2016-07-15 21:10:00,2,3,3,8,48
2016-07-15 21:20:00,0,0,0,0,0
2016-07-15 21:30:00,0,0,0,0,0
2016-07-15 21:40:00,0,0,0,0,0
2016-07-15 21:50:00,0,0,0,0,0
2016-07-15 22:00:00,0,0,0,0,0
2016-07-16 04:10:00,0,0,0,0,0
2016-07-16 04:20:00,0,0,0,0,0
2016-07-16 04:30:00,0,0,0,0,0
2016-07-16 04:40:00,0,0,0,0,0
2016-07-16 04:50:00,0,0,0,0,0
2016-07-16 05:00:00,2,2,3,7,42
2016-07-16 05:10:00,4,3,3,10,60
2016-07-16 05:20:00,3,3,3,9,54
2016-07-16 05:30:00,7,4,4,15,90
2016-07-16 05:40:00,18,18,24,60,360
2016-07-16 05:50:00,27,46,33,106,636
2016-07-16 06:00:00,63,63,80,206,1236
2016-07-16 06:10:00,45,68,57,170,1020
2016-07-16 06:20:00,34,67,41,142,852
2016-07-16 06:30:00,50,45,64,159,954
2016-07-16 06:40:00,28,35,36,99,594
2016-07-16 06:50:00,27,24,37,88,528
2016-07-16 07:00:00,38,40,43,121,726
2016-07-16 07:10:00,45,57,48,150,900
2016-07-16 07:20:00,104,127,131,362,2172
2016-07-16 07:30:00,175,206,84,465,2790
2016-07-16 07:40:00,76,224,176,476,2856
2016-07-16 07:50:00,249,206,128,583,3498
2016-07-16 08:00:00,163,151,157,471,2826
2016-07-16 08:10:00,49,146,226,421,2526
2016-07-16 08:20:00,102,82,118,302,1812
2016-07-16 08:30:00,74,71,86,231,1386
2016-07-16 08:40:00,84,88,91,263,1578
2016-07-16 08:50:00,91,89,108,288,1728
2016-07-16 09:00:00,58,56,80,194,1164
2016-07-16 09:10:00,83,31,104,218,1308
2016-07-16 09:20:00,68,19,79,166,996
2016-07-16 09:30:00,57,43,66,166,996
2016-07-16 09:40:00,86,45,103,234,1404
2016-07-16 09:50:00,109,96,160,365,2190
2016-07-16 10:00:00,149,116,170,435,2610
2016-07-16 10:10:00,88,71,121,280,1680
2016-07-16 10:20:00,104,129,142,375,2250
2016-07-16 10:30:00,121,196,183,500,3000
2016-07-16 10:40:00,215,245,264,724,4344
2016-07-16 10:50:00,126,151,150,427,2562
2016-07-16 11:00:00,89,130,134,353,2118
2016-07-16 11:10:00,149,126,153,428,2568
2016-07-16 11:20:00,199,179,210,588,3528
2016-07-16 11:30:00,184,208,206,598,3588
2016-07-16 11:40:00,207,232,229,668,4008
2016-07-16 11:50:00,171,195,192,558,3348
2016-07-16 12:00:00,170,198,194,562,3372
2016-07-16 12:10:00,167,193,188,548,3288
2016-07-16 12:20:00,155,180,178,513,3078
2016-07-16 12:30:00,212,237,234,683,4098
2016-07-16 12:40:00,166,168,188,522,3132
2016-07-16 12:50:00,152,142,165,459,2754
2016-07-16 13:00:00,260,124,185,569,3414
2016-07-16 13:10:00,200,202,207,609,3654
2016-07-16 13:20:00,286,309,304,899,5394
2016-07-16 13:30:00,166,190,186,542,3252
2016-07-16 13:40:00,224,247,242,713,4278
2016-07-16 13:50:00,250,273,271,794,4764
2016-07-16 14:00:00,288,311,305,904,5424
2016-07-16 14:10:00,297,323,318,938,5628
2016-07-16 14:20:00,343,368,363,1074,6444
2016-07-16 14:30:00,443,469,463,1375,8250
2016-07-16 14:40:00,292,316,308,916,5496
2016-07-16 14:50:00,349,374,365,1088,6528
2016-07-16 15:00:00,308,333,327,968,5808
2016-07-16 15:10:00,261,258,267,786,4716
2016-07-16 15:20:00,266,291,287,844,5064
2016-07-16 15:30:00,262,287,283,832,4992
2016-07-16 15:40:00,797,828,825,2450,14700
2016-07-16 15:50:00,857,892,887,2636,15816
2016-07-16 16:00:00,785,819,811,2415,14490
2016-07-16 16:10:00,713,742,736,2191,13146
2016-07-16 16:20:00,287,312,308,907,5442
2016-07-16 16:30:00,142,162,167,471,2826
2016-07-16 16:40:00,210,189,199,598,3588
2016-07-16 16:50:00,208,248,228,684,4104
2016-07-16 17:00:00,243,264,261,768,4608
2016-07-16 17:10:00,426,449,449,1324,7944
2016-07-16 17:20:00,316,343,340,999,5994
2016-07-16 17:30:00,381,419,407,1207,7242
2016-07-16 17:40:00,296,309,320,925,5550
2016-07-16 17:50:00,316,318,339,973,5838
2016-07-16 18:00:00,316,319,339,974,5844
2016-07-16 18:10:00,219,204,193,616,3696
2016-07-16 18:20:00,341,131,168,640,3840
2016-07-16 18:30:00,231,184,91,506,3036
2016-07-16 18:40:00,185,190,47,422,2532
2016-07-16 18:50:00,153,178,6,337,2022
2016-07-16 19:00:00,116,129,23,268,1608
2016-07-16 19:10:00,67,48,68,183,1098
2016-07-16 19:20:00,34,55,29,118,708
2016-07-16 19:30:00,41,50,20,111,666
2016-07-16 19:40:00,38,44,18,100,600
2016-07-16 19:50:00,34,33,22,89,534
2016-07-16 20:00:00,28,17,35,80,480
2016-07-16 20:10:00,21,18,30,69,414
2016-07-16 20:20:00,19,17,23,59,354
2016-07-16 20:30:00,21,16,27,64,384
2016-07-16 20:40:00,18,13,22,53,318
2016-07-16 20:50:00,15,7,5,27,162
2016-07-16 21:00:00,6,7,2,15,90
2016-07-16 21:10:00,0,0,0,0,0
2016-07-16 21:20:00,0,0,0,0,0
2016-07-16 21:30:00,0,0,0,0,0
2016-07-16 21:40:00,0,0,0,0,0
2016-07-16 21:50:00,0,0,0,0,0
2016-07-16 22:00:00,0,0,0,0,0
2016-07-17 04:20:00,0,0,0,0,0
2016-07-17 04:30:00,0,0,0,0,0
2016-07-17 04:40:00,0,0,0,0,0
2016-07-17 04:50:00,0,0,0,0,0
2016-07-17 05:00:00,0,0,0,0,0
2016-07-17 05:10:00,1,3,2,6,36
2016-07-17 05:20:00,3,9,6,18,108
2016-07-17 05:30:00,5,14,9,28,168
2016-07-17 05:40:00,8,19,8,35,210
2016-07-17 05:50:00,12,24,13,49,294
2016-07-17 06:00:00,14,34,13,61,366
2016-07-17 06:10:00,16,42,12,70,420
2016-07-17 06:20:00,16,47,21,84,504
2016-07-17 06:30:00,24,48,26,98,588
2016-07-17 06:40:00,29,48,34,111,666
2016-07-17 06:50:00,12,94,15,121,726
2016-07-17 07:00:00,28,67,37,132,792
2016-07-17 07:10:00,39,59,49,147,882
2016-07-17 07:20:00,34,96,87,217,1302
2016-07-17 07:30:00,85,127,116,328,1968
2016-07-17 07:40:00,90,160,224,474,2844
2016-07-17 07:50:00,193,198,209,600,3600
2016-07-17 08:00:00,231,255,255,741,4446
2016-07-17 08:10:00,284,308,307,899,5394
2016-07-17 08:20:00,372,395,388,1155,6930
2016-07-17 08:30:00,423,446,439,1308,7848
2016-07-17 08:40:00,249,271,265,785,4710
2016-07-17 08:50:00,518,545,537,1600,9600
2016-07-17 09:00:00,557,583,576,1716,10296
2016-07-17 09:10:00,625,650,645,1920,11520
2016-07-17 09:20:00,589,636,629,1854,11124
2016-07-17 09:30:00,401,433,429,1263,7578
2016-07-17 09:40:00,533,561,559,1653,9918
2016-07-17 09:50:00,525,548,541,1614,9684
2016-07-17 10:00:00,265,290,284,839,5034
2016-07-17 10:10:00,245,267,263,775,4650
2016-07-17 10:20:00,174,197,193,564,3384
2016-07-17 10:30:00,235,259,253,747,4482
2016-07-17 10:40:00,279,303,296,878,5268
2016-07-17 10:50:00,174,197,191,562,3372
2016-07-17 11:00:00,84,107,104,295,1770
2016-07-17 11:10:00,132,122,151,405,2430
2016-07-17 11:20:00,211,206,157,574,3444
2016-07-17 11:30:00,183,226,196,605,3630
2016-07-17 11:40:00,208,159,182,549,3294
2016-07-17 11:50:00,185,307,100,592,3552
2016-07-17 12:00:00,171,195,190,556,3336
2016-07-17 12:10:00,149,143,156,448,2688
2016-07-17 12:20:00,249,272,268,789,4734
2016-07-17 12:30:00,171,194,191,556,3336
2016-07-17 12:40:00,319,341,336,996,5976
2016-07-17 12:50:00,358,383,377,1118,6708
2016-07-17 13:00:00,350,373,366,1089,6534
2016-07-17 13:10:00,254,277,271,802,4812
2016-07-17 13:20:00,628,645,639,1912,11472
2016-07-17 13:30:00,767,786,775,2328,13968
2016-07-17 13:40:00,990,1012,1000,3002,18012
2016-07-17 13:50:00,799,819,807,2425,14550
2016-07-17 14:00:00,667,694,677,2038,12228
2016-07-17 14:10:00,517,539,524,1580,9480
2016-07-17 14:20:00,142,164,158,464,2784
2016-07-17 14:30:00,475,495,485,1455,8730
2016-07-17 14:40:00,261,282,276,819,4914
2016-07-17 14:50:00,458,480,475,1413,8478
2016-07-17 15:00:00,291,313,307,911,5466
2016-07-17 15:10:00,421,444,437,1302,7812
2016-07-17 15:20:00,485,504,498,1487,8922
2016-07-17 15:30:00,250,271,268,789,4734
2016-07-17 15:40:00,191,184,186,561,3366
2016-07-17 15:50:00,224,249,244,717,4302
2016-07-17 16:00:00,380,405,396,1181,7086
2016-07-17 16:10:00,446,471,460,1377,8262
2016-07-17 16:20:00,471,498,488,1457,8742
2016-07-17 16:30:00,495,527,517,1539,9234
2016-07-17 16:40:00,355,384,378,1117,6702
2016-07-17 16:50:00,238,262,257,757,4542
2016-07-17 17:00:00,79,66,92,237,1422
2016-07-17 17:10:00,145,128,152,425,2550
2016-07-17 17:20:00,230,249,243,722,4332
2016-07-17 17:30:00,249,280,271,800,4800
2016-07-17 17:40:00,117,134,155,406,2436
2016-07-17 17:50:00,260,257,262,779,4674
2016-07-17 18:00:00,162,188,181,531,3186
2016-07-17 18:10:00,165,189,183,537,3222
2016-07-17 18:20:00,249,274,268,791,4746
2016-07-17 18:30:00,89,104,105,298,1788
2016-07-17 18:40:00,90,124,144,358,2148
2016-07-17 18:50:00,71,69,85,225,1350
2016-07-17 19:00:00,97,105,71,273,1638
2016-07-17 19:10:00,104,128,60,292,1752
2016-07-17 19:20:00,106,129,53,288,1728
2016-07-17 19:30:00,83,100,54,237,1422
2016-07-17 19:40:00,51,52,52,155,930
2016-07-17 19:50:00,49,68,27,144,864
2016-07-17 20:00:00,27,59,28,114,684
2016-07-17 20:10:00,16,19,39,74,444
2016-07-17 20:20:00,16,25,20,61,366
2016-07-17 20:30:00,11,12,15,38,228
2016-07-17 20:40:00,3,3,3,9,54
2016-07-17 20:50:00,1,2,3,6,36
2016-07-17 21:00:00,0,0,0,0,0
2016-07-17 21:10:00,0,0,0,0,0
2016-07-17 21:20:00,0,0,0,0,0
2016-07-17 21:30:00,0,0,0,0,0
2016-07-17 21:40:00,0,0,0,0,0
2016-07-17 21:50:00,0,0,0,0,0
2016-07-17 22:00:00,0,0,0,0,0
2016-07-18 04:20:00,0,0,0,0,0
2016-07-18 04:30:00,0,0,0,0,0
2016-07-18 04:40:00,0,0,0,0,0
2016-07-18 04:50:00,0,0,0,0,0
2016-07-18 05:00:00,0,0,0,0,0
2016-07-18 05:10:00,2,3,3,8,48
2016-07-18 05:20:00,4,8,6,18,108
2016-07-18 05:30:00,5,12,11,28,168
2016-07-18 05:40:00,11,14,18,43,258
2016-07-18 05:50:00,17,24,25,66,396
2016-07-18 06:00:00,24,36,29,89,534
2016-07-18 06:10:00,22,37,32,91,546
2016-07-18 06:20:00,32,46,42,120,720
2016-07-18 06:30:00,41,64,64,169,1014
2016-07-18 06:40:00,25,53,31,109,654
2016-07-18 06:50:00,25,64,40,129,774
2016-07-18 07:00:00,60,61,75,196,1176
2016-07-18 07:10:00,98,92,122,312,1872
2016-07-18 07:20:00,92,114,118,324,1944
2016-07-18 07:30:00,70,127,128,325,1950
2016-07-18 07:40:00,81,127,100,308,1848
2016-07-18 07:50:00,181,213,180,574,3444
2016-07-18 08:00:00,225,251,244,720,4320
2016-07-18 08:10:00,302,331,322,955,5730
2016-07-18 08:20:00,242,271,265,778,4668
2016-07-18 08:30:00,323,351,344,1018,6108
2016-07-18 08:40:00,483,509,503,1495,8970
2016-07-18 08:50:00,279,301,293,873,5238
2016-07-18 09:00:00,274,295,291,860,5160
2016-07-18 09:10:00,233,255,253,741,4446
2016-07-18 09:20:00,316,336,331,983,5898
2016-07-18 09:30:00,352,375,368,1095,6570
2016-07-18 09:40:00,400,430,422,1252,7512
2016-07-18 09:50:00,400,425,417,1242,7452
2016-07-18 10:00:00,317,340,332,989,5934
2016-07-18 10:10:00,284,304,301,889,5334
2016-07-18 10:20:00,284,305,306,895,5370
2016-07-18 10:30:00,345,372,369,1086,6516
2016-07-18 10:40:00,372,397,391,1160,6960
2016-07-18 10:50:00,335,360,355,1050,6300
2016-07-18 11:00:00,340,364,359,1063,6378
2016-07-18 11:10:00,382,406,400,1188,7128
2016-07-18 11:20:00,381,404,397,1182,7092
2016-07-18 11:30:00,452,470,464,1386,8316
2016-07-18 11:40:00,564,583,589,1736,10416
2016-07-18 11:50:00,741,758,756,2255,13530
2016-07-18 12:00:00,611,633,627,1871,11226
2016-07-18 12:10:00,422,438,439,1299,7794
2016-07-18 12:20:00,544,565,561,1670,10020
2016-07-18 12:30:00,544,559,556,1659,9954
2016-07-18 12:40:00,759,773,775,2307,13842
2016-07-18 12:50:00,852,862,869,2583,15498
2016-07-18 13:00:00,643,657,657,1957,11742
2016-07-18 13:10:00,791,805,810,2406,14436
2016-07-18 13:20:00,903,923,924,2750,16500
2016-07-18 13:30:00,872,891,894,2657,15942
2016-07-18 13:40:00,916,927,941,2784,16704
2016-07-18 13:50:00,515,532,538,1585,9510
2016-07-18 14:00:00,418,437,437,1292,7752
2016-07-18 14:10:00,381,403,401,1185,7110
2016-07-18 14:20:00,243,265,264,772,4632
2016-07-18 14:30:00,147,169,168,484,2904
2016-07-18 14:40:00,139,209,60,408,2448
2016-07-18 14:50:00,112,123,141,376,2256
2016-07-18 15:00:00,201,256,84,541,3246
2016-07-18 15:10:00,298,317,313,928,5568
2016-07-18 15:20:00,311,328,326,965,5790
2016-07-18 15:30:00,275,295,292,862,5172
2016-07-18 15:40:00,126,120,157,403,2418
2016-07-18 15:50:00,88,109,99,296,1776
2016-07-18 16:00:00,104,109,118,331,1986
2016-07-18 16:10:00,160,276,62,498,2988
2016-07-18 16:20:00,52,91,98,241,1446
2016-07-18 16:30:00,60,63,73,196,1176
2016-07-18 16:40:00,52,73,62,187,1122
2016-07-18 16:50:00,48,57,69,174,1044
2016-07-18 17:00:00,61,81,103,245,1470
2016-07-18 17:10:00,113,24,135,272,1632
2016-07-18 17:20:00,104,80,129,313,1878
2016-07-18 17:30:00,124,191,176,491,2946
2016-07-18 17:40:00,103,75,144,322,1932
2016-07-18 17:50:00,83,70,103,256,1536
2016-07-18 18:00:00,39,57,51,147,882
2016-07-18 18:10:00,25,40,40,105,630
2016-07-18 18:20:00,124,158,99,381,2286
2016-07-18 18:30:00,129,85,152,366,2196
2016-07-18 18:40:00,86,53,95,234,1404
2016-07-18 18:50:00,49,48,62,159,954
2016-07-18 19:00:00,18,20,23,61,366
2016-07-18 19:10:00,49,43,65,157,942
2016-07-18 19:20:00,24,32,32,88,528
2016-07-18 19:30:00,11,14,14,39,234
2016-07-18 19:40:00,9,10,11,30,180
2016-07-18 19:50:00,8,8,11,27,162
2016-07-18 20:00:00,9,12,13,34,204
2016-07-18 20:10:00,2,4,2,8,48
2016-07-18 20:20:00,4,8,4,16,96
2016-07-18 20:30:00,7,10,9,26,156
2016-07-18 20:40:00,3,3,4,10,60
2016-07-18 20:50:00,1,2,2,5,30
2016-07-18 21:00:00,1,2,1,4,24
2016-07-18 21:10:00,1,2,1,4,24
2016-07-18 21:20:00,0,0,0,0,0
2016-07-18 21:30:00,0,0,0,0,0
2016-07-18 21:40:00,0,0,0,0,0
2016-07-18 21:50:00,0,0,0,0,0
2016-07-18 22:00:00,0,0,0,0,0
2016-07-19 04:20:00,0,0,0,0,0
2016-07-19 04:30:00,0,0,0,0,0
2016-07-19 04:40:00,0,0,0,0,0
2016-07-19 04:50:00,0,0,0,0,0
2016-07-19 05:00:00,0,0,0,0,0
2016-07-19 05:10:00,3,5,4,12,72
2016-07-19 05:20:00,7,11,10,28,168
2016-07-19 05:30:00,10,13,15,38,228
2016-07-19 05:40:00,10,12,16,38,228
2016-07-19 05:50:00,18,27,25,70,420
2016-07-19 06:00:00,23,32,33,88,528
2016-07-19 06:10:00,28,51,32,111,666
2016-07-19 06:20:00,35,58,45,138,828
2016-07-19 06:30:00,33,56,47,136,816
2016-07-19 06:40:00,29,66,34,129,774
2016-07-19 06:50:00,39,56,44,139,834
2016-07-19 07:00:00,55,112,139,306,1836
2016-07-19 07:10:00,29,146,143,318,1908
2016-07-19 07:20:00,104,150,89,343,2058
2016-07-19 07:30:00,94,128,118,340,2040
2016-07-19 07:40:00,97,92,117,306,1836
2016-07-19 07:50:00,126,138,133,397,2382
2016-07-19 08:00:00,215,240,234,689,4134
2016-07-19 08:10:00,317,342,334,993,5958
2016-07-19 08:20:00,349,374,368,1091,6546
2016-07-19 08:30:00,334,360,353,1047,6282
2016-07-19 08:40:00,335,366,357,1058,6348
2016-07-19 08:50:00,229,256,249,734,4404
2016-07-19 09:00:00,198,229,221,648,3888
2016-07-19 09:10:00,389,415,406,1210,7260
2016-07-19 09:20:00,364,389,385,1138,6828
2016-07-19 09:30:00,329,353,349,1031,6186
2016-07-19 09:40:00,399,425,422,1246,7476
2016-07-19 09:50:00,497,517,514,1528,9168
2016-07-19 10:00:00,469,481,490,1440,8640
2016-07-19 10:10:00,483,500,502,1485,8910
2016-07-19 10:20:00,732,734,752,2218,13308
2016-07-19 10:30:00,556,581,573,1710,10260
2016-07-19 10:40:00,788,807,802,2397,14382
2016-07-19 10:50:00,690,703,713,2106,12636
2016-07-19 11:00:00,673,698,689,2060,12360
2016-07-19 11:10:00,576,605,595,1776,10656
2016-07-19 11:20:00,742,767,760,2269,13614
2016-07-19 11:30:00,908,938,927,2773,16638
2016-07-19 11:40:00,905,931,924,2760,16560
2016-07-19 11:50:00,957,989,976,2922,17532
2016-07-19 12:00:00,1007,1036,1029,3072,18432
2016-07-19 12:10:00,994,1026,1012,3032,18192
2016-07-19 12:20:00,990,1022,1012,3024,18144
2016-07-19 12:30:00,927,959,949,2835,17010
2016-07-19 12:40:00,895,930,919,2744,16464
2016-07-19 12:50:00,661,690,679,2030,12180
2016-07-19 13:00:00,761,794,782,2337,14022
2016-07-19 13:10:00,865,896,886,2647,15882
2016-07-19 13:20:00,1065,1097,1088,3250,19500
2016-07-19 13:30:00,1033,1063,1055,3151,18906
2016-07-19 13:40:00,747,772,764,2283,13698
2016-07-19 13:50:00,717,748,741,2206,13236
2016-07-19 14:00:00,536,560,556,1652,9912
2016-07-19 14:10:00,372,401,393,1166,6996
2016-07-19 14:20:00,349,382,372,1103,6618
2016-07-19 14:30:00,340,367,359,1066,6396
2016-07-19 14:40:00,342,369,361,1072,6432
2016-07-19 14:50:00,451,482,470,1403,8418
2016-07-19 15:00:00,298,323,316,937,5622
2016-07-19 15:10:00,310,334,328,972,5832
2016-07-19 15:20:00,342,367,359,1068,6408
2016-07-19 15:30:00,287,313,307,907,5442
2016-07-19 15:40:00,353,378,373,1104,6624
2016-07-19 15:50:00,372,399,395,1166,6996
2016-07-19 16:00:00,279,305,299,883,5298
2016-07-19 16:10:00,205,230,226,661,3966
2016-07-19 16:20:00,244,272,265,781,4686
2016-07-19 16:30:00,307,338,331,976,5856
2016-07-19 16:40:00,331,361,351,1043,6258
2016-07-19 16:50:00,591,623,612,1826,10956
2016-07-19 17:00:00,546,583,571,1700,10200
2016-07-19 17:10:00,297,326,319,942,5652
2016-07-19 17:20:00,316,345,339,1000,6000
2016-07-19 17:30:00,346,375,371,1092,6552
2016-07-19 17:40:00,210,255,215,680,4080
2016-07-19 17:50:00,165,232,123,520,3120
2016-07-19 18:00:00,235,269,240,744,4464
2016-07-19 18:10:00,219,253,235,707,4242
2016-07-19 18:20:00,192,217,212,621,3726
2016-07-19 18:30:00,63,78,76,217,1302
2016-07-19 18:40:00,111,125,117,353,2118
2016-07-19 18:50:00,82,126,91,299,1794
2016-07-19 19:00:00,101,122,100,323,1938
2016-07-19 19:10:00,75,91,85,251,1506
2016-07-19 19:20:00,55,80,63,198,1188
2016-07-19 19:30:00,46,68,58,172,1032
2016-07-19 19:40:00,37,66,36,139,834
2016-07-19 19:50:00,19,82,20,121,726
2016-07-19 20:00:00,31,46,23,100,600
2016-07-19 20:10:00,25,29,18,72,432
2016-07-19 20:20:00,24,34,14,72,432
2016-07-19 20:30:00,21,40,16,77,462
2016-07-19 20:40:00,18,25,10,53,318
2016-07-19 20:50:00,5,7,19,31,186
2016-07-19 21:00:00,5,9,7,21,126
2016-07-19 21:10:00,5,8,4,17,102
2016-07-19 21:20:00,0,0,0,0,0
2016-07-19 21:30:00,0,0,0,0,0
2016-07-19 21:40:00,0,0,0,0,0
2016-07-19 21:50:00,0,0,0,0,0
2016-07-19 22:00:00,0,0,0,0,0
2016-07-20 04:20:00,0,0,0,0,0
2016-07-20 04:30:00,0,0,0,0,0
2016-07-20 04:40:00,0,0,0,0,0
2016-07-20 04:50:00,0,0,0,0,0
2016-07-20 05:00:00,0,0,0,0,0
2016-07-20 05:10:00,1,1,1,3,18
2016-07-20 05:20:00,3,5,4,12,72
2016-07-20 05:30:00,5,9,8,22,132
2016-07-20 05:40:00,6,12,12,30,180
2016-07-20 05:50:00,7,16,15,38,228
2016-07-20 06:00:00,10,18,18,46,276
2016-07-20 06:10:00,13,24,19,56,336
2016-07-20 06:20:00,16,26,24,66,396
2016-07-20 06:30:00,14,35,27,76,456
2016-07-20 06:40:00,19,42,22,83,498
2016-07-20 06:50:00,23,43,24,90,540
2016-07-20 07:00:00,24,43,31,98,588
2016-07-20 07:10:00,29,44,31,104,624
2016-07-20 07:20:00,37,58,50,145,870
2016-07-20 07:30:00,67,120,119,306,1836
2016-07-20 07:40:00,115,254,65,434,2604
2016-07-20 07:50:00,243,199,116,558,3348
2016-07-20 08:00:00,286,181,231,698,4188
2016-07-20 08:10:00,264,293,285,842,5052
2016-07-20 08:20:00,319,338,334,991,5946
2016-07-20 08:30:00,370,385,383,1138,6828
2016-07-20 08:40:00,415,437,435,1287,7722
2016-07-20 08:50:00,466,489,488,1443,8658
2016-07-20 09:00:00,517,543,543,1603,9618
2016-07-20 09:10:00,568,589,596,1753,10518
2016-07-20 09:20:00,620,636,632,1888,11328
2016-07-20 09:30:00,664,680,669,2013,12078
2016-07-20 09:40:00,701,721,710,2132,12792
2016-07-20 09:50:00,740,762,754,2256,13536
2016-07-20 10:00:00,767,791,786,2344,14064
2016-07-20 10:10:00,799,818,804,2421,14526
2016-07-20 10:20:00,823,844,826,2493,14958
2016-07-20 10:30:00,845,867,848,2560,15360
2016-07-20 10:40:00,869,890,869,2628,15768
2016-07-20 10:50:00,889,915,897,2701,16206
2016-07-20 11:00:00,914,941,929,2784,16704
2016-07-20 11:10:00,950,976,969,2895,17370
2016-07-20 11:20:00,906,933,913,2752,16512
2016-07-20 11:30:00,980,1013,995,2988,17928
2016-07-20 11:40:00,999,1024,1007,3030,18180
2016-07-20 11:50:00,981,1001,997,2979,17874
2016-07-20 12:00:00,982,1002,1004,2988,17928
2016-07-20 12:10:00,993,1015,1005,3013,18078
2016-07-20 12:20:00,998,1023,1005,3026,18156
2016-07-20 12:30:00,1009,1021,1015,3045,18270
2016-07-20 12:40:00,1006,1017,1022,3045,18270
2016-07-20 12:50:00,1007,1030,1018,3055,18330
2016-07-20 13:00:00,1001,1038,1014,3053,18318
2016-07-20 13:10:00,1001,1034,1017,3052,18312
2016-07-20 13:20:00,1005,1026,1016,3047,18282
2016-07-20 13:30:00,1015,999,1025,3039,18234
2016-07-20 13:40:00,1002,1015,1015,3032,18192
2016-07-20 13:50:00,999,999,1013,3011,18066
2016-07-20 14:00:00,983,1007,995,2985,17910
2016-07-20 14:10:00,991,978,993,2962,17772
2016-07-20 14:20:00,972,981,986,2939,17634
2016-07-20 14:30:00,961,981,965,2907,17442
2016-07-20 14:40:00,950,972,963,2885,17310
2016-07-20 14:50:00,938,959,949,2846,17076
2016-07-20 15:00:00,917,941,929,2787,16722
2016-07-20 15:10:00,875,897,885,2657,15942
2016-07-20 15:20:00,861,881,869,2611,15666
2016-07-20 15:30:00,824,845,840,2509,15054
2016-07-20 15:40:00,793,811,800,2404,14424
2016-07-20 15:50:00,761,782,771,2314,13884
2016-07-20 16:00:00,715,747,737,2199,13194
2016-07-20 16:10:00,689,723,711,2123,12738
2016-07-20 16:20:00,651,683,674,2008,12048
2016-07-20 16:30:00,606,637,628,1871,11226
2016-07-20 16:40:00,578,610,601,1789,10734
2016-07-20 16:50:00,548,575,566,1689,10134
2016-07-20 17:00:00,505,535,526,1566,9396
2016-07-20 17:10:00,480,509,501,1490,8940
2016-07-20 17:20:00,448,478,468,1394,8364
2016-07-20 17:30:00,404,434,422,1260,7560
2016-07-20 17:40:00,366,393,383,1142,6852
2016-07-20 17:50:00,323,349,342,1014,6084
2016-07-20 18:00:00,272,297,291,860,5160
2016-07-20 18:10:00,228,249,245,722,4332
2016-07-20 18:20:00,181,204,200,585,3510
2016-07-20 18:30:00,138,161,158,457,2742
2016-07-20 18:40:00,105,151,107,363,2178
2016-07-20 18:50:00,86,115,101,302,1812
2016-07-20 19:00:00,63,83,77,223,1338
2016-07-20 19:10:00,45,56,48,149,894
2016-07-20 19:20:00,23,40,35,98,588
2016-07-20 19:30:00,22,45,30,97,582
2016-07-20 19:40:00,17,46,25,88,528
2016-07-20 19:50:00,17,43,21,81,486
2016-07-20 20:00:00,19,37,18,74,444
2016-07-20 20:10:00,15,32,20,67,402
2016-07-20 20:20:00,14,33,11,58,348
2016-07-20 20:30:00,14,24,11,49,294
2016-07-20 20:40:00,8,22,8,38,228
2016-07-20 20:50:00,6,13,6,25,150
2016-07-20 21:00:00,3,4,2,9,54
2016-07-20 21:10:00,0,0,0,0,0
2016-07-20 21:20:00,0,0,0,0,0
2016-07-20 21:30:00,0,0,0,0,0
2016-07-20 21:40:00,0,0,0,0,0
2016-07-20 21:50:00,0,0,0,0,0
2016-07-21 04:20:00,0,0,0,0,0
2016-07-21 04:30:00,0,0,0,0,0
2016-07-21 04:40:00,0,0,0,0,0
2016-07-21 04:50:00,3,0,2,5,30
2016-07-21 05:00:00,3,2,3,8,48
2016-07-21 05:10:00,6,6,7,19,114
2016-07-21 05:20:00,13,14,14,41,246
2016-07-21 05:30:00,21,27,25,73,438
2016-07-21 05:40:00,25,62,25,112,672
2016-07-21 05:50:00,45,56,45,146,876
2016-07-21 06:00:00,52,71,62,185,1110
2016-07-21 06:10:00,63,84,73,220,1320
2016-07-21 06:20:00,79,91,95,265,1590
2016-07-21 06:30:00,66,103,104,273,1638
2016-07-21 06:40:00,56,76,73,205,1230
2016-07-21 06:50:00,48,60,58,166,996
2016-07-21 07:00:00,42,61,51,154,924
2016-07-21 07:10:00,42,73,63,178,1068
2016-07-21 07:20:00,65,86,70,221,1326
2016-07-21 07:30:00,73,95,86,254,1524
2016-07-21 07:40:00,96,128,101,325,1950
2016-07-21 07:50:00,154,131,124,409,2454
2016-07-21 08:00:00,172,191,172,535,3210
2016-07-21 08:10:00,193,218,204,615,3690
2016-07-21 08:20:00,202,225,219,646,3876
2016-07-21 08:30:00,214,237,232,683,4098
2016-07-21 08:40:00,239,264,257,760,4560
2016-07-21 08:50:00,425,454,450,1329,7974
2016-07-21 09:00:00,404,431,426,1261,7566
2016-07-21 09:10:00,464,492,485,1441,8646
2016-07-21 09:20:00,629,655,653,1937,11622
2016-07-21 09:30:00,739,769,762,2270,13620
2016-07-21 09:40:00,503,535,526,1564,9384
2016-07-21 09:50:00,284,311,304,899,5394
2016-07-21 10:00:00,325,352,347,1024,6144
2016-07-21 10:10:00,320,345,337,1002,6012
2016-07-21 10:20:00,349,379,372,1100,6600
2016-07-21 10:30:00,307,339,330,976,5856
2016-07-21 10:40:00,195,224,219,638,3828
2016-07-21 10:50:00,109,118,129,356,2136
2016-07-21 11:00:00,116,25,129,270,1620
2016-07-21 11:10:00,85,73,110,268,1608
2016-07-21 11:20:00,74,136,125,335,2010
2016-07-21 11:30:00,40,172,219,431,2586
2016-07-21 11:40:00,19,197,282,498,2988
2016-07-21 11:50:00,47,177,270,494,2964
2016-07-21 12:00:00,215,237,237,689,4134
2016-07-21 12:10:00,239,265,258,762,4572
2016-07-21 12:20:00,268,294,286,848,5088
2016-07-21 12:30:00,445,475,466,1386,8316
2016-07-21 12:40:00,444,475,466,1385,8310
2016-07-21 12:50:00,573,607,591,1771,10626
2016-07-21 13:00:00,331,361,352,1044,6264
2016-07-21 13:10:00,339,364,358,1061,6366
2016-07-21 13:20:00,309,333,328,970,5820
2016-07-21 13:30:00,289,314,306,909,5454
2016-07-21 13:40:00,323,346,337,1006,6036
2016-07-21 13:50:00,410,436,422,1268,7608
2016-07-21 14:00:00,454,479,464,1397,8382
2016-07-21 14:10:00,403,428,415,1246,7476
2016-07-21 14:20:00,280,308,299,887,5322
2016-07-21 14:30:00,214,241,233,688,4128
2016-07-21 14:40:00,179,206,138,523,3138
2016-07-21 14:50:00,188,210,169,567,3402
2016-07-21 15:00:00,259,284,280,823,4938
2016-07-21 15:10:00,309,338,329,976,5856
2016-07-21 15:20:00,340,366,358,1064,6384
2016-07-21 15:30:00,370,403,392,1165,6990
2016-07-21 15:40:00,352,381,373,1106,6636
2016-07-21 15:50:00,329,357,350,1036,6216
2016-07-21 16:00:00,301,330,322,953,5718
2016-07-21 16:10:00,291,317,309,917,5502
2016-07-21 16:20:00,456,486,473,1415,8490
2016-07-21 16:30:00,647,675,665,1987,11922
2016-07-21 16:40:00,646,675,666,1987,11922
2016-07-21 16:50:00,629,658,650,1937,11622
2016-07-21 17:00:00,563,587,584,1734,10404
2016-07-21 17:10:00,464,485,480,1429,8574
2016-07-21 17:20:00,173,233,166,572,3432
2016-07-21 17:30:00,120,167,166,453,2718
2016-07-21 17:40:00,276,298,286,860,5160
2016-07-21 17:50:00,98,120,117,335,2010
2016-07-21 18:00:00,144,167,162,473,2838
2016-07-21 18:10:00,227,249,244,720,4320
2016-07-21 18:20:00,194,214,209,617,3702
2016-07-21 18:30:00,148,167,164,479,2874
2016-07-21 18:40:00,107,127,125,359,2154
2016-07-21 18:50:00,111,123,62,296,1776
2016-07-21 19:00:00,75,89,61,225,1350
2016-07-21 19:10:00,44,62,53,159,954
2016-07-21 19:20:00,35,66,34,135,810
2016-07-21 19:30:00,24,88,20,132,792
2016-07-21 19:40:00,9,84,29,122,732
2016-07-21 19:50:00,27,49,35,111,666
2016-07-21 20:00:00,27,49,24,100,600
2016-07-21 20:10:00,25,35,25,85,510
2016-07-21 20:20:00,20,23,27,70,420
2016-07-21 20:30:00,16,19,22,57,342
2016-07-21 20:40:00,9,16,11,36,216
2016-07-21 20:50:00,6,11,5,22,132
2016-07-21 21:00:00,2,3,2,7,42
2016-07-21 21:10:00,0,0,0,0,0
2016-07-21 21:20:00,0,0,0,0,0
2016-07-21 21:30:00,0,0,0,0,0
2016-07-21 21:40:00,0,0,0,0,0
2016-07-21 21:50:00,0,0,0,0,0
2016-07-22 04:20:00,0,0,0,0,0
2016-07-22 04:30:00,0,0,0,0,0
2016-07-22 04:40:00,0,0,0,0,0
2016-07-22 04:50:00,0,0,0,0,0
2016-07-22 05:00:00,0,0,0,0,0
2016-07-22 05:10:00,0,1,0,1,6
2016-07-22 05:20:00,3,4,4,11,66
2016-07-22 05:30:00,9,9,13,31,186
2016-07-22 05:40:00,19,18,26,63,378
2016-07-22 05:50:00,22,25,31,78,468
2016-07-22 06:00:00,21,25,32,78,468
2016-07-22 06:10:00,44,40,48,132,792
2016-07-22 06:20:00,70,66,85,221,1326
2016-07-22 06:30:00,108,37,134,279,1674
2016-07-22 06:40:00,70,94,92,256,1536
2016-07-22 06:50:00,58,79,76,213,1278
2016-07-22 07:00:00,70,32,81,183,1098
2016-07-22 07:10:00,53,67,69,189,1134
2016-07-22 07:20:00,77,89,86,252,1512
2016-07-22 07:30:00,94,123,107,324,1944
2016-07-22 07:40:00,23,167,260,450,2700
2016-07-22 07:50:00,178,316,61,555,3330
2016-07-22 08:00:00,226,260,230,716,4296
2016-07-22 08:10:00,247,268,264,779,4674
2016-07-22 08:20:00,291,312,307,910,5460
2016-07-22 08:30:00,326,346,341,1013,6078
2016-07-22 08:40:00,366,384,379,1129,6774
2016-07-22 08:50:00,418,436,432,1286,7716
2016-07-22 09:00:00,290,309,305,904,5424
2016-07-22 09:10:00,488,510,505,1503,9018
2016-07-22 09:20:00,469,496,491,1456,8736
2016-07-22 09:30:00,272,301,296,869,5214
2016-07-22 09:40:00,241,271,265,777,4662
2016-07-22 09:50:00,332,361,354,1047,6282
2016-07-22 10:00:00,545,585,579,1709,10254
2016-07-22 10:10:00,521,556,547,1624,9744
2016-07-22 10:20:00,587,625,613,1825,10950
2016-07-22 10:30:00,529,563,556,1648,9888
2016-07-22 10:40:00,612,648,645,1905,11430
2016-07-22 10:50:00,770,812,803,2385,14310
2016-07-22 11:00:00,884,933,914,2731,16386
2016-07-22 11:10:00,899,937,924,2760,16560
2016-07-22 11:20:00,903,946,932,2781,16686
2016-07-22 11:30:00,913,944,941,2798,16788
2016-07-22 11:40:00,942,950,967,2859,17154
2016-07-22 11:50:00,965,982,988,2935,17610
2016-07-22 12:00:00,970,991,1003,2964,17784
2016-07-22 12:10:00,989,1015,1013,3017,18102
2016-07-22 12:20:00,1013,1000,1015,3028,18168
2016-07-22 12:30:00,1006,1028,1007,3041,18246
2016-07-22 12:40:00,1001,1027,1019,3047,18282
2016-07-22 12:50:00,1019,1038,1016,3073,18438
2016-07-22 13:00:00,998,1025,1014,3037,18222
2016-07-22 13:10:00,993,1030,1017,3040,18240
2016-07-22 13:20:00,1020,1047,1034,3101,18606
2016-07-22 13:30:00,986,1016,1001,3003,18018
2016-07-22 13:40:00,872,897,881,2650,15900
2016-07-22 13:50:00,857,885,878,2620,15720
2016-07-22 14:00:00,969,999,986,2954,17724
2016-07-22 14:10:00,961,992,980,2933,17598
2016-07-22 14:20:00,953,982,971,2906,17436
2016-07-22 14:30:00,944,968,956,2868,17208
2016-07-22 14:40:00,919,945,935,2799,16794
2016-07-22 14:50:00,896,927,923,2746,16476
2016-07-22 15:00:00,870,910,899,2679,16074
2016-07-22 15:10:00,848,880,874,2602,15612
2016-07-22 15:20:00,776,805,805,2386,14316
2016-07-22 15:30:00,573,599,595,1767,10602
2016-07-22 15:40:00,419,442,442,1303,7818
2016-07-22 15:50:00,446,470,466,1382,8292
2016-07-22 16:00:00,330,353,354,1037,6222
2016-07-22 16:10:00,676,704,705,2085,12510
2016-07-22 16:20:00,660,694,690,2044,12264
2016-07-22 16:30:00,595,621,613,1829,10974
2016-07-22 16:40:00,552,580,574,1706,10236
2016-07-22 16:50:00,510,535,533,1578,9468
2016-07-22 17:00:00,467,494,489,1450,8700
2016-07-22 17:10:00,365,387,383,1135,6810
2016-07-22 17:20:00,234,254,251,739,4434
2016-07-22 17:30:00,162,181,179,522,3132
2016-07-22 17:40:00,238,257,255,750,4500
2016-07-22 17:50:00,246,266,264,776,4656
2016-07-22 18:00:00,159,178,175,512,3072
2016-07-22 18:10:00,167,179,164,510,3060
2016-07-22 18:20:00,49,117,110,276,1656
2016-07-22 18:30:00,34,118,117,269,1614
2016-07-22 18:40:00,64,84,81,229,1374
2016-07-22 18:50:00,46,64,55,165,990
2016-07-22 19:00:00,51,44,48,143,858
2016-07-22 19:10:00,53,46,56,155,930
2016-07-22 19:20:00,49,52,53,154,924
2016-07-22 19:30:00,40,51,53,144,864
2016-07-22 19:40:00,19,60,29,108,648
2016-07-22 19:50:00,20,39,27,86,516
2016-07-22 20:00:00,14,36,24,74,444
2016-07-22 20:10:00,12,26,19,57,342
2016-07-22 20:20:00,7,19,16,42,252
2016-07-22 20:30:00,7,16,10,33,198
2016-07-22 20:40:00,7,14,6,27,162
2016-07-22 20:50:00,3,7,6,16,96
2016-07-22 21:00:00,1,3,1,5,30
2016-07-22 21:10:00,0,0,0,0,0
2016-07-22 21:20:00,0,0,0,0,0
2016-07-22 21:30:00,0,0,0,0,0
2016-07-22 21:40:00,0,0,0,0,0
2016-07-22 21:50:00,0,0,0,0,0
2016-07-23 04:40:00,0,0,0,0,0
2016-07-23 04:50:00,0,0,0,0,0
2016-07-23 05:00:00,0,0,0,0,0
2016-07-23 05:10:00,0,0,0,0,0
2016-07-23 05:20:00,0,0,0,0,0
2016-07-23 05:30:00,0,0,0,0,0
2016-07-23 05:40:00,0,1,1,2,12
2016-07-23 05:50:00,1,3,1,5,30
2016-07-23 06:00:00,3,5,3,11,66
2016-07-23 06:10:00,7,15,8,30,180
2016-07-23 06:20:00,15,27,19,61,366
2016-07-23 06:30:00,24,44,27,95,570
2016-07-23 06:40:00,27,51,24,102,612
2016-07-23 06:50:00,22,44,26,92,552
2016-07-23 07:00:00,18,42,18,78,468
2016-07-23 07:10:00,30,55,32,117,702
2016-07-23 07:20:00,46,43,58,147,882
2016-07-23 07:30:00,33,51,55,139,834
2016-07-23 07:40:00,34,60,61,155,930
2016-07-23 07:50:00,50,73,62,185,1110
2016-07-23 08:00:00,79,55,89,223,1338
2016-07-23 08:10:00,124,0,132,256,1536
2016-07-23 08:20:00,110,49,121,280,1680
2016-07-23 08:30:00,82,109,98,289,1734
2016-07-23 08:40:00,61,78,73,212,1272
2016-07-23 08:50:00,89,122,98,309,1854
2016-07-23 09:00:00,111,37,118,266,1596
2016-07-23 09:10:00,91,57,95,243,1458
2016-07-23 09:20:00,63,111,98,272,1632
2016-07-23 09:30:00,139,218,62,419,2514
2016-07-23 09:40:00,136,117,144,397,2382
2016-07-23 09:50:00,128,130,144,402,2412
2016-07-23 10:00:00,104,54,111,269,1614
2016-07-23 10:10:00,93,114,110,317,1902
2016-07-23 10:20:00,113,66,127,306,1836
2016-07-23 10:30:00,87,122,130,339,2034
2016-07-23 10:40:00,161,143,185,489,2934
2016-07-23 10:50:00,210,239,175,624,3744
2016-07-23 11:00:00,306,315,317,938,5628
2016-07-23 11:10:00,307,330,327,964,5784
2016-07-23 11:20:00,239,262,260,761,4566
2016-07-23 11:30:00,210,233,230,673,4038
2016-07-23 11:40:00,214,188,166,568,3408
2016-07-23 11:50:00,240,176,176,592,3552
2016-07-23 12:00:00,206,258,109,573,3438
2016-07-23 12:10:00,216,175,174,565,3390
2016-07-23 12:20:00,229,157,180,566,3396
2016-07-23 12:30:00,190,296,58,544,3264
2016-07-23 12:40:00,14,186,302,502,3012
2016-07-23 12:50:00,3,171,312,486,2916
2016-07-23 13:00:00,0,159,309,468,2808
2016-07-23 13:10:00,92,182,241,515,3090
2016-07-23 13:20:00,191,218,203,612,3672
2016-07-23 13:30:00,208,229,224,661,3966
2016-07-23 13:40:00,249,321,230,800,4800
2016-07-23 13:50:00,548,571,566,1685,10110
2016-07-23 14:00:00,709,730,722,2161,12966
2016-07-23 14:10:00,613,634,628,1875,11250
2016-07-23 14:20:00,585,608,602,1795,10770
2016-07-23 14:30:00,379,396,392,1167,7002
2016-07-23 14:40:00,470,487,482,1439,8634
2016-07-23 14:50:00,460,481,474,1415,8490
2016-07-23 15:00:00,442,466,459,1367,8202
2016-07-23 15:10:00,425,446,442,1313,7878
2016-07-23 15:20:00,694,709,703,2106,12636
2016-07-23 15:30:00,922,944,935,2801,16806
2016-07-23 15:40:00,818,858,849,2525,15150
2016-07-23 15:50:00,770,797,786,2353,14118
2016-07-23 16:00:00,615,642,629,1886,11316
2016-07-23 16:10:00,371,398,387,1156,6936
2016-07-23 16:20:00,252,281,270,803,4818
2016-07-23 16:30:00,277,304,295,876,5256
2016-07-23 16:40:00,329,358,346,1033,6198
2016-07-23 16:50:00,322,349,340,1011,6066
2016-07-23 17:00:00,288,311,305,904,5424
2016-07-23 17:10:00,282,311,297,890,5340
2016-07-23 17:20:00,243,268,259,770,4620
2016-07-23 17:30:00,256,282,272,810,4860
2016-07-23 17:40:00,217,240,231,688,4128
2016-07-23 17:50:00,198,217,212,627,3762
2016-07-23 18:00:00,179,200,195,574,3444
2016-07-23 18:10:00,175,196,192,563,3378
2016-07-23 18:20:00,170,194,189,553,3318
2016-07-23 18:30:00,157,182,178,517,3102
2016-07-23 18:40:00,166,127,175,468,2808
2016-07-23 18:50:00,107,138,225,470,2820
2016-07-23 19:00:00,57,163,221,441,2646
2016-07-23 19:10:00,98,152,132,382,2292
2016-07-23 19:20:00,127,103,143,373,2238
2016-07-23 19:30:00,105,128,136,369,2214
2016-07-23 19:40:00,97,120,104,321,1926
2016-07-23 19:50:00,105,61,113,279,1674
2016-07-23 20:00:00,116,17,130,263,1578
2016-07-23 20:10:00,78,63,88,229,1374
2016-07-23 20:20:00,54,72,77,203,1218
2016-07-23 20:30:00,59,37,62,158,948
2016-07-23 20:40:00,22,81,20,123,738
2016-07-23 20:50:00,27,34,30,91,546
2016-07-23 21:00:00,22,36,25,83,498
2016-07-23 21:10:00,18,20,23,61,366
2016-07-23 21:20:00,8,11,11,30,180
2016-07-23 21:30:00,1,2,1,4,24
2016-07-23 21:40:00,0,0,0,0,0
2016-07-23 21:50:00,0,0,0,0,0
2016-07-24 04:30:00,0,0,0,0,0
2016-07-24 04:40:00,0,0,0,0,0
2016-07-24 04:50:00,0,0,0,0,0
2016-07-24 05:00:00,0,0,0,0,0
2016-07-24 05:10:00,0,0,1,1,6
2016-07-24 05:20:00,5,3,5,13,78
2016-07-24 05:30:00,8,8,9,25,150
2016-07-24 05:40:00,12,11,12,35,210
2016-07-24 05:50:00,14,13,8,35,210
2016-07-24 06:00:00,11,11,13,35,210
2016-07-24 06:10:00,15,19,20,54,324
2016-07-24 06:20:00,19,28,28,75,450
2016-07-24 06:30:00,25,39,34,98,588
2016-07-24 06:40:00,36,46,29,111,666
2016-07-24 06:50:00,17,89,19,125,750
2016-07-24 07:00:00,32,56,47,135,810
2016-07-24 07:10:00,44,52,50,146,876
2016-07-24 07:20:00,46,47,44,137,822
2016-07-24 07:30:00,51,98,87,236,1416
2016-07-24 07:40:00,106,136,136,378,2268
2016-07-24 07:50:00,80,212,212,504,3024
2016-07-24 08:00:00,174,337,121,632,3792
2016-07-24 08:10:00,244,265,263,772,4632
2016-07-24 08:20:00,293,315,308,916,5496
2016-07-24 08:30:00,346,365,358,1069,6414
2016-07-24 08:40:00,389,409,404,1202,7212
2016-07-24 08:50:00,439,461,458,1358,8148
2016-07-24 09:00:00,496,518,514,1528,9168
2016-07-24 09:10:00,551,566,564,1681,10086
2016-07-24 09:20:00,594,615,615,1824,10944
2016-07-24 09:30:00,637,653,656,1946,11676
2016-07-24 09:40:00,678,697,692,2067,12402
2016-07-24 09:50:00,725,737,729,2191,13146
2016-07-24 10:00:00,753,769,761,2283,13698
2016-07-24 10:10:00,773,800,785,2358,14148
2016-07-24 10:20:00,810,827,812,2449,14694
2016-07-24 10:30:00,841,854,841,2536,15216
2016-07-24 10:40:00,858,871,861,2590,15540
2016-07-24 10:50:00,871,894,888,2653,15918
2016-07-24 11:00:00,901,913,898,2712,16272
2016-07-24 11:10:00,911,927,904,2742,16452
2016-07-24 11:20:00,917,943,934,2794,16764
2016-07-24 11:30:00,938,955,959,2852,17112
2016-07-24 11:40:00,958,969,969,2896,17376
2016-07-24 11:50:00,969,991,980,2940,17640
2016-07-24 12:00:00,973,1002,987,2962,17772
2016-07-24 12:10:00,974,1000,996,2970,17820
2016-07-24 12:20:00,991,1007,1005,3003,18018
2016-07-24 12:30:00,988,1024,1011,3023,18138
2016-07-24 12:40:00,1002,1027,1009,3038,18228
2016-07-24 12:50:00,1002,1026,1005,3033,18198
2016-07-24 13:00:00,996,1028,1009,3033,18198
2016-07-24 13:10:00,996,1025,1004,3025,18150
2016-07-24 13:20:00,980,1008,987,2975,17850
2016-07-24 13:30:00,972,1010,994,2976,17856
2016-07-24 13:40:00,978,1008,991,2977,17862
2016-07-24 13:50:00,975,1002,981,2958,17748
2016-07-24 14:00:00,973,994,974,2941,17646
2016-07-24 14:10:00,954,980,975,2909,17454
2016-07-24 14:20:00,943,969,960,2872,17232
2016-07-24 14:30:00,933,966,946,2845,17070
2016-07-24 14:40:00,918,949,931,2798,16788
2016-07-24 14:50:00,900,933,916,2749,16494
2016-07-24 15:00:00,881,914,892,2687,16122
2016-07-24 15:10:00,848,879,864,2591,15546
2016-07-24 15:20:00,820,850,836,2506,15036
2016-07-24 15:30:00,782,809,794,2385,14310
2016-07-24 15:40:00,741,768,754,2263,13578
2016-07-24 15:50:00,709,736,722,2167,13002
2016-07-24 16:00:00,679,707,696,2082,12492
2016-07-24 16:10:00,650,675,666,1991,11946
2016-07-24 16:20:00,609,634,624,1867,11202
2016-07-24 16:30:00,581,607,598,1786,10716
2016-07-24 16:40:00,541,567,556,1664,9984
2016-07-24 16:50:00,500,530,519,1549,9294
2016-07-24 17:00:00,462,496,485,1443,8658
2016-07-24 17:10:00,412,439,431,1282,7692
2016-07-24 17:20:00,366,398,389,1153,6918
2016-07-24 17:30:00,345,378,365,1088,6528
2016-07-24 17:40:00,316,346,335,997,5982
2016-07-24 17:50:00,281,308,303,892,5352
2016-07-24 18:00:00,234,262,255,751,4506
2016-07-24 18:10:00,187,214,210,611,3666
2016-07-24 18:20:00,161,238,109,508,3048
2016-07-24 18:30:00,36,188,152,376,2256
2016-07-24 18:40:00,51,80,95,226,1356
2016-07-24 18:50:00,64,68,75,207,1242
2016-07-24 19:00:00,71,77,78,226,1356
2016-07-24 19:10:00,62,73,74,209,1254
2016-07-24 19:20:00,60,71,76,207,1242
2016-07-24 19:30:00,46,66,80,192,1152
2016-07-24 19:40:00,31,62,67,160,960
2016-07-24 19:50:00,23,75,29,127,762
2016-07-24 20:00:00,22,42,35,99,594
2016-07-24 20:10:00,18,31,27,76,456
2016-07-24 20:20:00,14,21,21,56,336
2016-07-24 20:30:00,7,17,14,38,228
2016-07-24 20:40:00,4,11,9,24,144
2016-07-24 20:50:00,2,5,4,11,66
2016-07-24 21:00:00,0,2,1,3,18
2016-07-24 21:10:00,0,0,0,0,0
2016-07-24 21:20:00,0,0,0,0,0
2016-07-24 21:30:00,0,0,0,0,0
2016-07-24 21:40:00,0,0,0,0,0
2016-07-25 04:30:00,0,0,0,0,0
2016-07-25 04:40:00,0,0,0,0,0
2016-07-25 04:50:00,0,0,0,0,0
2016-07-25 05:00:00,0,0,0,0,0
2016-07-25 05:10:00,0,2,1,3,18
2016-07-25 05:20:00,5,7,6,18,108
2016-07-25 05:30:00,9,17,12,38,228
2016-07-25 05:40:00,22,28,27,77,462
2016-07-25 05:50:00,21,49,27,97,582
2016-07-25 06:00:00,22,85,22,129,774
2016-07-25 06:10:00,17,86,20,123,738
2016-07-25 06:20:00,21,82,22,125,750
2016-07-25 06:30:00,47,53,57,157,942
2016-07-25 06:40:00,94,99,104,297,1782
2016-07-25 06:50:00,110,114,126,350,2100
2016-07-25 07:00:00,107,38,115,260,1560
2016-07-25 07:10:00,46,100,102,248,1488
2016-07-25 07:20:00,44,117,117,278,1668
2016-07-25 07:30:00,93,123,111,327,1962
2016-07-25 07:40:00,95,120,113,328,1968
2016-07-25 07:50:00,95,123,103,321,1926
2016-07-25 08:00:00,91,127,108,326,1956
2016-07-25 08:10:00,67,111,112,290,1740
2016-07-25 08:20:00,118,151,135,404,2424
2016-07-25 08:30:00,98,150,161,409,2454
2016-07-25 08:40:00,285,281,288,854,5124
2016-07-25 08:50:00,217,242,237,696,4176
2016-07-25 09:00:00,428,456,449,1333,7998
2016-07-25 09:10:00,571,598,590,1759,10554
2016-07-25 09:20:00,327,352,349,1028,6168
2016-07-25 09:30:00,262,286,281,829,4974
2016-07-25 09:40:00,300,324,319,943,5658
2016-07-25 09:50:00,232,263,274,769,4614
2016-07-25 10:00:00,458,485,480,1423,8538
2016-07-25 10:10:00,771,802,795,2368,14208
2016-07-25 10:20:00,800,827,815,2442,14652
2016-07-25 10:30:00,809,832,831,2472,14832
2016-07-25 10:40:00,849,878,868,2595,15570
2016-07-25 10:50:00,776,816,802,2394,14364
2016-07-25 11:00:00,566,596,583,1745,10470
2016-07-25 11:10:00,602,625,622,1849,11094
2016-07-25 11:20:00,629,658,648,1935,11610
2016-07-25 11:30:00,720,744,731,2195,13170
2016-07-25 11:40:00,733,765,751,2249,13494
2016-07-25 11:50:00,713,754,726,2193,13158
2016-07-25 12:00:00,803,834,818,2455,14730
2016-07-25 12:10:00,649,673,663,1985,11910
2016-07-25 12:20:00,864,895,884,2643,15858
2016-07-25 12:30:00,871,900,884,2655,15930
2016-07-25 12:40:00,746,773,760,2279,13674
2016-07-25 12:50:00,711,736,728,2175,13050
2016-07-25 13:00:00,659,681,672,2012,12072
2016-07-25 13:10:00,244,267,261,772,4632
2016-07-25 13:20:00,241,171,200,612,3672
2016-07-25 13:30:00,290,138,202,630,3780
2016-07-25 13:40:00,268,289,288,845,5070
2016-07-25 13:50:00,245,268,264,777,4662
2016-07-25 14:00:00,284,309,305,898,5388
2016-07-25 14:10:00,586,611,611,1808,10848
2016-07-25 14:20:00,617,648,640,1905,11430
2016-07-25 14:30:00,345,377,365,1087,6522
2016-07-25 14:40:00,248,277,271,796,4776
2016-07-25 14:50:00,227,303,210,740,4440
2016-07-25 15:00:00,282,306,302,890,5340
2016-07-25 15:10:00,283,305,305,893,5358
2016-07-25 15:20:00,179,211,152,542,3252
2016-07-25 15:30:00,116,117,92,325,1950
2016-07-25 15:40:00,92,121,135,348,2088
2016-07-25 15:50:00,161,240,205,606,3636
2016-07-25 16:00:00,441,468,463,1372,8232
2016-07-25 16:10:00,403,432,425,1260,7560
2016-07-25 16:20:00,495,522,520,1537,9222
2016-07-25 16:30:00,534,567,556,1657,9942
2016-07-25 16:40:00,503,531,522,1556,9336
2016-07-25 16:50:00,363,387,380,1130,6780
2016-07-25 17:00:00,267,289,283,839,5034
2016-07-25 17:10:00,332,325,328,985,5910
2016-07-25 17:20:00,409,426,419,1254,7524
2016-07-25 17:30:00,371,391,388,1150,6900
2016-07-25 17:40:00,285,300,300,885,5310
2016-07-25 17:50:00,241,266,262,769,4614
2016-07-25 18:00:00,179,199,195,573,3438
2016-07-25 18:10:00,179,199,195,573,3438
2016-07-25 18:20:00,121,127,141,389,2334
2016-07-25 18:30:00,141,115,141,397,2382
2016-07-25 18:40:00,95,112,113,320,1920
2016-07-25 18:50:00,76,48,90,214,1284
2016-07-25 19:00:00,103,61,105,269,1614
2016-07-25 19:10:00,138,96,144,378,2268
2016-07-25 19:20:00,149,107,161,417,2502
2016-07-25 19:30:00,144,113,127,384,2304
2016-07-25 19:40:00,82,102,76,260,1560
2016-07-25 19:50:00,81,95,51,227,1362
2016-07-25 20:00:00,48,69,30,147,882
2016-07-25 20:10:00,36,44,12,92,552
2016-07-25 20:20:00,26,30,11,67,402
2016-07-25 20:30:00,18,25,12,55,330
2016-07-25 20:40:00,10,16,5,31,186
2016-07-25 20:50:00,1,3,6,10,60
2016-07-25 21:00:00,0,0,0,0,0
2016-07-25 21:10:00,0,0,0,0,0
2016-07-25 21:20:00,0,0,0,0,0
2016-07-25 21:30:00,0,0,0,0,0
2016-07-25 21:40:00,0,0,0,0,0
2016-07-26 04:30:00,0,0,0,0,0
2016-07-26 04:40:00,0,0,0,0,0
2016-07-26 04:50:00,0,0,0,0,0
2016-07-26 05:00:00,0,0,0,0,0
2016-07-26 05:10:00,0,0,0,0,0
2016-07-26 05:20:00,6,9,8,23,138
2016-07-26 05:30:00,14,15,18,47,282
2016-07-26 05:40:00,22,30,21,73,438
2016-07-26 05:50:00,23,57,25,105,630
2016-07-26 06:00:00,24,77,27,128,768
2016-07-26 06:10:00,19,64,24,107,642
2016-07-26 06:20:00,26,34,31,91,546
2016-07-26 06:30:00,45,53,41,139,834
2016-07-26 06:40:00,50,69,66,185,1110
2016-07-26 06:50:00,22,120,127,269,1614
2016-07-26 07:00:00,49,125,116,290,1740
2016-07-26 07:10:00,89,126,105,320,1920
2016-07-26 07:20:00,70,93,106,269,1614
2016-07-26 07:30:00,88,71,101,260,1560
2016-07-26 07:40:00,89,73,117,279,1674
2016-07-26 07:50:00,48,152,139,339,2034
2016-07-26 08:00:00,89,165,182,436,2616
2016-07-26 08:10:00,216,280,211,707,4242
2016-07-26 08:20:00,232,255,248,735,4410
2016-07-26 08:30:00,197,223,216,636,3816
2016-07-26 08:40:00,228,248,242,718,4308
2016-07-26 08:50:00,233,256,250,739,4434
2016-07-26 09:00:00,219,253,244,716,4296
2016-07-26 09:10:00,343,369,362,1074,6444
2016-07-26 09:20:00,194,218,212,624,3744
2016-07-26 09:30:00,318,345,340,1003,6018
2016-07-26 09:40:00,620,646,638,1904,11424
2016-07-26 09:50:00,690,717,709,2116,12696
2016-07-26 10:00:00,769,804,790,2363,14178
2016-07-26 10:10:00,823,861,850,2534,15204
2016-07-26 10:20:00,772,805,797,2374,14244
2016-07-26 10:30:00,895,921,918,2734,16404
2016-07-26 10:40:00,873,903,901,2677,16062
2016-07-26 10:50:00,833,860,846,2539,15234
2016-07-26 11:00:00,882,909,903,2694,16164
2016-07-26 11:10:00,946,977,975,2898,17388
2016-07-26 11:20:00,949,989,976,2914,17484
2016-07-26 11:30:00,977,1019,1000,2996,17976
2016-07-26 11:40:00,588,621,611,1820,10920
2016-07-26 11:50:00,100,153,150,403,2418
2016-07-26 12:00:00,713,773,728,2214,13284
2016-07-26 12:10:00,1068,1098,1087,3253,19518
2016-07-26 12:20:00,950,974,968,2892,17352
2016-07-26 12:30:00,497,521,513,1531,9186
2016-07-26 12:40:00,1057,1081,1070,3208,19248
2016-07-26 12:50:00,1045,1074,1056,3175,19050
2016-07-26 13:00:00,1046,1070,1050,3166,18996
2016-07-26 13:10:00,1061,1077,1063,3201,19206
2016-07-26 13:20:00,1081,1107,1100,3288,19728
2016-07-26 13:30:00,301,323,319,943,5658
2016-07-26 13:40:00,161,163,202,526,3156
2016-07-26 13:50:00,204,217,209,630,3780
2016-07-26 14:00:00,191,221,188,600,3600
2016-07-26 14:10:00,432,458,448,1338,8028
2016-07-26 14:20:00,359,387,375,1121,6726
2016-07-26 14:30:00,313,335,328,976,5856
2016-07-26 14:40:00,296,321,313,930,5580
2016-07-26 14:50:00,303,328,321,952,5712
2016-07-26 15:00:00,506,531,524,1561,9366
2016-07-26 15:10:00,592,623,615,1830,10980
2016-07-26 15:20:00,368,404,398,1170,7020
2016-07-26 15:30:00,363,407,398,1168,7008
2016-07-26 15:40:00,459,491,485,1435,8610
2016-07-26 15:50:00,380,395,407,1182,7092
2016-07-26 16:00:00,718,735,740,2193,13158
2016-07-26 16:10:00,649,665,670,1984,11904
2016-07-26 16:20:00,771,800,788,2359,14154
2016-07-26 16:30:00,614,624,639,1877,11262
2016-07-26 16:40:00,626,661,653,1940,11640
2016-07-26 16:50:00,553,591,581,1725,10350
2016-07-26 17:00:00,459,488,480,1427,8562
2016-07-26 17:10:00,394,421,415,1230,7380
2016-07-26 17:20:00,410,437,434,1281,7686
2016-07-26 17:30:00,374,400,396,1170,7020
2016-07-26 17:40:00,328,354,352,1034,6204
2016-07-26 17:50:00,261,285,283,829,4974
2016-07-26 18:00:00,118,142,138,398,2388
2016-07-26 18:10:00,7,151,139,297,1782
2016-07-26 18:20:00,161,189,161,511,3066
2016-07-26 18:30:00,96,141,145,382,2292
2016-07-26 18:40:00,118,32,135,285,1710
2016-07-26 18:50:00,91,49,99,239,1434
2016-07-26 19:00:00,49,80,80,209,1254
2016-07-26 19:10:00,45,84,107,236,1416
2016-07-26 19:20:00,29,64,49,142,852
2016-07-26 19:30:00,42,56,62,160,960
2016-07-26 19:40:00,59,55,71,185,1110
2016-07-26 19:50:00,28,41,37,106,636
2016-07-26 20:00:00,22,23,30,75,450
2016-07-26 20:10:00,11,25,19,55,330
2016-07-26 20:20:00,12,16,17,45,270
2016-07-26 20:30:00,10,14,12,36,216
2016-07-26 20:40:00,5,10,7,22,132
2016-07-26 20:50:00,4,7,4,15,90
2016-07-26 21:00:00,1,3,1,5,30
2016-07-26 21:10:00,0,0,0,0,0
2016-07-26 21:20:00,0,0,0,0,0
2016-07-26 21:30:00,0,0,0,0,0
2016-07-26 21:40:00,0,0,0,0,0
2016-07-27 04:30:00,0,0,0,0,0
2016-07-27 04:40:00,0,0,0,0,0
2016-07-27 04:50:00,0,0,0,0,0
2016-07-27 05:00:00,0,0,0,0,0
2016-07-27 05:10:00,0,0,0,0,0
2016-07-27 05:20:00,0,1,0,1,6
2016-07-27 05:30:00,5,4,6,15,90
2016-07-27 05:40:00,9,14,9,32,192
2016-07-27 05:50:00,17,17,16,50,300
2016-07-27 06:00:00,18,30,22,70,420
2016-07-27 06:10:00,26,39,31,96,576
2016-07-27 06:20:00,45,50,53,148,888
2016-07-27 06:30:00,65,64,85,214,1284
2016-07-27 06:40:00,121,6,130,257,1542
2016-07-27 06:50:00,71,71,137,279,1674
2016-07-27 07:00:00,75,120,103,298,1788
2016-07-27 07:10:00,91,118,98,307,1842
2016-07-27 07:20:00,87,141,138,366,2196
2016-07-27 07:30:00,139,184,140,463,2778
2016-07-27 07:40:00,179,239,136,554,3324
2016-07-27 07:50:00,183,209,206,598,3588
2016-07-27 08:00:00,184,210,202,596,3576
2016-07-27 08:10:00,190,171,215,576,3456
2016-07-27 08:20:00,185,240,180,605,3630
2016-07-27 08:30:00,217,245,230,692,4152
2016-07-27 08:40:00,371,394,389,1154,6924
2016-07-27 08:50:00,378,411,405,1194,7164
2016-07-27 09:00:00,287,321,316,924,5544
2016-07-27 09:10:00,250,284,277,811,4866
2016-07-27 09:20:00,366,388,386,1140,6840
2016-07-27 09:30:00,640,664,662,1966,11796
2016-07-27 09:40:00,603,627,625,1855,11130
2016-07-27 09:50:00,481,506,504,1491,8946
2016-07-27 10:00:00,724,746,739,2209,13254
2016-07-27 10:10:00,922,946,937,2805,16830
2016-07-27 10:20:00,736,761,755,2252,13512
2016-07-27 10:30:00,855,872,870,2597,15582
2016-07-27 10:40:00,837,862,855,2554,15324
2016-07-27 10:50:00,852,877,869,2598,15588
2016-07-27 11:00:00,959,1011,999,2969,17814
2016-07-27 11:10:00,591,631,622,1844,11064
2016-07-27 11:20:00,830,868,850,2548,15288
2016-07-27 11:30:00,700,727,723,2150,12900
2016-07-27 11:40:00,615,641,636,1892,11352
2016-07-27 11:50:00,722,752,745,2219,13314
2016-07-27 12:00:00,691,718,710,2119,12714
2016-07-27 12:10:00,464,488,482,1434,8604
2016-07-27 12:20:00,437,461,454,1352,8112
2016-07-27 12:30:00,589,613,603,1805,10830
2016-07-27 12:40:00,700,721,715,2136,12816
2016-07-27 12:50:00,866,896,883,2645,15870
2016-07-27 13:00:00,412,438,431,1281,7686
2016-07-27 13:10:00,416,433,432,1281,7686
2016-07-27 13:20:00,695,717,705,2117,12702
2016-07-27 13:30:00,455,477,469,1401,8406
2016-07-27 13:40:00,487,507,505,1499,8994
2016-07-27 13:50:00,506,525,521,1552,9312
2016-07-27 14:00:00,448,466,464,1378,8268
2016-07-27 14:10:00,614,636,629,1879,11274
2016-07-27 14:20:00,671,692,687,2050,12300
2016-07-27 14:30:00,813,839,830,2482,14892
2016-07-27 14:40:00,833,860,852,2545,15270
2016-07-27 14:50:00,757,781,776,2314,13884
2016-07-27 15:00:00,772,797,791,2360,14160
2016-07-27 15:10:00,536,562,557,1655,9930
2016-07-27 15:20:00,450,473,468,1391,8346
2016-07-27 15:30:00,745,772,766,2283,13698
2016-07-27 15:40:00,781,820,808,2409,14454
2016-07-27 15:50:00,658,693,684,2035,12210
2016-07-27 16:00:00,458,488,475,1421,8526
2016-07-27 16:10:00,456,481,464,1401,8406
2016-07-27 16:20:00,512,537,524,1573,9438
2016-07-27 16:30:00,390,415,408,1213,7278
2016-07-27 16:40:00,469,499,492,1460,8760
2016-07-27 16:50:00,542,567,566,1675,10050
2016-07-27 17:00:00,416,440,440,1296,7776
2016-07-27 17:10:00,439,463,462,1364,8184
2016-07-27 17:20:00,392,415,413,1220,7320
2016-07-27 17:30:00,234,257,255,746,4476
2016-07-27 17:40:00,198,210,213,621,3726
2016-07-27 17:50:00,124,145,145,414,2484
2016-07-27 18:00:00,97,117,119,333,1998
2016-07-27 18:10:00,69,81,77,227,1362
2016-07-27 18:20:00,98,116,56,270,1620
2016-07-27 18:30:00,68,75,81,224,1344
2016-07-27 18:40:00,78,50,96,224,1344
2016-07-27 18:50:00,48,45,56,149,894
2016-07-27 19:00:00,26,71,28,125,750
2016-07-27 19:10:00,29,23,39,91,546
2016-07-27 19:20:00,6,12,11,29,174
2016-07-27 19:30:00,6,10,10,26,156
2016-07-27 19:40:00,4,5,6,15,90
2016-07-27 19:50:00,2,3,3,8,48
2016-07-27 20:00:00,2,4,2,8,48
2016-07-27 20:10:00,0,0,0,0,0
2016-07-27 20:20:00,0,0,0,0,0
2016-07-27 20:30:00,0,0,0,0,0
2016-07-27 20:40:00,0,0,0,0,0
2016-07-27 20:50:00,0,0,0,0,0
2016-07-27 21:00:00,0,0,0,0,0
2016-07-27 21:10:00,0,0,0,0,0
2016-07-27 21:20:00,0,0,0,0,0
2016-07-27 21:30:00,0,0,0,0,0
2016-07-28 04:40:00,0,0,0,0,0
2016-07-28 04:50:00,0,0,0,0,0
2016-07-28 05:00:00,0,0,0,0,0
2016-07-28 05:10:00,0,0,0,0,0
2016-07-28 05:20:00,1,2,1,4,24
2016-07-28 05:30:00,6,10,8,24,144
2016-07-28 05:40:00,14,16,15,45,270
2016-07-28 05:50:00,19,25,22,66,396
2016-07-28 06:00:00,12,12,20,44,264
2016-07-28 06:10:00,25,32,32,89,534
2016-07-28 06:20:00,18,20,25,63,378
2016-07-28 06:30:00,19,25,26,70,420
2016-07-28 06:40:00,17,34,27,78,468
2016-07-28 06:50:00,16,37,33,86,516
2016-07-28 07:00:00,21,40,34,95,570
2016-07-28 07:10:00,40,42,26,108,648
2016-07-28 07:20:00,32,48,36,116,696
2016-07-28 07:30:00,24,83,22,129,774
2016-07-28 07:40:00,93,186,114,393,2358
2016-07-28 07:50:00,164,169,189,522,3132
2016-07-28 08:00:00,102,129,119,350,2100
2016-07-28 08:10:00,219,243,237,699,4194
2016-07-28 08:20:00,285,303,301,889,5334
2016-07-28 08:30:00,322,344,342,1008,6048
2016-07-28 08:40:00,416,436,436,1288,7728
2016-07-28 08:50:00,386,406,400,1192,7152
2016-07-28 09:00:00,454,474,468,1396,8376
2016-07-28 09:10:00,453,474,468,1395,8370
2016-07-28 09:20:00,550,577,572,1699,10194
2016-07-28 09:30:00,556,578,572,1706,10236
2016-07-28 09:40:00,566,591,582,1739,10434
2016-07-28 09:50:00,122,144,149,415,2490
2016-07-28 10:00:00,618,655,644,1917,11502
2016-07-28 10:10:00,430,456,444,1330,7980
2016-07-28 10:20:00,850,873,858,2581,15486
2016-07-28 10:30:00,932,957,941,2830,16980
2016-07-28 10:40:00,661,685,674,2020,12120
2016-07-28 10:50:00,555,585,575,1715,10290
2016-07-28 11:00:00,514,543,533,1590,9540
2016-07-28 11:10:00,833,858,843,2534,15204
2016-07-28 11:20:00,836,865,861,2562,15372
2016-07-28 11:30:00,708,731,730,2169,13014
2016-07-28 11:40:00,960,996,988,2944,17664
2016-07-28 11:50:00,904,938,935,2777,16662
2016-07-28 12:00:00,1004,1034,1022,3060,18360
2016-07-28 12:10:00,915,943,932,2790,16740
2016-07-28 12:20:00,863,902,883,2648,15888
2016-07-28 12:30:00,1045,1091,1067,3203,19218
2016-07-28 12:40:00,1031,1065,1048,3144,18864
2016-07-28 12:50:00,1033,1069,1049,3151,18906
2016-07-28 13:00:00,1036,1064,1057,3157,18942
2016-07-28 13:10:00,1043,1065,1059,3167,19002
2016-07-28 13:20:00,1020,1055,1041,3116,18696
2016-07-28 13:30:00,1019,1048,1037,3104,18624
2016-07-28 13:40:00,1018,1041,1031,3090,18540
2016-07-28 13:50:00,1016,1037,1029,3082,18492
2016-07-28 14:00:00,1007,1030,1023,3060,18360
2016-07-28 14:10:00,1000,1020,1011,3031,18186
2016-07-28 14:20:00,981,1007,1002,2990,17940
2016-07-28 14:30:00,962,986,983,2931,17586
2016-07-28 14:40:00,941,964,963,2868,17208
2016-07-28 14:50:00,916,943,939,2798,16788
2016-07-28 15:00:00,889,922,915,2726,16356
2016-07-28 15:10:00,857,885,882,2624,15744
2016-07-28 15:20:00,852,874,865,2591,15546
2016-07-28 15:30:00,818,839,830,2487,14922
2016-07-28 15:40:00,760,789,776,2325,13950
2016-07-28 15:50:00,736,762,749,2247,13482
2016-07-28 16:00:00,697,720,707,2124,12744
2016-07-28 16:10:00,653,684,671,2008,12048
2016-07-28 16:20:00,613,647,631,1891,11346
2016-07-28 16:30:00,591,627,614,1832,10992
2016-07-28 16:40:00,553,586,573,1712,10272
2016-07-28 16:50:00,510,540,531,1581,9486
2016-07-28 17:00:00,475,506,499,1480,8880
2016-07-28 17:10:00,423,463,451,1337,8022
2016-07-28 17:20:00,383,413,409,1205,7230
2016-07-28 17:30:00,356,386,379,1121,6726
2016-07-28 17:40:00,264,293,287,844,5064
2016-07-28 17:50:00,249,275,273,797,4782
2016-07-28 18:00:00,285,311,308,904,5424
2016-07-28 18:10:00,192,223,212,627,3762
2016-07-28 18:20:00,152,175,153,480,2880
2016-07-28 18:30:00,79,115,120,314,1884
2016-07-28 18:40:00,52,93,94,239,1434
2016-07-28 18:50:00,68,49,69,186,1116
2016-07-28 19:00:00,26,46,31,103,618
2016-07-28 19:10:00,21,35,31,87,522
2016-07-28 19:20:00,21,25,30,76,456
2016-07-28 19:30:00,26,41,34,101,606
2016-07-28 19:40:00,11,46,33,90,540
2016-07-28 19:50:00,9,46,22,77,462
2016-07-28 20:00:00,11,36,19,66,396
2016-07-28 20:10:00,9,29,19,57,342
2016-07-28 20:20:00,8,20,12,40,240
2016-07-28 20:30:00,4,9,8,21,126
2016-07-28 20:40:00,1,3,3,7,42
2016-07-28 20:50:00,0,0,0,0,0
2016-07-28 21:00:00,0,0,0,0,0
2016-07-28 21:10:00,0,0,0,0,0
2016-07-28 21:20:00,0,0,0,0,0
2016-07-28 21:30:00,0,0,0,0,0
2016-07-29 04:40:00,0,0,0,0,0
2016-07-29 04:50:00,0,0,0,0,0
2016-07-29 05:00:00,0,0,0,0,0
2016-07-29 05:10:00,0,0,0,0,0
2016-07-29 05:20:00,0,0,0,0,0
2016-07-29 05:30:00,0,0,0,0,0
2016-07-29 05:40:00,0,0,0,0,0
2016-07-29 05:50:00,3,3,4,10,60
2016-07-29 06:00:00,9,14,12,35,210
2016-07-29 06:10:00,17,26,25,68,408
2016-07-29 06:20:00,32,50,44,126,756
2016-07-29 06:30:00,33,54,58,145,870
2016-07-29 06:40:00,57,69,75,201,1206
2016-07-29 06:50:00,33,65,55,153,918
2016-07-29 07:00:00,26,54,33,113,678
2016-07-29 07:10:00,48,67,70,185,1110
2016-07-29 07:20:00,76,134,139,349,2094
2016-07-29 07:30:00,75,179,216,470,2820
2016-07-29 07:40:00,164,243,159,566,3396
2016-07-29 07:50:00,215,239,234,688,4128
2016-07-29 08:00:00,194,216,211,621,3726
2016-07-29 08:10:00,122,144,140,406,2436
2016-07-29 08:20:00,60,99,96,255,1530
2016-07-29 08:30:00,91,77,101,269,1614
2016-07-29 08:40:00,40,132,137,309,1854
2016-07-29 08:50:00,148,238,99,485,2910
2016-07-29 09:00:00,112,138,129,379,2274
2016-07-29 09:10:00,138,125,154,417,2502
2016-07-29 09:20:00,17,139,140,296,1776
2016-07-29 09:30:00,37,104,94,235,1410
2016-07-29 09:40:00,52,93,80,225,1350
2016-07-29 09:50:00,25,122,124,271,1626
2016-07-29 10:00:00,65,93,92,250,1500
2016-07-29 10:10:00,132,152,83,367,2202
2016-07-29 10:20:00,180,190,149,519,3114
2016-07-29 10:30:00,307,285,290,882,5292
2016-07-29 10:40:00,248,267,260,775,4650
2016-07-29 10:50:00,221,239,234,694,4164
2016-07-29 11:00:00,195,213,208,616,3696
2016-07-29 11:10:00,196,271,135,602,3612
2016-07-29 11:20:00,271,291,285,847,5082
2016-07-29 11:30:00,141,160,156,457,2742
2016-07-29 11:40:00,281,143,170,594,3564
2016-07-29 11:50:00,304,327,320,951,5706
2016-07-29 12:00:00,197,218,213,628,3768
2016-07-29 12:10:00,50,67,29,146,876
2016-07-29 12:20:00,62,80,31,173,1038
2016-07-29 12:30:00,105,121,79,305,1830
2016-07-29 12:40:00,142,189,172,503,3018
2016-07-29 12:50:00,206,237,260,703,4218
2016-07-29 13:00:00,252,278,273,803,4818
2016-07-29 13:10:00,297,323,316,936,5616
2016-07-29 13:20:00,361,384,377,1122,6732
2016-07-29 13:30:00,495,518,511,1524,9144
2016-07-29 13:40:00,495,513,515,1523,9138
2016-07-29 13:50:00,534,560,553,1647,9882
2016-07-29 14:00:00,666,691,681,2038,12228
2016-07-29 14:10:00,285,308,305,898,5388
2016-07-29 14:20:00,414,438,434,1286,7716
2016-07-29 14:30:00,561,589,581,1731,10386
2016-07-29 14:40:00,781,812,803,2396,14376
2016-07-29 14:50:00,664,693,684,2041,12246
2016-07-29 15:00:00,948,980,968,2896,17376
2016-07-29 15:10:00,660,685,680,2025,12150
2016-07-29 15:20:00,721,751,744,2216,13296
2016-07-29 15:30:00,587,619,610,1816,10896
2016-07-29 15:40:00,580,612,599,1791,10746
2016-07-29 15:50:00,718,750,733,2201,13206
2016-07-29 16:00:00,612,632,626,1870,11220
2016-07-29 16:10:00,597,617,617,1831,10986
2016-07-29 16:20:00,508,534,533,1575,9450
2016-07-29 16:30:00,231,253,250,734,4404
2016-07-29 16:40:00,381,402,399,1182,7092
2016-07-29 16:50:00,302,323,320,945,5670
2016-07-29 17:00:00,198,221,218,637,3822
2016-07-29 17:10:00,265,288,285,838,5028
2016-07-29 17:20:00,401,426,419,1246,7476
2016-07-29 17:30:00,228,253,249,730,4380
2016-07-29 17:40:00,283,313,306,902,5412
2016-07-29 17:50:00,251,276,272,799,4794
2016-07-29 18:00:00,227,253,246,726,4356
2016-07-29 18:10:00,190,217,214,621,3726
2016-07-29 18:20:00,116,84,134,334,2004
2016-07-29 18:30:00,20,71,70,161,966
2016-07-29 18:40:00,45,80,75,200,1200
2016-07-29 18:50:00,29,105,123,257,1542
2016-07-29 19:00:00,56,142,137,335,2010
2016-07-29 19:10:00,67,148,165,380,2280
2016-07-29 19:20:00,31,129,127,287,1722
2016-07-29 19:30:00,40,130,124,294,1764
2016-07-29 19:40:00,77,174,203,454,2724
2016-07-29 19:50:00,126,119,139,384,2304
2016-07-29 20:00:00,33,81,49,163,978
2016-07-29 20:10:00,16,42,16,74,444
2016-07-29 20:20:00,11,30,16,57,342
2016-07-29 20:30:00,6,16,8,30,180
2016-07-29 20:40:00,2,4,2,8,48
2016-07-29 20:50:00,1,1,0,2,12
2016-07-29 21:00:00,0,0,0,0,0
2016-07-29 21:10:00,0,0,0,0,0
2016-07-29 21:20:00,0,0,0,0,0
2016-07-29 21:30:00,0,0,0,0,0
2016-07-30 04:40:00,0,0,0,0,0
2016-07-30 04:50:00,0,0,0,0,0
2016-07-30 05:00:00,0,0,0,0,0
2016-07-30 05:10:00,0,0,0,0,0
2016-07-30 05:20:00,0,0,0,0,0
2016-07-30 05:30:00,1,0,1,2,12
2016-07-30 05:40:00,7,5,5,17,102
2016-07-30 05:50:00,10,10,12,32,192
2016-07-30 06:00:00,10,17,14,41,246
2016-07-30 06:10:00,16,25,19,60,360
2016-07-30 06:20:00,21,23,30,74,444
2016-07-30 06:30:00,22,25,28,75,450
2016-07-30 06:40:00,27,41,34,102,612
2016-07-30 06:50:00,42,63,52,157,942
2016-07-30 07:00:00,41,64,40,145,870
2016-07-30 07:10:00,64,71,69,204,1224
2016-07-30 07:20:00,188,218,197,603,3618
2016-07-30 07:30:00,149,170,166,485,2910
2016-07-30 07:40:00,145,168,126,439,2634
2016-07-30 07:50:00,125,122,127,374,2244
2016-07-30 08:00:00,103,98,127,328,1968
2016-07-30 08:10:00,177,134,165,476,2856
2016-07-30 08:20:00,230,251,246,727,4362
2016-07-30 08:30:00,112,132,128,372,2232
2016-07-30 08:40:00,72,158,164,394,2364
2016-07-30 08:50:00,92,122,75,289,1734
2016-07-30 09:00:00,468,458,461,1387,8322
2016-07-30 09:10:00,133,155,150,438,2628
2016-07-30 09:20:00,224,242,241,707,4242
2016-07-30 09:30:00,44,66,48,158,948
2016-07-30 09:40:00,130,192,161,483,2898
2016-07-30 09:50:00,346,372,365,1083,6498
2016-07-30 10:00:00,393,418,411,1222,7332
2016-07-30 10:10:00,157,180,177,514,3084
2016-07-30 10:20:00,172,204,155,531,3186
2016-07-30 10:30:00,217,240,232,689,4134
2016-07-30 10:40:00,198,235,207,640,3840
2016-07-30 10:50:00,207,231,226,664,3984
2016-07-30 11:00:00,413,445,438,1296,7776
2016-07-30 11:10:00,163,186,181,530,3180
2016-07-30 11:20:00,276,313,303,892,5352
2016-07-30 11:30:00,263,294,290,847,5082
2016-07-30 11:40:00,177,164,248,589,3534
2016-07-30 11:50:00,169,267,91,527,3162
2016-07-30 12:00:00,171,288,121,580,3480
2016-07-30 12:10:00,199,240,259,698,4188
2016-07-30 12:20:00,187,203,206,596,3576
2016-07-30 12:30:00,157,182,177,516,3096
2016-07-30 12:40:00,234,220,230,684,4104
2016-07-30 12:50:00,267,293,287,847,5082
2016-07-30 13:00:00,284,301,303,888,5328
2016-07-30 13:10:00,326,348,342,1016,6096
2016-07-30 13:20:00,757,784,767,2308,13848
2016-07-30 13:30:00,411,437,429,1277,7662
2016-07-30 13:40:00,592,619,614,1825,10950
2016-07-30 13:50:00,1075,1119,1098,3292,19752
2016-07-30 14:00:00,990,1031,1015,3036,18216
2016-07-30 14:10:00,882,907,910,2699,16194
2016-07-30 14:20:00,1016,1045,1035,3096,18576
2016-07-30 14:30:00,621,649,639,1909,11454
2016-07-30 14:40:00,745,778,764,2287,13722
2016-07-30 14:50:00,705,727,721,2153,12918
2016-07-30 15:00:00,386,404,403,1193,7158
2016-07-30 15:10:00,811,830,828,2469,14814
2016-07-30 15:20:00,277,297,295,869,5214
2016-07-30 15:30:00,256,276,275,807,4842
2016-07-30 15:40:00,601,620,619,1840,11040
2016-07-30 15:50:00,364,383,379,1126,6756
2016-07-30 16:00:00,350,370,366,1086,6516
2016-07-30 16:10:00,356,378,372,1106,6636
2016-07-30 16:20:00,182,202,198,582,3492
2016-07-30 16:30:00,34,88,41,163,978
2016-07-30 16:40:00,123,170,151,444,2664
2016-07-30 16:50:00,287,306,297,890,5340
2016-07-30 17:00:00,165,187,183,535,3210
2016-07-30 17:10:00,95,101,87,283,1698
2016-07-30 17:20:00,227,216,205,648,3888
2016-07-30 17:30:00,177,199,195,571,3426
2016-07-30 17:40:00,171,191,229,591,3546
2016-07-30 17:50:00,178,309,21,508,3048
2016-07-30 18:00:00,162,313,27,502,3012
2016-07-30 18:10:00,185,286,67,538,3228
2016-07-30 18:20:00,175,281,61,517,3102
2016-07-30 18:30:00,110,140,125,375,2250
2016-07-30 18:40:00,90,129,116,335,2010
2016-07-30 18:50:00,75,146,127,348,2088
2016-07-30 19:00:00,60,114,107,281,1686
2016-07-30 19:10:00,60,68,80,208,1248
2016-07-30 19:20:00,64,47,81,192,1152
2016-07-30 19:30:00,82,79,83,244,1464
2016-07-30 19:40:00,61,83,72,216,1296
2016-07-30 19:50:00,52,58,53,163,978
2016-07-30 20:00:00,23,76,23,122,732
2016-07-30 20:10:00,10,63,12,85,510
2016-07-30 20:20:00,23,27,28,78,468
2016-07-30 20:30:00,14,12,20,46,276
2016-07-30 20:40:00,7,15,9,31,186
2016-07-30 20:50:00,4,5,5,14,84
2016-07-30 21:00:00,1,2,1,4,24
2016-07-30 21:10:00,0,0,0,0,0
2016-07-30 21:20:00,0,0,0,0,0
2016-07-30 21:30:00,0,0,0,0,0
2016-07-31 04:40:00,0,0,0,0,0
2016-07-31 04:50:00,0,0,0,0,0
2016-07-31 05:00:00,0,0,0,0,0
2016-07-31 05:10:00,0,0,0,0,0
2016-07-31 05:20:00,0,0,0,0,0
2016-07-31 05:30:00,2,2,2,6,36
2016-07-31 05:40:00,8,5,2,15,90
2016-07-31 05:50:00,7,9,7,23,138
2016-07-31 06:00:00,14,8,10,32,192
2016-07-31 06:10:00,12,17,13,42,252
2016-07-31 06:20:00,15,19,20,54,324
2016-07-31 06:30:00,18,21,25,64,384
2016-07-31 06:40:00,17,31,27,75,450
2016-07-31 06:50:00,22,34,28,84,504
2016-07-31 07:00:00,25,39,29,93,558
2016-07-31 07:10:00,22,45,34,101,606
2016-07-31 07:20:00,38,39,35,112,672
2016-07-31 07:30:00,16,98,12,126,756
2016-07-31 07:40:00,49,134,133,316,1896
2016-07-31 07:50:00,82,218,186,486,2916
2016-07-31 08:00:00,191,210,207,608,3648
2016-07-31 08:10:00,236,315,194,745,4470
2016-07-31 08:20:00,290,315,309,914,5484
2016-07-31 08:30:00,322,348,343,1013,6078
2016-07-31 08:40:00,311,330,328,969,5814
2016-07-31 08:50:00,290,313,307,910,5460
2016-07-31 09:00:00,316,339,330,985,5910
2016-07-31 09:10:00,446,468,463,1377,8262
2016-07-31 09:20:00,577,605,597,1779,10674
2016-07-31 09:30:00,627,651,642,1920,11520
2016-07-31 09:40:00,602,631,618,1851,11106
2016-07-31 09:50:00,685,713,707,2105,12630
2016-07-31 10:00:00,766,788,777,2331,13986
2016-07-31 10:10:00,621,648,636,1905,11430
2016-07-31 10:20:00,753,781,767,2301,13806
2016-07-31 10:30:00,655,681,674,2010,12060
2016-07-31 10:40:00,778,802,795,2375,14250
2016-07-31 10:50:00,687,714,705,2106,12636
2016-07-31 11:00:00,631,652,648,1931,11586
2016-07-31 11:10:00,641,676,668,1985,11910
2016-07-31 11:20:00,754,782,774,2310,13860
2016-07-31 11:30:00,494,518,513,1525,9150
2016-07-31 11:40:00,450,473,468,1391,8346
2016-07-31 11:50:00,397,421,416,1234,7404
2016-07-31 12:00:00,354,378,373,1105,6630
2016-07-31 12:10:00,542,569,563,1674,10044
2016-07-31 12:20:00,825,850,846,2521,15126
2016-07-31 12:30:00,245,265,262,772,4632
2016-07-31 12:40:00,247,266,262,775,4650
2016-07-31 12:50:00,682,709,699,2090,12540
2016-07-31 13:00:00,711,735,722,2168,13008
2016-07-31 13:10:00,448,477,470,1395,8370
2016-07-31 13:20:00,463,488,481,1432,8592
2016-07-31 13:30:00,589,616,608,1813,10878
2016-07-31 13:40:00,601,626,613,1840,11040
2016-07-31 13:50:00,424,446,437,1307,7842
2016-07-31 14:00:00,449,474,463,1386,8316
2016-07-31 14:10:00,630,652,651,1933,11598
2016-07-31 14:20:00,605,631,626,1862,11172
2016-07-31 14:30:00,164,188,183,535,3210
2016-07-31 14:40:00,161,184,179,524,3144
2016-07-31 14:50:00,292,316,310,918,5508
2016-07-31 15:00:00,810,842,828,2480,14880
2016-07-31 15:10:00,411,439,430,1280,7680
2016-07-31 15:20:00,347,372,366,1085,6510
2016-07-31 15:30:00,589,615,610,1814,10884
2016-07-31 15:40:00,706,735,724,2165,12990
2016-07-31 15:50:00,754,785,773,2312,13872
2016-07-31 16:00:00,698,730,720,2148,12888
2016-07-31 16:10:00,683,711,701,2095,12570
2016-07-31 16:20:00,630,658,646,1934,11604
2016-07-31 16:30:00,611,638,630,1879,11274
2016-07-31 16:40:00,608,641,628,1877,11262
2016-07-31 16:50:00,256,281,273,810,4860
2016-07-31 17:00:00,106,128,123,357,2142
2016-07-31 17:10:00,101,130,128,359,2154
2016-07-31 17:20:00,52,85,67,204,1224
2016-07-31 17:30:00,27,50,31,108,648
2016-07-31 17:40:00,63,75,94,232,1392
2016-07-31 17:50:00,309,342,328,979,5874
2016-07-31 18:00:00,237,264,257,758,4548
2016-07-31 18:10:00,161,203,194,558,3348
2016-07-31 18:20:00,126,139,166,431,2586
2016-07-31 18:30:00,81,99,117,297,1782
2016-07-31 18:40:00,92,155,165,412,2472
2016-07-31 18:50:00,45,59,72,176,1056
2016-07-31 19:00:00,22,36,33,91,546
2016-07-31 19:10:00,17,22,26,65,390
2016-07-31 19:20:00,21,18,33,72,432
2016-07-31 19:30:00,20,32,29,81,486
2016-07-31 19:40:00,28,47,35,110,660
2016-07-31 19:50:00,14,48,31,93,558
2016-07-31 20:00:00,21,44,29,94,564
2016-07-31 20:10:00,15,27,20,62,372
2016-07-31 20:20:00,6,13,8,27,162
2016-07-31 20:30:00,5,13,6,24,144
2016-07-31 20:40:00,4,6,3,13,78
2016-07-31 20:50:00,2,2,2,6,36
2016-07-31 21:00:00,0,0,0,0,0
2016-07-31 21:10:00,0,0,0,0,0
2016-07-31 21:20:00,0,0,0,0,0
2016-07-31 21:30:00,0,0,0,0,0
2016-08-01 04:50:00,0,0,0,0,0
2016-08-01 05:00:00,0,0,0,0,0
2016-08-01 05:10:00,0,0,0,0,0
2016-08-01 05:20:00,2,4,2,8,48
2016-08-01 05:30:00,3,5,4,12,72
2016-08-01 05:40:00,15,19,16,50,300
2016-08-01 05:50:00,16,16,19,51,306
2016-08-01 06:00:00,17,22,24,63,378
2016-08-01 06:10:00,31,44,37,112,672
2016-08-01 06:20:00,50,75,67,192,1152
2016-08-01 06:30:00,31,74,42,147,882
2016-08-01 06:40:00,29,81,44,154,924
2016-08-01 06:50:00,77,88,98,263,1578
2016-08-01 07:00:00,87,124,102,313,1878
2016-08-01 07:10:00,89,128,104,321,1926
2016-08-01 07:20:00,78,120,99,297,1782
2016-08-01 07:30:00,113,226,73,412,2472
2016-08-01 07:40:00,110,180,110,400,2400
2016-08-01 07:50:00,148,177,100,425,2550
2016-08-01 08:00:00,177,245,88,510,3060
2016-08-01 08:10:00,194,305,26,525,3150
2016-08-01 08:20:00,208,175,180,563,3378
2016-08-01 08:30:00,261,190,214,665,3990
2016-08-01 08:40:00,230,251,248,729,4374
2016-08-01 08:50:00,174,195,193,562,3372
2016-08-01 09:00:00,219,239,238,696,4176
2016-08-01 09:10:00,349,371,367,1087,6522
2016-08-01 09:20:00,592,614,607,1813,10878
2016-08-01 09:30:00,524,545,540,1609,9654
2016-08-01 09:40:00,712,732,727,2171,13026
2016-08-01 09:50:00,620,643,638,1901,11406
2016-08-01 10:00:00,603,626,621,1850,11100
2016-08-01 10:10:00,761,787,781,2329,13974
2016-08-01 10:20:00,880,902,897,2679,16074
2016-08-01 10:30:00,661,683,681,2025,12150
2016-08-01 10:40:00,231,254,250,735,4410
2016-08-01 10:50:00,706,729,720,2155,12930
2016-08-01 11:00:00,861,882,874,2617,15702
2016-08-01 11:10:00,1007,1021,1019,3047,18282
2016-08-01 11:20:00,784,803,797,2384,14304
2016-08-01 11:30:00,149,172,169,490,2940
2016-08-01 11:40:00,546,571,567,1684,10104
2016-08-01 11:50:00,822,851,840,2513,15078
2016-08-01 12:00:00,1079,1108,1096,3283,19698
2016-08-01 12:10:00,1081,1108,1097,3286,19716
2016-08-01 12:20:00,989,1023,1010,3022,18132
2016-08-01 12:30:00,809,839,828,2476,14856
2016-08-01 12:40:00,1008,1038,1025,3071,18426
2016-08-01 12:50:00,774,796,790,2360,14160
2016-08-01 13:00:00,957,984,978,2919,17514
2016-08-01 13:10:00,725,751,745,2221,13326
2016-08-01 13:20:00,446,470,463,1379,8274
2016-08-01 13:30:00,89,110,107,306,1836
2016-08-01 13:40:00,65,98,89,252,1512
2016-08-01 13:50:00,66,126,120,312,1872
2016-08-01 14:00:00,533,556,546,1635,9810
2016-08-01 14:10:00,1096,1129,1114,3339,20034
2016-08-01 14:20:00,306,329,323,958,5748
2016-08-01 14:30:00,44,85,60,189,1134
2016-08-01 14:40:00,822,850,835,2507,15042
2016-08-01 14:50:00,969,995,977,2941,17646
2016-08-01 15:00:00,513,540,530,1583,9498
2016-08-01 15:10:00,619,642,634,1895,11370
2016-08-01 15:20:00,149,189,169,507,3042
2016-08-01 15:30:00,390,418,411,1219,7314
2016-08-01 15:40:00,452,482,473,1407,8442
2016-08-01 15:50:00,291,321,313,925,5550
2016-08-01 16:00:00,387,413,406,1206,7236
2016-08-01 16:10:00,241,267,263,771,4626
2016-08-01 16:20:00,433,461,454,1348,8088
2016-08-01 16:30:00,168,193,187,548,3288
2016-08-01 16:40:00,404,432,424,1260,7560
2016-08-01 16:50:00,306,334,329,969,5814
2016-08-01 17:00:00,259,289,282,830,4980
2016-08-01 17:10:00,374,404,393,1171,7026
2016-08-01 17:20:00,408,436,424,1268,7608
2016-08-01 17:30:00,340,368,359,1067,6402
2016-08-01 17:40:00,289,317,306,912,5472
2016-08-01 17:50:00,191,216,210,617,3702
2016-08-01 18:00:00,199,223,215,637,3822
2016-08-01 18:10:00,162,187,180,529,3174
2016-08-01 18:20:00,119,134,139,392,2352
2016-08-01 18:30:00,72,70,84,226,1356
2016-08-01 18:40:00,75,63,88,226,1356
2016-08-01 18:50:00,90,37,107,234,1404
2016-08-01 19:00:00,76,44,92,212,1272
2016-08-01 19:10:00,41,61,41,143,858
2016-08-01 19:20:00,34,48,36,118,708
2016-08-01 19:30:00,30,51,38,119,714
2016-08-01 19:40:00,33,52,43,128,768
2016-08-01 19:50:00,18,36,21,75,450
2016-08-01 20:00:00,18,21,26,65,390
2016-08-01 20:10:00,14,23,17,54,324
2016-08-01 20:20:00,8,14,12,34,204
2016-08-01 20:30:00,5,8,8,21,126
2016-08-01 20:40:00,4,4,5,13,78
2016-08-01 20:50:00,1,1,1,3,18
2016-08-01 21:00:00,0,0,0,0,0
2016-08-01 21:10:00,0,0,0,0,0
2016-08-01 21:20:00,0,0,0,0,0
2016-08-01 21:30:00,0,0,0,0,0
2016-08-02 04:40:00,0,0,0,0,0
2016-08-02 04:50:00,0,0,0,0,0
2016-08-02 05:00:00,0,0,0,0,0
2016-08-02 05:10:00,0,0,0,0,0
2016-08-02 05:20:00,0,0,0,0,0
2016-08-02 05:30:00,1,0,1,2,12
2016-08-02 05:40:00,3,10,4,17,102
2016-08-02 05:50:00,12,12,14,38,228
2016-08-02 06:00:00,15,25,24,64,384
2016-08-02 06:10:00,26,64,36,126,756
2016-08-02 06:20:00,43,57,53,153,918
2016-08-02 06:30:00,57,42,64,163,978
2016-08-02 06:40:00,61,71,78,210,1260
2016-08-02 06:50:00,60,73,78,211,1266
2016-08-02 07:00:00,70,86,77,233,1398
2016-08-02 07:10:00,116,28,120,264,1584
2016-08-02 07:20:00,49,107,111,267,1602
2016-08-02 07:30:00,33,126,136,295,1770
2016-08-02 07:40:00,86,108,103,297,1782
2016-08-02 07:50:00,82,72,114,268,1608
2016-08-02 08:00:00,138,196,134,468,2808
2016-08-02 08:10:00,284,310,295,889,5334
2016-08-02 08:20:00,187,211,204,602,3612
2016-08-02 08:30:00,184,208,202,594,3564
2016-08-02 08:40:00,143,165,161,469,2814
2016-08-02 08:50:00,97,123,122,342,2052
2016-08-02 09:00:00,372,384,387,1143,6858
2016-08-02 09:10:00,572,601,590,1763,10578
2016-08-02 09:20:00,237,261,255,753,4518
2016-08-02 09:30:00,224,247,244,715,4290
2016-08-02 09:40:00,131,111,139,381,2286
2016-08-02 09:50:00,172,167,153,492,2952
2016-08-02 10:00:00,167,205,116,488,2928
2016-08-02 10:10:00,262,287,280,829,4974
2016-08-02 10:20:00,444,471,464,1379,8274
2016-08-02 10:30:00,494,520,513,1527,9162
2016-08-02 10:40:00,365,364,367,1096,6576
2016-08-02 10:50:00,541,555,554,1650,9900
2016-08-02 11:00:00,425,445,442,1312,7872
2016-08-02 11:10:00,795,815,808,2418,14508
2016-08-02 11:20:00,492,509,508,1509,9054
2016-08-02 11:30:00,1146,1179,1171,3496,20976
2016-08-02 11:40:00,562,593,584,1739,10434
2016-08-02 11:50:00,924,950,943,2817,16902
2016-08-02 12:00:00,915,938,929,2782,16692
2016-08-02 12:10:00,1036,1064,1053,3153,18918
2016-08-02 12:20:00,1080,1099,1094,3273,19638
2016-08-02 12:30:00,1102,1127,1108,3337,20022
2016-08-02 12:40:00,1037,1072,1053,3162,18972
2016-08-02 12:50:00,1043,1077,1068,3188,19128
2016-08-02 13:00:00,1063,1082,1079,3224,19344
2016-08-02 13:10:00,1056,1069,1074,3199,19194
2016-08-02 13:20:00,1050,1069,1047,3166,18996
2016-08-02 13:30:00,1013,1033,1011,3057,18342
2016-08-02 13:40:00,1064,1084,1072,3220,19320
2016-08-02 13:50:00,1047,1067,1052,3166,18996
2016-08-02 14:00:00,1046,1044,1027,3117,18702
2016-08-02 14:10:00,1040,1037,1010,3087,18522
2016-08-02 14:20:00,1029,1025,996,3050,18300
2016-08-02 14:30:00,1013,1003,977,2993,17958
2016-08-02 14:40:00,1001,980,967,2948,17688
2016-08-02 14:50:00,981,965,962,2908,17448
2016-08-02 15:00:00,959,949,937,2845,17070
2016-08-02 15:10:00,970,980,971,2921,17526
2016-08-02 15:20:00,902,915,908,2725,16350
2016-08-02 15:30:00,523,536,529,1588,9528
2016-08-02 15:40:00,673,701,690,2064,12384
2016-08-02 15:50:00,370,394,389,1153,6918
2016-08-02 16:00:00,820,845,837,2502,15012
2016-08-02 16:10:00,748,781,774,2303,13818
2016-08-02 16:20:00,668,687,687,2042,12252
2016-08-02 16:30:00,625,643,639,1907,11442
2016-08-02 16:40:00,576,597,593,1766,10596
2016-08-02 16:50:00,539,562,556,1657,9942
2016-08-02 17:00:00,522,547,542,1611,9666
2016-08-02 17:10:00,479,503,496,1478,8868
2016-08-02 17:20:00,432,455,447,1334,8004
2016-08-02 17:30:00,384,405,397,1186,7116
2016-08-02 17:40:00,332,355,346,1033,6198
2016-08-02 17:50:00,292,318,310,920,5520
2016-08-02 18:00:00,258,281,277,816,4896
2016-08-02 18:10:00,208,231,227,666,3996
2016-08-02 18:20:00,158,182,178,518,3108
2016-08-02 18:30:00,117,139,134,390,2340
2016-08-02 18:40:00,77,105,104,286,1716
2016-08-02 18:50:00,72,73,79,224,1344
2016-08-02 19:00:00,41,56,39,136,816
2016-08-02 19:10:00,30,49,28,107,642
2016-08-02 19:20:00,29,50,20,99,594
2016-08-02 19:30:00,29,46,14,89,534
2016-08-02 19:40:00,24,36,21,81,486
2016-08-02 19:50:00,22,31,20,73,438
2016-08-02 20:00:00,12,33,19,64,384
2016-08-02 20:10:00,10,26,17,53,318
2016-08-02 20:20:00,11,19,12,42,252
2016-08-02 20:30:00,7,13,7,27,162
2016-08-02 20:40:00,5,8,4,17,102
2016-08-02 20:50:00,1,2,1,4,24
2016-08-02 21:00:00,0,0,0,0,0
2016-08-02 21:10:00,0,0,0,0,0
2016-08-02 21:20:00,0,0,0,0,0
2016-08-02 21:30:00,0,0,0,0,0
2016-08-03 04:50:00,0,0,0,0,0
2016-08-03 05:00:00,0,0,0,0,0
2016-08-03 05:10:00,0,0,0,0,0
2016-08-03 05:20:00,0,0,0,0,0
2016-08-03 05:30:00,3,4,4,11,66
2016-08-03 05:40:00,8,14,10,32,192
2016-08-03 05:50:00,21,25,25,71,426
2016-08-03 06:00:00,29,43,35,107,642
2016-08-03 06:10:00,32,64,43,139,834
2016-08-03 06:20:00,56,43,72,171,1026
2016-08-03 06:30:00,77,74,89,240,1440
2016-08-03 06:40:00,80,124,100,304,1824
2016-08-03 06:50:00,90,121,109,320,1920
2016-08-03 07:00:00,92,123,106,321,1926
2016-08-03 07:10:00,72,117,106,295,1770
2016-08-03 07:20:00,73,120,116,309,1854
2016-08-03 07:30:00,87,145,166,398,2388
2016-08-03 07:40:00,53,153,288,494,2964
2016-08-03 07:50:00,132,258,140,530,3180
2016-08-03 08:00:00,165,331,0,496,2976
2016-08-03 08:10:00,179,279,103,561,3366
2016-08-03 08:20:00,183,205,205,593,3558
2016-08-03 08:30:00,213,235,234,682,4092
2016-08-03 08:40:00,213,135,180,528,3168
2016-08-03 08:50:00,130,116,151,397,2382
2016-08-03 09:00:00,81,79,91,251,1506
2016-08-03 09:10:00,96,84,105,285,1710
2016-08-03 09:20:00,103,116,100,319,1914
2016-08-03 09:30:00,101,85,112,298,1788
2016-08-03 09:40:00,76,126,111,313,1878
2016-08-03 09:50:00,142,182,119,443,2658
2016-08-03 10:00:00,261,163,202,626,3756
2016-08-03 10:10:00,207,232,229,668,4008
2016-08-03 10:20:00,88,99,106,293,1758
2016-08-03 10:30:00,156,183,164,503,3018
2016-08-03 10:40:00,166,175,134,475,2850
2016-08-03 10:50:00,181,187,199,567,3402
2016-08-03 11:00:00,158,157,116,431,2586
2016-08-03 11:10:00,100,154,85,339,2034
2016-08-03 11:20:00,143,152,131,426,2556
2016-08-03 11:30:00,53,92,74,219,1314
2016-08-03 11:40:00,41,79,49,169,1014
2016-08-03 11:50:00,94,92,105,291,1746
2016-08-03 12:00:00,56,64,64,184,1104
2016-08-03 12:10:00,76,97,80,253,1518
2016-08-03 12:20:00,62,85,71,218,1308
2016-08-03 12:30:00,54,65,48,167,1002
2016-08-03 12:40:00,40,56,38,134,804
2016-08-03 12:50:00,53,51,45,149,894
2016-08-03 13:00:00,90,87,89,266,1596
2016-08-03 13:10:00,154,148,93,395,2370
2016-08-03 13:20:00,162,167,176,505,3030
2016-08-03 13:30:00,171,175,181,527,3162
2016-08-03 13:40:00,228,173,152,553,3318
2016-08-03 13:50:00,257,276,276,809,4854
2016-08-03 14:00:00,198,218,215,631,3786
2016-08-03 14:10:00,122,143,140,405,2430
2016-08-03 14:20:00,130,130,135,395,2370
2016-08-03 14:30:00,145,163,160,468,2808
2016-08-03 14:40:00,73,94,87,254,1524
2016-08-03 14:50:00,69,92,80,241,1446
2016-08-03 15:00:00,38,53,34,125,750
2016-08-03 15:10:00,60,53,65,178,1068
2016-08-03 15:20:00,22,20,27,69,414
2016-08-03 15:30:00,18,12,22,52,312
2016-08-03 15:40:00,27,59,27,113,678
2016-08-03 15:50:00,82,81,100,263,1578
2016-08-03 16:00:00,47,62,71,180,1080
2016-08-03 16:10:00,76,56,86,218,1308
2016-08-03 16:20:00,38,87,82,207,1242
2016-08-03 16:30:00,66,71,81,218,1308
2016-08-03 16:40:00,65,87,83,235,1410
2016-08-03 16:50:00,158,135,120,413,2478
2016-08-03 17:00:00,58,125,115,298,1788
2016-08-03 17:10:00,168,196,162,526,3156
2016-08-03 17:20:00,204,228,224,656,3936
2016-08-03 17:30:00,145,168,161,474,2844
2016-08-03 17:40:00,87,101,107,295,1770
2016-08-03 17:50:00,142,119,140,401,2406
2016-08-03 18:00:00,135,199,105,439,2634
2016-08-03 18:10:00,118,116,60,294,1764
2016-08-03 18:20:00,126,111,97,334,2004
2016-08-03 18:30:00,104,132,104,340,2040
2016-08-03 18:40:00,102,132,114,348,2088
2016-08-03 18:50:00,194,165,124,483,2898
2016-08-03 19:00:00,146,149,81,376,2256
2016-08-03 19:10:00,126,122,137,385,2310
2016-08-03 19:20:00,87,119,105,311,1866
2016-08-03 19:30:00,89,54,96,239,1434
2016-08-03 19:40:00,49,104,93,246,1476
2016-08-03 19:50:00,65,89,51,205,1230
2016-08-03 20:00:00,48,60,43,151,906
2016-08-03 20:10:00,40,61,34,135,810
2016-08-03 20:20:00,34,45,9,88,528
2016-08-03 20:30:00,17,19,13,49,294
2016-08-03 20:40:00,10,11,11,32,192
2016-08-03 20:50:00,5,7,6,18,108
2016-08-03 21:00:00,1,2,1,4,24
2016-08-03 21:10:00,0,0,0,0,0
2016-08-03 21:20:00,0,0,0,0,0
2016-08-04 04:50:00,0,0,0,0,0
2016-08-04 05:00:00,0,0,0,0,0
2016-08-04 05:10:00,0,0,0,0,0
2016-08-04 05:20:00,0,0,0,0,0
2016-08-04 05:30:00,2,1,2,5,30
2016-08-04 05:40:00,8,10,9,27,162
2016-08-04 05:50:00,17,18,21,56,336
2016-08-04 06:00:00,23,24,27,74,444
2016-08-04 06:10:00,21,19,31,71,426
2016-08-04 06:20:00,23,18,32,73,438
2016-08-04 06:30:00,31,36,35,102,612
2016-08-04 06:40:00,39,55,45,139,834
2016-08-04 06:50:00,39,56,53,148,888
2016-08-04 07:00:00,40,58,59,157,942
2016-08-04 07:10:00,81,131,137,349,2094
2016-08-04 07:20:00,106,79,140,325,1950
2016-08-04 07:30:00,106,56,120,282,1692
2016-08-04 07:40:00,51,62,77,190,1140
2016-08-04 07:50:00,69,38,82,189,1134
2016-08-04 08:00:00,108,55,117,280,1680
2016-08-04 08:10:00,179,216,204,599,3594
2016-08-04 08:20:00,249,278,272,799,4794
2016-08-04 08:30:00,260,290,281,831,4986
2016-08-04 08:40:00,285,306,307,898,5388
2016-08-04 08:50:00,417,443,438,1298,7788
2016-08-04 09:00:00,472,495,493,1460,8760
2016-08-04 09:10:00,322,331,327,980,5880
2016-08-04 09:20:00,322,329,326,977,5862
2016-08-04 09:30:00,245,258,256,759,4554
2016-08-04 09:40:00,333,343,335,1011,6066
2016-08-04 09:50:00,748,745,735,2228,13368
2016-08-04 10:00:00,758,760,744,2262,13572
2016-08-04 10:10:00,800,812,797,2409,14454
2016-08-04 10:20:00,833,855,848,2536,15216
2016-08-04 10:30:00,795,803,792,2390,14340
2016-08-04 10:40:00,907,906,885,2698,16188
2016-08-04 10:50:00,940,938,926,2804,16824
2016-08-04 11:00:00,243,257,260,760,4560
2016-08-04 11:10:00,672,685,688,2045,12270
2016-08-04 11:20:00,479,499,492,1470,8820
2016-08-04 11:30:00,670,685,679,2034,12204
2016-08-04 11:40:00,1095,1114,1098,3307,19842
2016-08-04 11:50:00,830,854,848,2532,15192
2016-08-04 12:00:00,376,397,391,1164,6984
2016-08-04 12:10:00,100,108,103,311,1866
2016-08-04 12:20:00,146,175,177,498,2988
2016-08-04 12:30:00,562,590,584,1736,10416
2016-08-04 12:40:00,965,993,983,2941,17646
2016-08-04 12:50:00,571,598,589,1758,10548
2016-08-04 13:00:00,359,382,379,1120,6720
2016-08-04 13:10:00,522,543,544,1609,9654
2016-08-04 13:20:00,208,195,90,493,2958
2016-08-04 13:30:00,301,320,315,936,5616
2016-08-04 13:40:00,601,623,621,1845,11070
2016-08-04 13:50:00,1012,1032,1023,3067,18402
2016-08-04 14:00:00,921,940,929,2790,16740
2016-08-04 14:10:00,210,231,228,669,4014
2016-08-04 14:20:00,427,450,448,1325,7950
2016-08-04 14:30:00,682,708,699,2089,12534
2016-08-04 14:40:00,305,327,319,951,5706
2016-08-04 14:50:00,174,196,192,562,3372
2016-08-04 15:00:00,319,343,339,1001,6006
2016-08-04 15:10:00,531,555,546,1632,9792
2016-08-04 15:20:00,283,305,302,890,5340
2016-08-04 15:30:00,258,279,276,813,4878
2016-08-04 15:40:00,277,298,295,870,5220
2016-08-04 15:50:00,484,559,502,1545,9270
2016-08-04 16:00:00,231,284,236,751,4506
2016-08-04 16:10:00,222,271,212,705,4230
2016-08-04 16:20:00,334,354,356,1044,6264
2016-08-04 16:30:00,297,319,321,937,5622
2016-08-04 16:40:00,150,132,156,438,2628
2016-08-04 16:50:00,117,80,138,335,2010
2016-08-04 17:00:00,91,107,187,385,2310
2016-08-04 17:10:00,315,346,331,992,5952
2016-08-04 17:20:00,289,293,320,902,5412
2016-08-04 17:30:00,453,483,474,1410,8460
2016-08-04 17:40:00,376,405,398,1179,7074
2016-08-04 17:50:00,234,259,254,747,4482
2016-08-04 18:00:00,135,162,157,454,2724
2016-08-04 18:10:00,212,238,232,682,4092
2016-08-04 18:20:00,138,171,121,430,2580
2016-08-04 18:30:00,192,220,214,626,3756
2016-08-04 18:40:00,64,130,149,343,2058
2016-08-04 18:50:00,60,73,70,203,1218
2016-08-04 19:00:00,96,58,106,260,1560
2016-08-04 19:10:00,62,74,75,211,1266
2016-08-04 19:20:00,41,61,50,152,912
2016-08-04 19:30:00,20,51,30,101,606
2016-08-04 19:40:00,19,32,29,80,480
2016-08-04 19:50:00,13,35,28,76,456
2016-08-04 20:00:00,13,30,20,63,378
2016-08-04 20:10:00,13,22,20,55,330
2016-08-04 20:20:00,6,21,10,37,222
2016-08-04 20:30:00,6,13,5,24,144
2016-08-04 20:40:00,3,4,2,9,54
2016-08-04 20:50:00,0,0,0,0,0
2016-08-04 21:00:00,0,0,0,0,0
2016-08-04 21:10:00,0,0,0,0,0
2016-08-04 21:20:00,0,0,0,0,0
2016-08-05 05:00:00,0,0,0,0,0
2016-08-05 05:10:00,0,0,0,0,0
2016-08-05 05:20:00,0,0,0,0,0
2016-08-05 05:30:00,0,0,0,0,0
2016-08-05 05:40:00,1,0,0,1,6
2016-08-05 05:50:00,4,5,2,11,66
2016-08-05 06:00:00,6,8,6,20,120
2016-08-05 06:10:00,8,11,9,28,168
2016-08-05 06:20:00,9,13,8,30,180
2016-08-05 06:30:00,11,20,16,47,282
2016-08-05 06:40:00,19,32,24,75,450
2016-08-05 06:50:00,27,46,35,108,648
2016-08-05 07:00:00,35,55,39,129,774
2016-08-05 07:10:00,33,57,43,133,798
2016-08-05 07:20:00,50,59,75,184,1104
2016-08-05 07:30:00,84,103,104,291,1746
2016-08-05 07:40:00,86,115,113,314,1884
2016-08-05 07:50:00,105,128,121,354,2124
2016-08-05 08:00:00,51,75,67,193,1158
2016-08-05 08:10:00,152,193,165,510,3060
2016-08-05 08:20:00,210,238,233,681,4086
2016-08-05 08:30:00,279,301,298,878,5268
2016-08-05 08:40:00,252,274,272,798,4788
2016-08-05 08:50:00,319,341,339,999,5994
2016-08-05 09:00:00,310,331,329,970,5820
2016-08-05 09:10:00,403,424,422,1249,7494
2016-08-05 09:20:00,526,541,541,1608,9648
2016-08-05 09:30:00,346,363,365,1074,6444
2016-08-05 09:40:00,493,510,508,1511,9066
2016-08-05 09:50:00,598,617,616,1831,10986
2016-08-05 10:00:00,591,609,611,1811,10866
2016-08-05 10:10:00,444,466,463,1373,8238
2016-08-05 10:20:00,428,450,448,1326,7956
2016-08-05 10:30:00,523,545,540,1608,9648
2016-08-05 10:40:00,493,513,511,1517,9102
2016-08-05 10:50:00,514,535,534,1583,9498
2016-08-05 11:00:00,689,713,708,2110,12660
2016-08-05 11:10:00,718,723,710,2151,12906
2016-08-05 11:20:00,718,719,706,2143,12858
2016-08-05 11:30:00,490,492,483,1465,8790
2016-08-05 11:40:00,446,465,461,1372,8232
2016-08-05 11:50:00,287,307,303,897,5382
2016-08-05 12:00:00,337,359,355,1051,6306
2016-08-05 12:10:00,203,224,221,648,3888
2016-08-05 12:20:00,359,380,376,1115,6690
2016-08-05 12:30:00,468,497,491,1456,8736
2016-08-05 12:40:00,346,372,367,1085,6510
2016-08-05 12:50:00,840,870,861,2571,15426
2016-08-05 13:00:00,851,883,871,2605,15630
2016-08-05 13:10:00,913,945,940,2798,16788
2016-08-05 13:20:00,883,908,902,2693,16158
2016-08-05 13:30:00,762,785,772,2319,13914
2016-08-05 13:40:00,1074,1104,1096,3274,19644
2016-08-05 13:50:00,1045,1077,1067,3189,19134
2016-08-05 14:00:00,1034,1058,1054,3146,18876
2016-08-05 14:10:00,1019,1049,1044,3112,18672
2016-08-05 14:20:00,1023,1056,1050,3129,18774
2016-08-05 14:30:00,1002,1031,1017,3050,18300
2016-08-05 14:40:00,736,757,746,2239,13434
2016-08-05 14:50:00,582,606,602,1790,10740
2016-08-05 15:00:00,319,341,337,997,5982
2016-08-05 15:10:00,675,703,696,2074,12444
2016-08-05 15:20:00,795,823,818,2436,14616
2016-08-05 15:30:00,834,858,852,2544,15264
2016-08-05 15:40:00,785,807,804,2396,14376
2016-08-05 15:50:00,759,776,770,2305,13830
2016-08-05 16:00:00,682,701,698,2081,12486
2016-08-05 16:10:00,686,708,702,2096,12576
2016-08-05 16:20:00,431,419,358,1208,7248
2016-08-05 16:30:00,396,378,375,1149,6894
2016-08-05 16:40:00,372,393,390,1155,6930
2016-08-05 16:50:00,315,337,335,987,5922
2016-08-05 17:00:00,274,295,293,862,5172
2016-08-05 17:10:00,223,244,240,707,4242
2016-08-05 17:20:00,284,304,302,890,5340
2016-08-05 17:30:00,172,192,190,554,3324
2016-08-05 17:40:00,138,203,86,427,2562
2016-08-05 17:50:00,136,137,117,390,2340
2016-08-05 18:00:00,32,192,240,464,2784
2016-08-05 18:10:00,148,175,118,441,2646
2016-08-05 18:20:00,99,123,119,341,2046
2016-08-05 18:30:00,111,123,141,375,2250
2016-08-05 18:40:00,137,173,182,492,2952
2016-08-05 18:50:00,120,118,140,378,2268
2016-08-05 19:00:00,66,58,72,196,1176
2016-08-05 19:10:00,72,11,77,160,960
2016-08-05 19:20:00,31,47,36,114,684
2016-08-05 19:30:00,26,28,35,89,534
2016-08-05 19:40:00,20,32,28,80,480
2016-08-05 19:50:00,25,37,36,98,588
2016-08-05 20:00:00,19,15,26,60,360
2016-08-05 20:10:00,18,14,22,54,324
2016-08-05 20:20:00,10,13,13,36,216
2016-08-05 20:30:00,5,6,5,16,96
2016-08-05 20:40:00,0,1,0,1,6
2016-08-05 20:50:00,0,0,0,0,0
2016-08-05 21:00:00,0,0,0,0,0
2016-08-05 21:10:00,0,0,0,0,0
2016-08-05 21:20:00,0,0,0,0,0
2016-08-06 05:00:00,0,0,0,0,0
2016-08-06 05:10:00,0,0,0,0,0
2016-08-06 05:20:00,0,0,0,0,0
2016-08-06 05:30:00,0,0,0,0,0
2016-08-06 05:40:00,0,1,0,1,6
2016-08-06 05:50:00,1,3,2,6,36
2016-08-06 06:00:00,2,3,3,8,48
2016-08-06 06:10:00,6,8,8,22,132
2016-08-06 06:20:00,17,16,27,60,360
2016-08-06 06:30:00,26,45,38,109,654
2016-08-06 06:40:00,55,63,69,187,1122
2016-08-06 06:50:00,89,83,108,280,1680
2016-08-06 07:00:00,112,54,131,297,1782
2016-08-06 07:10:00,92,124,112,328,1968
2016-08-06 07:20:00,94,125,126,345,2070
2016-08-06 07:30:00,84,125,105,314,1884
2016-08-06 07:40:00,94,113,116,323,1938
2016-08-06 07:50:00,105,114,133,352,2112
2016-08-06 08:00:00,142,137,190,469,2814
2016-08-06 08:10:00,128,173,229,530,3180
2016-08-06 08:20:00,0,172,300,472,2832
2016-08-06 08:30:00,0,169,306,475,2850
2016-08-06 08:40:00,191,223,181,595,3570
2016-08-06 08:50:00,265,285,284,834,5004
2016-08-06 09:00:00,265,287,282,834,5004
2016-08-06 09:10:00,195,165,203,563,3378
2016-08-06 09:20:00,255,280,275,810,4860
2016-08-06 09:30:00,498,515,512,1525,9150
2016-08-06 09:40:00,390,407,408,1205,7230
2016-08-06 09:50:00,246,199,199,644,3864
2016-08-06 10:00:00,177,202,198,577,3462
2016-08-06 10:10:00,99,100,125,324,1944
2016-08-06 10:20:00,293,258,285,836,5016
2016-08-06 10:30:00,407,431,428,1266,7596
2016-08-06 10:40:00,309,334,328,971,5826
2016-08-06 10:50:00,243,267,264,774,4644
2016-08-06 11:00:00,266,290,287,843,5058
2016-08-06 11:10:00,352,380,377,1109,6654
2016-08-06 11:20:00,514,540,541,1595,9570
2016-08-06 11:30:00,301,325,322,948,5688
2016-08-06 11:40:00,212,270,226,708,4248
2016-08-06 11:50:00,363,404,395,1162,6972
2016-08-06 12:00:00,370,398,393,1161,6966
2016-08-06 12:10:00,725,757,754,2236,13416
2016-08-06 12:20:00,1065,1092,1084,3241,19446
2016-08-06 12:30:00,894,922,913,2729,16374
2016-08-06 12:40:00,1081,1113,1112,3306,19836
2016-08-06 12:50:00,483,504,503,1490,8940
2016-08-06 13:00:00,1129,1150,1143,3422,20532
2016-08-06 13:10:00,1116,1132,1139,3387,20322
2016-08-06 13:20:00,864,893,884,2641,15846
2016-08-06 13:30:00,1097,1121,1102,3320,19920
2016-08-06 13:40:00,1097,1124,1112,3333,19998
2016-08-06 13:50:00,963,989,981,2933,17598
2016-08-06 14:00:00,676,703,695,2074,12444
2016-08-06 14:10:00,577,604,600,1781,10686
2016-08-06 14:20:00,707,742,732,2181,13086
2016-08-06 14:30:00,274,300,295,869,5214
2016-08-06 14:40:00,332,357,352,1041,6246
2016-08-06 14:50:00,287,315,308,910,5460
2016-08-06 15:00:00,385,409,404,1198,7188
2016-08-06 15:10:00,652,682,674,2008,12048
2016-08-06 15:20:00,901,931,926,2758,16548
2016-08-06 15:30:00,818,843,832,2493,14958
2016-08-06 15:40:00,865,896,887,2648,15888
2016-08-06 15:50:00,606,633,629,1868,11208
2016-08-06 16:00:00,636,664,660,1960,11760
2016-08-06 16:10:00,732,759,754,2245,13470
2016-08-06 16:20:00,695,723,716,2134,12804
2016-08-06 16:30:00,533,558,555,1646,9876
2016-08-06 16:40:00,475,497,497,1469,8814
2016-08-06 16:50:00,217,248,250,715,4290
2016-08-06 17:00:00,323,347,347,1017,6102
2016-08-06 17:10:00,369,399,391,1159,6954
2016-08-06 17:20:00,335,358,348,1041,6246
2016-08-06 17:30:00,350,381,371,1102,6612
2016-08-06 17:40:00,194,221,218,633,3798
2016-08-06 17:50:00,289,314,310,913,5478
2016-08-06 18:00:00,175,200,194,569,3414
2016-08-06 18:10:00,183,208,202,593,3558
2016-08-06 18:20:00,77,120,78,275,1650
2016-08-06 18:30:00,84,95,85,264,1584
2016-08-06 18:40:00,58,57,70,185,1110
2016-08-06 18:50:00,34,63,39,136,816
2016-08-06 19:00:00,34,67,35,136,816
2016-08-06 19:10:00,21,58,24,103,618
2016-08-06 19:20:00,47,57,74,178,1068
2016-08-06 19:30:00,41,49,48,138,828
2016-08-06 19:40:00,16,32,20,68,408
2016-08-06 19:50:00,37,17,33,87,522
2016-08-06 20:00:00,20,16,29,65,390
2016-08-06 20:10:00,16,18,21,55,330
2016-08-06 20:20:00,10,14,14,38,228
2016-08-06 20:30:00,4,10,8,22,132
2016-08-06 20:40:00,2,3,2,7,42
2016-08-06 20:50:00,0,0,0,0,0
2016-08-06 21:00:00,0,0,0,0,0
2016-08-06 21:10:00,0,0,0,0,0
2016-08-06 21:20:00,0,0,0,0,0
2016-08-07 04:50:00,0,0,0,0,0
2016-08-07 05:00:00,0,0,0,0,0
2016-08-07 05:10:00,0,0,0,0,0
2016-08-07 05:20:00,0,0,0,0,0
2016-08-07 05:30:00,1,2,1,4,24
2016-08-07 05:40:00,3,5,5,13,78
2016-08-07 05:50:00,5,11,6,22,132
2016-08-07 06:00:00,4,7,7,18,108
2016-08-07 06:10:00,9,19,7,35,210
2016-08-07 06:20:00,14,28,8,50,300
2016-08-07 06:30:00,20,48,14,82,492
2016-08-07 06:40:00,25,53,17,95,570
2016-08-07 06:50:00,40,60,38,138,828
2016-08-07 07:00:00,48,75,72,195,1170
2016-08-07 07:10:00,53,87,68,208,1248
2016-08-07 07:20:00,60,130,112,302,1812
2016-08-07 07:30:00,77,96,89,262,1572
2016-08-07 07:40:00,79,80,92,251,1506
2016-08-07 07:50:00,92,115,158,365,2190
2016-08-07 08:00:00,93,80,125,298,1788
2016-08-07 08:10:00,57,74,89,220,1320
2016-08-07 08:20:00,65,112,125,302,1812
2016-08-07 08:30:00,103,111,155,369,2214
2016-08-07 08:40:00,201,232,221,654,3924
2016-08-07 08:50:00,283,304,299,886,5316
2016-08-07 09:00:00,360,380,373,1113,6678
2016-08-07 09:10:00,301,322,319,942,5652
2016-08-07 09:20:00,482,505,506,1493,8958
2016-08-07 09:30:00,237,261,259,757,4542
2016-08-07 09:40:00,268,293,284,845,5070
2016-08-07 09:50:00,304,329,321,954,5724
2016-08-07 10:00:00,570,595,587,1752,10512
2016-08-07 10:10:00,383,405,398,1186,7116
2016-08-07 10:20:00,264,283,278,825,4950
2016-08-07 10:30:00,220,242,236,698,4188
2016-08-07 10:40:00,265,270,229,764,4584
2016-08-07 10:50:00,260,283,277,820,4920
2016-08-07 11:00:00,228,252,246,726,4356
2016-08-07 11:10:00,268,290,282,840,5040
2016-08-07 11:20:00,761,789,777,2327,13962
2016-08-07 11:30:00,662,688,682,2032,12192
2016-08-07 11:40:00,385,407,407,1199,7194
2016-08-07 11:50:00,574,608,596,1778,10668
2016-08-07 12:00:00,456,482,472,1410,8460
2016-08-07 12:10:00,249,273,268,790,4740
2016-08-07 12:20:00,236,260,256,752,4512
2016-08-07 12:30:00,125,149,144,418,2508
2016-08-07 12:40:00,120,143,140,403,2418
2016-08-07 12:50:00,248,271,268,787,4722
2016-08-07 13:00:00,205,228,224,657,3942
2016-08-07 13:10:00,187,173,229,589,3534
2016-08-07 13:20:00,151,173,166,490,2940
2016-08-07 13:30:00,111,137,130,378,2268
2016-08-07 13:40:00,171,203,195,569,3414
2016-08-07 13:50:00,221,244,239,704,4224
2016-08-07 14:00:00,133,156,152,441,2646
2016-08-07 14:10:00,250,236,246,732,4392
2016-08-07 14:20:00,187,195,186,568,3408
2016-08-07 14:30:00,128,153,78,359,2154
2016-08-07 14:40:00,82,129,86,297,1782
2016-08-07 14:50:00,105,133,124,362,2172
2016-08-07 15:00:00,238,207,214,659,3954
2016-08-07 15:10:00,195,218,213,626,3756
2016-08-07 15:20:00,230,254,249,733,4398
2016-08-07 15:30:00,272,295,291,858,5148
2016-08-07 15:40:00,259,285,280,824,4944
2016-08-07 15:50:00,229,255,250,734,4404
2016-08-07 16:00:00,250,273,269,792,4752
2016-08-07 16:10:00,293,319,314,926,5556
2016-08-07 16:20:00,239,262,258,759,4554
2016-08-07 16:30:00,185,209,205,599,3594
2016-08-07 16:40:00,142,166,162,470,2820
2016-08-07 16:50:00,69,88,85,242,1452
2016-08-07 17:00:00,74,83,84,241,1446
2016-08-07 17:10:00,42,61,50,153,918
2016-08-07 17:20:00,27,47,31,105,630
2016-08-07 17:30:00,30,47,34,111,666
2016-08-07 17:40:00,25,50,37,112,672
2016-08-07 17:50:00,54,42,49,145,870
2016-08-07 18:00:00,125,170,142,437,2622
2016-08-07 18:10:00,100,100,127,327,1962
2016-08-07 18:20:00,104,135,155,394,2364
2016-08-07 18:30:00,123,144,133,400,2400
2016-08-07 18:40:00,71,56,80,207,1242
2016-08-07 18:50:00,57,40,74,171,1026
2016-08-07 19:00:00,49,49,45,143,858
2016-08-07 19:10:00,76,54,84,214,1284
2016-08-07 19:20:00,46,46,51,143,858
2016-08-07 19:30:00,39,28,50,117,702
2016-08-07 19:40:00,26,30,35,91,546
2016-08-07 19:50:00,20,24,26,70,420
2016-08-07 20:00:00,37,47,45,129,774
2016-08-07 20:10:00,18,19,25,62,372
2016-08-07 20:20:00,6,13,11,30,180
2016-08-07 20:30:00,3,7,5,15,90
2016-08-07 20:40:00,0,0,0,0,0
2016-08-07 20:50:00,0,0,0,0,0
2016-08-07 21:00:00,0,0,0,0,0
2016-08-07 21:10:00,0,0,0,0,0
2016-08-08 05:00:00,0,0,0,0,0
2016-08-08 05:10:00,0,0,0,0,0
2016-08-08 05:20:00,0,0,0,0,0
2016-08-08 05:30:00,0,0,0,0,0
2016-08-08 05:40:00,1,2,1,4,24
2016-08-08 05:50:00,10,7,9,26,156
2016-08-08 06:00:00,9,15,15,39,234
2016-08-08 06:10:00,19,22,28,69,414
2016-08-08 06:20:00,22,33,26,81,486
2016-08-08 06:30:00,40,61,37,138,828
2016-08-08 06:40:00,42,30,49,121,726
2016-08-08 06:50:00,61,40,72,173,1038
2016-08-08 07:00:00,28,51,34,113,678
2016-08-08 07:10:00,88,111,99,298,1788
2016-08-08 07:20:00,87,87,105,279,1674
2016-08-08 07:30:00,100,105,126,331,1986
2016-08-08 07:40:00,147,198,85,430,2580
2016-08-08 07:50:00,112,198,80,390,2340
2016-08-08 08:00:00,157,211,202,570,3420
2016-08-08 08:10:00,224,251,245,720,4320
2016-08-08 08:20:00,110,32,125,267,1602
2016-08-08 08:30:00,37,29,43,109,654
2016-08-08 08:40:00,36,55,49,140,840
2016-08-08 08:50:00,48,61,45,154,924
2016-08-08 09:00:00,35,47,38,120,720
2016-08-08 09:10:00,71,49,78,198,1188
2016-08-08 09:20:00,190,205,179,574,3444
2016-08-08 09:30:00,265,292,289,846,5076
2016-08-08 09:40:00,530,555,563,1648,9888
2016-08-08 09:50:00,672,708,702,2082,12492
2016-08-08 10:00:00,795,844,836,2475,14850
2016-08-08 10:10:00,807,858,847,2512,15072
2016-08-08 10:20:00,908,954,951,2813,16878
2016-08-08 10:30:00,285,314,310,909,5454
2016-08-08 10:40:00,273,310,316,899,5394
2016-08-08 10:50:00,272,303,296,871,5226
2016-08-08 11:00:00,418,450,444,1312,7872
2016-08-08 11:10:00,644,674,670,1988,11928
2016-08-08 11:20:00,901,928,929,2758,16548
2016-08-08 11:30:00,1016,1034,1040,3090,18540
2016-08-08 11:40:00,1019,1037,1041,3097,18582
2016-08-08 11:50:00,631,652,656,1939,11634
2016-08-08 12:00:00,971,984,994,2949,17694
2016-08-08 12:10:00,1051,1079,1082,3212,19272
2016-08-08 12:20:00,1107,1138,1135,3380,20280
2016-08-08 12:30:00,1039,1071,1054,3164,18984
2016-08-08 12:40:00,464,490,487,1441,8646
2016-08-08 12:50:00,1052,1072,1068,3192,19152
2016-08-08 13:00:00,917,940,936,2793,16758
2016-08-08 13:10:00,823,845,845,2513,15078
2016-08-08 13:20:00,614,636,632,1882,11292
2016-08-08 13:30:00,413,441,434,1288,7728
2016-08-08 13:40:00,842,872,867,2581,15486
2016-08-08 13:50:00,600,627,622,1849,11094
2016-08-08 14:00:00,181,202,200,583,3498
2016-08-08 14:10:00,461,468,463,1392,8352
2016-08-08 14:20:00,893,912,911,2716,16296
2016-08-08 14:30:00,777,797,797,2371,14226
2016-08-08 14:40:00,882,904,899,2685,16110
2016-08-08 14:50:00,336,360,354,1050,6300
2016-08-08 15:00:00,101,122,120,343,2058
2016-08-08 15:10:00,280,277,284,841,5046
2016-08-08 15:20:00,773,795,795,2363,14178
2016-08-08 15:30:00,342,369,364,1075,6450
2016-08-08 15:40:00,245,270,267,782,4692
2016-08-08 15:50:00,404,435,430,1269,7614
2016-08-08 16:00:00,462,495,489,1446,8676
2016-08-08 16:10:00,155,180,176,511,3066
2016-08-08 16:20:00,387,419,412,1218,7308
2016-08-08 16:30:00,492,525,518,1535,9210
2016-08-08 16:40:00,343,390,286,1019,6114
2016-08-08 16:50:00,273,297,294,864,5184
2016-08-08 17:00:00,361,386,382,1129,6774
2016-08-08 17:10:00,177,202,196,575,3450
2016-08-08 17:20:00,46,60,61,167,1002
2016-08-08 17:30:00,108,105,127,340,2040
2016-08-08 17:40:00,104,201,145,450,2700
2016-08-08 17:50:00,101,173,243,517,3102
2016-08-08 18:00:00,170,197,193,560,3360
2016-08-08 18:10:00,193,223,216,632,3792
2016-08-08 18:20:00,145,150,162,457,2742
2016-08-08 18:30:00,78,77,83,238,1428
2016-08-08 18:40:00,90,89,107,286,1716
2016-08-08 18:50:00,74,92,91,257,1542
2016-08-08 19:00:00,56,62,64,182,1092
2016-08-08 19:10:00,39,35,40,114,684
2016-08-08 19:20:00,34,27,37,98,588
2016-08-08 19:30:00,35,35,33,103,618
2016-08-08 19:40:00,30,39,38,107,642
2016-08-08 19:50:00,51,73,33,157,942
2016-08-08 20:00:00,34,51,23,108,648
2016-08-08 20:10:00,9,25,16,50,300
2016-08-08 20:20:00,9,15,6,30,180
2016-08-08 20:30:00,2,6,2,10,60
2016-08-08 20:40:00,0,0,0,0,0
2016-08-08 20:50:00,0,0,0,0,0
2016-08-08 21:00:00,0,0,0,0,0
2016-08-08 21:10:00,0,0,0,0,0
2016-08-09 05:00:00,0,0,0,0,0
2016-08-09 05:10:00,0,0,0,0,0
2016-08-09 05:20:00,0,0,0,0,0
2016-08-09 05:30:00,0,0,0,0,0
2016-08-09 05:40:00,1,1,1,3,18
2016-08-09 05:50:00,5,5,8,18,108
2016-08-09 06:00:00,16,24,19,59,354
2016-08-09 06:10:00,25,38,32,95,570
2016-08-09 06:20:00,20,30,24,74,444
2016-08-09 06:30:00,11,18,21,50,300
2016-08-09 06:40:00,18,32,24,74,444
2016-08-09 06:50:00,23,42,26,91,546
2016-08-09 07:00:00,34,62,38,134,804
2016-08-09 07:10:00,31,45,32,108,648
2016-08-09 07:20:00,20,87,20,127,762
2016-08-09 07:30:00,42,51,57,150,900
2016-08-09 07:40:00,67,26,72,165,990
2016-08-09 07:50:00,80,99,111,290,1740
2016-08-09 08:00:00,180,120,166,466,2796
2016-08-09 08:10:00,221,229,231,681,4086
2016-08-09 08:20:00,149,199,262,610,3660
2016-08-09 08:30:00,152,174,177,503,3018
2016-08-09 08:40:00,388,407,402,1197,7182
2016-08-09 08:50:00,430,451,446,1327,7962
2016-08-09 09:00:00,486,500,497,1483,8898
2016-08-09 09:10:00,546,560,562,1668,10008
2016-08-09 09:20:00,541,549,556,1646,9876
2016-08-09 09:30:00,664,677,681,2022,12132
2016-08-09 09:40:00,665,697,694,2056,12336
2016-08-09 09:50:00,769,807,810,2386,14316
2016-08-09 10:00:00,831,844,849,2524,15144
2016-08-09 10:10:00,772,784,790,2346,14076
2016-08-09 10:20:00,416,431,435,1282,7692
2016-08-09 10:30:00,138,160,159,457,2742
2016-08-09 10:40:00,789,817,818,2424,14544
2016-08-09 10:50:00,967,1002,993,2962,17772
2016-08-09 11:00:00,1002,1029,1020,3051,18306
2016-08-09 11:10:00,475,496,490,1461,8766
2016-08-09 11:20:00,361,382,379,1122,6732
2016-08-09 11:30:00,1099,1114,1098,3311,19866
2016-08-09 11:40:00,1075,1103,1081,3259,19554
2016-08-09 11:50:00,663,691,682,2036,12216
2016-08-09 12:00:00,785,812,806,2403,14418
2016-08-09 12:10:00,1048,1071,1063,3182,19092
2016-08-09 12:20:00,1043,1068,1062,3173,19038
2016-08-09 12:30:00,1070,1099,1089,3258,19548
2016-08-09 12:40:00,521,545,538,1604,9624
2016-08-09 12:50:00,602,635,628,1865,11190
2016-08-09 13:00:00,344,365,361,1070,6420
2016-08-09 13:10:00,736,763,758,2257,13542
2016-08-09 13:20:00,1061,1088,1081,3230,19380
2016-08-09 13:30:00,1084,1106,1102,3292,19752
2016-08-09 13:40:00,954,975,972,2901,17406
2016-08-09 13:50:00,1077,1098,1091,3266,19596
2016-08-09 14:00:00,1085,1113,1105,3303,19818
2016-08-09 14:10:00,964,979,980,2923,17538
2016-08-09 14:20:00,913,915,932,2760,16560
2016-08-09 14:30:00,992,1008,1014,3014,18084
2016-08-09 14:40:00,1015,1036,1038,3089,18534
2016-08-09 14:50:00,995,1020,1016,3031,18186
2016-08-09 15:00:00,659,683,679,2021,12126
2016-08-09 15:10:00,855,875,869,2599,15594
2016-08-09 15:20:00,898,920,917,2735,16410
2016-08-09 15:30:00,844,868,867,2579,15474
2016-08-09 15:40:00,820,851,847,2518,15108
2016-08-09 15:50:00,169,179,174,522,3132
2016-08-09 16:00:00,286,269,315,870,5220
2016-08-09 16:10:00,357,385,384,1126,6756
2016-08-09 16:20:00,598,621,617,1836,11016
2016-08-09 16:30:00,520,540,535,1595,9570
2016-08-09 16:40:00,227,246,243,716,4296
2016-08-09 16:50:00,150,170,169,489,2934
2016-08-09 17:00:00,359,386,388,1133,6798
2016-08-09 17:10:00,445,478,471,1394,8364
2016-08-09 17:20:00,288,316,312,916,5496
2016-08-09 17:30:00,363,397,388,1148,6888
2016-08-09 17:40:00,291,322,315,928,5568
2016-08-09 17:50:00,152,163,172,487,2922
2016-08-09 18:00:00,130,139,148,417,2502
2016-08-09 18:10:00,88,62,104,254,1524
2016-08-09 18:20:00,143,136,178,457,2742
2016-08-09 18:30:00,68,93,82,243,1458
2016-08-09 18:40:00,56,69,54,179,1074
2016-08-09 18:50:00,45,51,41,137,822
2016-08-09 19:00:00,84,64,85,233,1398
2016-08-09 19:10:00,38,71,37,146,876
2016-08-09 19:20:00,24,36,40,100,600
2016-08-09 19:30:00,39,18,31,88,528
2016-08-09 19:40:00,26,21,31,78,468
2016-08-09 19:50:00,26,21,27,74,444
2016-08-09 20:00:00,15,15,21,51,306
2016-08-09 20:10:00,9,12,14,35,210
2016-08-09 20:20:00,6,8,6,20,120
2016-08-09 20:30:00,3,3,2,8,48
2016-08-09 20:40:00,0,0,0,0,0
2016-08-09 20:50:00,0,0,0,0,0
2016-08-09 21:00:00,0,0,0,0,0
2016-08-09 21:10:00,0,0,0,0,0
2016-08-10 05:00:00,0,0,0,0,0
2016-08-10 05:10:00,0,0,0,0,0
2016-08-10 05:20:00,0,0,0,0,0
2016-08-10 05:30:00,0,0,0,0,0
2016-08-10 05:40:00,0,0,0,0,0
2016-08-10 05:50:00,3,4,3,10,60
2016-08-10 06:00:00,6,11,7,24,144
2016-08-10 06:10:00,11,15,11,37,222
2016-08-10 06:20:00,15,19,13,47,282
2016-08-10 06:30:00,16,27,16,59,354
2016-08-10 06:40:00,20,27,22,69,414
2016-08-10 06:50:00,18,31,29,78,468
2016-08-10 07:00:00,22,35,32,89,534
2016-08-10 07:10:00,29,39,35,103,618
2016-08-10 07:20:00,28,60,31,119,714
2016-08-10 07:30:00,35,63,33,131,786
2016-08-10 07:40:00,50,48,45,143,858
2016-08-10 07:50:00,68,85,85,238,1428
2016-08-10 08:00:00,139,147,194,480,2880
2016-08-10 08:10:00,175,298,153,626,3756
2016-08-10 08:20:00,246,271,268,785,4710
2016-08-10 08:30:00,305,331,325,961,5766
2016-08-10 08:40:00,362,389,382,1133,6798
2016-08-10 08:50:00,419,449,444,1312,7872
2016-08-10 09:00:00,481,510,504,1495,8970
2016-08-10 09:10:00,539,565,559,1663,9978
2016-08-10 09:20:00,615,638,635,1888,11328
2016-08-10 09:30:00,722,747,741,2210,13260
2016-08-10 09:40:00,772,799,795,2366,14196
2016-08-10 09:50:00,724,750,746,2220,13320
2016-08-10 10:00:00,378,403,399,1180,7080
2016-08-10 10:10:00,366,388,385,1139,6834
2016-08-10 10:20:00,332,350,347,1029,6174
2016-08-10 10:30:00,370,389,386,1145,6870
2016-08-10 10:40:00,408,428,425,1261,7566
2016-08-10 10:50:00,364,386,385,1135,6810
2016-08-10 11:00:00,340,362,361,1063,6378
2016-08-10 11:10:00,380,400,393,1173,7038
2016-08-10 11:20:00,370,389,382,1141,6846
2016-08-10 11:30:00,374,392,386,1152,6912
2016-08-10 11:40:00,346,365,357,1068,6408
2016-08-10 11:50:00,472,493,483,1448,8688
2016-08-10 12:00:00,669,692,683,2044,12264
2016-08-10 12:10:00,712,739,727,2178,13068
2016-08-10 12:20:00,450,467,460,1377,8262
2016-08-10 12:30:00,520,542,536,1598,9588
2016-08-10 12:40:00,443,465,460,1368,8208
2016-08-10 12:50:00,435,456,454,1345,8070
2016-08-10 13:00:00,390,413,408,1211,7266
2016-08-10 13:10:00,305,327,318,950,5700
2016-08-10 13:20:00,64,120,107,291,1746
2016-08-10 13:30:00,152,124,153,429,2574
2016-08-10 13:40:00,173,214,158,545,3270
2016-08-10 13:50:00,233,242,240,715,4290
2016-08-10 14:00:00,379,402,392,1173,7038
2016-08-10 14:10:00,295,321,312,928,5568
2016-08-10 14:20:00,281,305,297,883,5298
2016-08-10 14:30:00,336,360,351,1047,6282
2016-08-10 14:40:00,220,257,206,683,4098
2016-08-10 14:50:00,461,488,475,1424,8544
2016-08-10 15:00:00,350,377,368,1095,6570
2016-08-10 15:10:00,581,612,605,1798,10788
2016-08-10 15:20:00,309,333,327,969,5814
2016-08-10 15:30:00,131,157,154,442,2652
2016-08-10 15:40:00,423,452,449,1324,7944
2016-08-10 15:50:00,708,739,731,2178,13068
2016-08-10 16:00:00,556,584,576,1716,10296
2016-08-10 16:10:00,645,671,665,1981,11886
2016-08-10 16:20:00,691,716,710,2117,12702
2016-08-10 16:30:00,595,621,615,1831,10986
2016-08-10 16:40:00,543,567,568,1678,10068
2016-08-10 16:50:00,488,516,510,1514,9084
2016-08-10 17:00:00,451,480,471,1402,8412
2016-08-10 17:10:00,423,450,434,1307,7842
2016-08-10 17:20:00,387,415,394,1196,7176
2016-08-10 17:30:00,343,376,356,1075,6450
2016-08-10 17:40:00,291,325,312,928,5568
2016-08-10 17:50:00,250,280,273,803,4818
2016-08-10 18:00:00,214,241,236,691,4146
2016-08-10 18:10:00,165,188,183,536,3216
2016-08-10 18:20:00,125,149,145,419,2514
2016-08-10 18:30:00,84,104,102,290,1740
2016-08-10 18:40:00,54,57,59,170,1020
2016-08-10 18:50:00,33,56,34,123,738
2016-08-10 19:00:00,38,62,39,139,834
2016-08-10 19:10:00,30,44,33,107,642
2016-08-10 19:20:00,26,46,29,101,606
2016-08-10 19:30:00,21,39,23,83,498
2016-08-10 19:40:00,25,26,23,74,444
2016-08-10 19:50:00,17,24,21,62,372
2016-08-10 20:00:00,12,12,17,41,246
2016-08-10 20:10:00,11,11,13,35,210
2016-08-10 20:20:00,6,9,6,21,126
2016-08-10 20:30:00,2,3,2,7,42
2016-08-10 20:40:00,0,0,0,0,0
2016-08-10 20:50:00,0,0,0,0,0
2016-08-10 21:00:00,0,0,0,0,0
2016-08-10 21:10:00,0,0,0,0,0
2016-08-11 05:10:00,0,0,0,0,0
2016-08-11 05:20:00,0,0,0,0,0
2016-08-11 05:30:00,0,0,0,0,0
2016-08-11 05:40:00,0,0,0,0,0
2016-08-11 05:50:00,6,4,2,12,72
2016-08-11 06:00:00,5,10,6,21,126
2016-08-11 06:10:00,5,11,8,24,144
2016-08-11 06:20:00,11,17,11,39,234
2016-08-11 06:30:00,16,21,19,56,336
2016-08-11 06:40:00,19,30,21,70,420
2016-08-11 06:50:00,17,38,27,82,492
2016-08-11 07:00:00,26,46,20,92,552
2016-08-11 07:10:00,25,50,26,101,606
2016-08-11 07:20:00,25,54,29,108,648
2016-08-11 07:30:00,8,104,10,122,732
2016-08-11 07:40:00,31,65,37,133,798
2016-08-11 07:50:00,53,91,77,221,1326
2016-08-11 08:00:00,115,187,171,473,2838
2016-08-11 08:10:00,213,250,166,629,3774
2016-08-11 08:20:00,255,275,270,800,4800
2016-08-11 08:30:00,311,331,325,967,5802
2016-08-11 08:40:00,372,389,385,1146,6876
2016-08-11 08:50:00,432,451,446,1329,7974
2016-08-11 09:00:00,486,508,501,1495,8970
2016-08-11 09:10:00,542,563,562,1667,10002
2016-08-11 09:20:00,601,622,617,1840,11040
2016-08-11 09:30:00,658,685,673,2016,12096
2016-08-11 09:40:00,712,735,723,2170,13020
2016-08-11 09:50:00,760,778,772,2310,13860
2016-08-11 10:00:00,801,826,813,2440,14640
2016-08-11 10:10:00,836,868,855,2559,15354
2016-08-11 10:20:00,866,897,884,2647,15882
2016-08-11 10:30:00,900,924,916,2740,16440
2016-08-11 10:40:00,922,949,942,2813,16878
2016-08-11 10:50:00,938,966,958,2862,17172
2016-08-11 11:00:00,956,980,966,2902,17412
2016-08-11 11:10:00,984,1003,994,2981,17886
2016-08-11 11:20:00,998,1021,1007,3026,18156
2016-08-11 11:30:00,1015,1033,1023,3071,18426
2016-08-11 11:40:00,1031,1050,1040,3121,18726
2016-08-11 11:50:00,1036,1061,1049,3146,18876
2016-08-11 12:00:00,1041,1070,1060,3171,19026
2016-08-11 12:10:00,1053,1078,1074,3205,19230
2016-08-11 12:20:00,1059,1081,1080,3220,19320
2016-08-11 12:30:00,1066,1079,1079,3224,19344
2016-08-11 12:40:00,1067,1090,1083,3240,19440
2016-08-11 12:50:00,1064,1090,1086,3240,19440
2016-08-11 13:00:00,1060,1090,1079,3229,19374
2016-08-11 13:10:00,1058,1096,1083,3237,19422
2016-08-11 13:20:00,1056,1097,1081,3234,19404
2016-08-11 13:30:00,1057,1093,1082,3232,19392
2016-08-11 13:40:00,1049,1087,1076,3212,19272
2016-08-11 13:50:00,1048,1072,1060,3180,19080
2016-08-11 14:00:00,1035,1068,1053,3156,18936
2016-08-11 14:10:00,1019,1058,1046,3123,18738
2016-08-11 14:20:00,1010,1045,1027,3082,18492
2016-08-11 14:30:00,1005,1036,1024,3065,18390
2016-08-11 14:40:00,761,788,774,2323,13938
2016-08-11 14:50:00,686,712,701,2099,12594
2016-08-11 15:00:00,993,1019,1005,3017,18102
2016-08-11 15:10:00,745,768,754,2267,13602
2016-08-11 15:20:00,608,630,618,1856,11136
2016-08-11 15:30:00,579,606,596,1781,10686
2016-08-11 15:40:00,629,655,647,1931,11586
2016-08-11 15:50:00,479,507,501,1487,8922
2016-08-11 16:00:00,781,817,809,2407,14442
2016-08-11 16:10:00,698,732,720,2150,12900
2016-08-11 16:20:00,550,586,572,1708,10248
2016-08-11 16:30:00,399,432,420,1251,7506
2016-08-11 16:40:00,364,393,381,1138,6828
2016-08-11 16:50:00,144,167,161,472,2832
2016-08-11 17:00:00,194,218,214,626,3756
2016-08-11 17:10:00,445,468,464,1377,8262
2016-08-11 17:20:00,219,239,228,686,4116
2016-08-11 17:30:00,153,173,163,489,2934
2016-08-11 17:40:00,177,200,189,566,3396
2016-08-11 17:50:00,108,138,124,370,2220
2016-08-11 18:00:00,113,41,122,276,1656
2016-08-11 18:10:00,111,142,153,406,2436
2016-08-11 18:20:00,36,134,135,305,1830
2016-08-11 18:30:00,0,137,144,281,1686
2016-08-11 18:40:00,79,76,94,249,1494
2016-08-11 18:50:00,48,93,97,238,1428
2016-08-11 19:00:00,47,102,106,255,1530
2016-08-11 19:10:00,54,100,112,266,1596
2016-08-11 19:20:00,47,95,94,236,1416
2016-08-11 19:30:00,32,80,65,177,1062
2016-08-11 19:40:00,37,69,33,139,834
2016-08-11 19:50:00,29,52,13,94,564
2016-08-11 20:00:00,20,49,22,91,546
2016-08-11 20:10:00,8,18,10,36,216
2016-08-11 20:20:00,1,3,4,8,48
2016-08-11 20:30:00,0,1,2,3,18
2016-08-11 20:40:00,0,0,0,0,0
2016-08-11 20:50:00,0,0,0,0,0
2016-08-11 21:00:00,0,0,0,0,0
2016-08-12 05:10:00,0,0,0,0,0
2016-08-12 05:20:00,0,0,0,0,0
2016-08-12 05:30:00,0,0,0,0,0
2016-08-12 05:40:00,0,0,0,0,0
2016-08-12 05:50:00,1,0,2,3,18
2016-08-12 06:00:00,3,9,14,26,156
2016-08-12 06:10:00,6,24,14,44,264
2016-08-12 06:20:00,7,53,17,77,462
2016-08-12 06:30:00,26,36,30,92,552
2016-08-12 06:40:00,20,78,48,146,876
2016-08-12 06:50:00,17,76,74,167,1002
2016-08-12 07:00:00,30,57,48,135,810
2016-08-12 07:10:00,53,84,65,202,1212
2016-08-12 07:20:00,42,100,79,221,1326
2016-08-12 07:30:00,26,142,137,305,1830
2016-08-12 07:40:00,88,165,137,390,2340
2016-08-12 07:50:00,203,226,193,622,3732
2016-08-12 08:00:00,169,192,184,545,3270
2016-08-12 08:10:00,161,241,148,550,3300
2016-08-12 08:20:00,189,229,143,561,3366
2016-08-12 08:30:00,180,240,141,561,3366
2016-08-12 08:40:00,124,269,132,525,3150
2016-08-12 08:50:00,234,195,127,556,3336
2016-08-12 09:00:00,299,169,109,577,3462
2016-08-12 09:10:00,293,131,171,595,3570
2016-08-12 09:20:00,220,221,193,634,3804
2016-08-12 09:30:00,209,241,215,665,3990
2016-08-12 09:40:00,320,344,341,1005,6030
2016-08-12 09:50:00,301,324,320,945,5670
2016-08-12 10:00:00,463,487,481,1431,8586
2016-08-12 10:10:00,559,578,574,1711,10266
2016-08-12 10:20:00,463,485,481,1429,8574
2016-08-12 10:30:00,268,291,286,845,5070
2016-08-12 10:40:00,266,290,284,840,5040
2016-08-12 10:50:00,316,340,339,995,5970
2016-08-12 11:00:00,250,273,269,792,4752
2016-08-12 11:10:00,233,242,242,717,4302
2016-08-12 11:20:00,444,465,455,1364,8184
2016-08-12 11:30:00,765,786,773,2324,13944
2016-08-12 11:40:00,377,396,392,1165,6990
2016-08-12 11:50:00,399,418,417,1234,7404
2016-08-12 12:00:00,404,431,425,1260,7560
2016-08-12 12:10:00,433,454,452,1339,8034
2016-08-12 12:20:00,551,572,572,1695,10170
2016-08-12 12:30:00,377,402,394,1173,7038
2016-08-12 12:40:00,241,262,256,759,4554
2016-08-12 12:50:00,306,328,323,957,5742
2016-08-12 13:00:00,377,401,396,1174,7044
2016-08-12 13:10:00,302,325,320,947,5682
2016-08-12 13:20:00,220,243,238,701,4206
2016-08-12 13:30:00,159,181,178,518,3108
2016-08-12 13:40:00,287,154,189,630,3780
2016-08-12 13:50:00,267,290,287,844,5064
2016-08-12 14:00:00,213,235,231,679,4074
2016-08-12 14:10:00,233,256,250,739,4434
2016-08-12 14:20:00,173,193,190,556,3336
2016-08-12 14:30:00,113,134,132,379,2274
2016-08-12 14:40:00,104,125,100,329,1974
2016-08-12 14:50:00,137,163,113,413,2478
2016-08-12 15:00:00,124,146,118,388,2328
2016-08-12 15:10:00,85,130,113,328,1968
2016-08-12 15:20:00,128,198,120,446,2676
2016-08-12 15:30:00,136,141,134,411,2466
2016-08-12 15:40:00,82,97,91,270,1620
2016-08-12 15:50:00,66,67,72,205,1230
2016-08-12 16:00:00,127,153,159,439,2634
2016-08-12 16:10:00,75,128,125,328,1968
2016-08-12 16:20:00,88,101,105,294,1764
2016-08-12 16:30:00,93,93,102,288,1728
2016-08-12 16:40:00,53,49,57,159,954
2016-08-12 16:50:00,190,194,205,589,3534
2016-08-12 17:00:00,81,63,93,237,1422
2016-08-12 17:10:00,70,70,91,231,1386
2016-08-12 17:20:00,106,102,127,335,2010
2016-08-12 17:30:00,125,165,98,388,2328
2016-08-12 17:40:00,82,84,89,255,1530
2016-08-12 17:50:00,105,151,206,462,2772
2016-08-12 18:00:00,143,111,146,400,2400
2016-08-12 18:10:00,78,69,96,243,1458
2016-08-12 18:20:00,113,99,118,330,1980
2016-08-12 18:30:00,111,114,134,359,2154
2016-08-12 18:40:00,115,118,132,365,2190
2016-08-12 18:50:00,150,127,169,446,2676
2016-08-12 19:00:00,112,69,122,303,1818
2016-08-12 19:10:00,66,44,75,185,1110
2016-08-12 19:20:00,42,56,41,139,834
2016-08-12 19:30:00,49,55,61,165,990
2016-08-12 19:40:00,25,17,31,73,438
2016-08-12 19:50:00,18,9,24,51,306
2016-08-12 20:00:00,13,11,17,41,246
2016-08-12 20:10:00,7,8,7,22,132
2016-08-12 20:20:00,1,1,1,3,18
2016-08-12 20:30:00,0,0,0,0,0
2016-08-12 20:40:00,0,0,0,0,0
2016-08-12 20:50:00,0,0,0,0,0
2016-08-12 21:00:00,0,0,0,0,0
2016-08-13 05:20:00,0,0,0,0,0
2016-08-13 05:30:00,0,0,0,0,0
2016-08-13 05:40:00,0,0,0,0,0
2016-08-13 05:50:00,0,0,0,0,0
2016-08-13 06:00:00,1,1,0,2,12
2016-08-13 06:10:00,6,6,4,16,96
2016-08-13 06:20:00,10,15,13,38,228
2016-08-13 06:30:00,10,16,11,37,222
2016-08-13 06:40:00,8,13,7,28,168
2016-08-13 06:50:00,13,21,11,45,270
2016-08-13 07:00:00,20,31,17,68,408
2016-08-13 07:10:00,30,42,27,99,594
2016-08-13 07:20:00,40,69,62,171,1026
2016-08-13 07:30:00,85,62,96,243,1458
2016-08-13 07:40:00,61,103,95,259,1554
2016-08-13 07:50:00,32,77,71,180,1080
2016-08-13 08:00:00,54,81,60,195,1170
2016-08-13 08:10:00,101,134,86,321,1926
2016-08-13 08:20:00,105,235,84,424,2544
2016-08-13 08:30:00,83,171,173,427,2562
2016-08-13 08:40:00,85,146,140,371,2226
2016-08-13 08:50:00,105,145,126,376,2256
2016-08-13 09:00:00,88,115,110,313,1878
2016-08-13 09:10:00,80,114,104,298,1788
2016-08-13 09:20:00,76,141,149,366,2196
2016-08-13 09:30:00,60,162,148,370,2220
2016-08-13 09:40:00,118,110,137,365,2190
2016-08-13 09:50:00,125,204,92,421,2526
2016-08-13 10:00:00,229,270,236,735,4410
2016-08-13 10:10:00,287,310,305,902,5412
2016-08-13 10:20:00,348,369,367,1084,6504
2016-08-13 10:30:00,403,427,425,1255,7530
2016-08-13 10:40:00,392,417,416,1225,7350
2016-08-13 10:50:00,920,954,949,2823,16938
2016-08-13 11:00:00,882,909,908,2699,16194
2016-08-13 11:10:00,830,855,852,2537,15222
2016-08-13 11:20:00,459,481,475,1415,8490
2016-08-13 11:30:00,244,266,261,771,4626
2016-08-13 11:40:00,276,212,226,714,4284
2016-08-13 11:50:00,355,377,373,1105,6630
2016-08-13 12:00:00,334,357,352,1043,6258
2016-08-13 12:10:00,133,154,152,439,2634
2016-08-13 12:20:00,82,101,91,274,1644
2016-08-13 12:30:00,213,126,177,516,3096
2016-08-13 12:40:00,271,293,292,856,5136
2016-08-13 12:50:00,220,236,286,742,4452
2016-08-13 13:00:00,318,284,303,905,5430
2016-08-13 13:10:00,831,853,845,2529,15174
2016-08-13 13:20:00,886,913,907,2706,16236
2016-08-13 13:30:00,1012,1038,1035,3085,18510
2016-08-13 13:40:00,973,1008,1000,2981,17886
2016-08-13 13:50:00,978,1014,1001,2993,17958
2016-08-13 14:00:00,935,971,961,2867,17202
2016-08-13 14:10:00,529,554,547,1630,9780
2016-08-13 14:20:00,464,491,484,1439,8634
2016-08-13 14:30:00,370,397,391,1158,6948
2016-08-13 14:40:00,219,244,240,703,4218
2016-08-13 14:50:00,261,267,268,796,4776
2016-08-13 15:00:00,639,668,663,1970,11820
2016-08-13 15:10:00,797,832,827,2456,14736
2016-08-13 15:20:00,668,692,691,2051,12306
2016-08-13 15:30:00,766,795,791,2352,14112
2016-08-13 15:40:00,357,379,377,1113,6678
2016-08-13 15:50:00,188,232,275,695,4170
2016-08-13 16:00:00,231,254,251,736,4416
2016-08-13 16:10:00,183,152,186,521,3126
2016-08-13 16:20:00,250,264,260,774,4644
2016-08-13 16:30:00,223,251,244,718,4308
2016-08-13 16:40:00,108,125,140,373,2238
2016-08-13 16:50:00,111,114,116,341,2046
2016-08-13 17:00:00,133,159,153,445,2670
2016-08-13 17:10:00,155,179,161,495,2970
2016-08-13 17:20:00,99,134,130,363,2178
2016-08-13 17:30:00,98,187,177,462,2772
2016-08-13 17:40:00,164,202,177,543,3258
2016-08-13 17:50:00,59,83,70,212,1272
2016-08-13 18:00:00,54,134,73,261,1566
2016-08-13 18:10:00,123,162,135,420,2520
2016-08-13 18:20:00,81,89,93,263,1578
2016-08-13 18:30:00,114,16,121,251,1506
2016-08-13 18:40:00,82,67,92,241,1446
2016-08-13 18:50:00,59,77,77,213,1278
2016-08-13 19:00:00,76,91,85,252,1512
2016-08-13 19:10:00,73,35,79,187,1122
2016-08-13 19:20:00,48,43,53,144,864
2016-08-13 19:30:00,31,60,30,121,726
2016-08-13 19:40:00,24,42,34,100,600
2016-08-13 19:50:00,14,11,22,47,282
2016-08-13 20:00:00,16,16,21,53,318
2016-08-13 20:10:00,13,12,18,43,258
2016-08-13 20:20:00,3,4,5,12,72
2016-08-13 20:30:00,0,0,0,0,0
2016-08-13 20:40:00,0,0,0,0,0
2016-08-13 20:50:00,0,0,0,0,0
2016-08-13 21:00:00,0,0,0,0,0
2016-08-14 05:10:00,0,0,0,0,0
2016-08-14 05:20:00,0,0,0,0,0
2016-08-14 05:30:00,0,0,0,0,0
2016-08-14 05:40:00,0,0,0,0,0
2016-08-14 05:50:00,1,1,0,2,12
2016-08-14 06:00:00,4,4,3,11,66
2016-08-14 06:10:00,7,8,6,21,126
2016-08-14 06:20:00,9,13,8,30,180
2016-08-14 06:30:00,12,18,11,41,246
2016-08-14 06:40:00,13,21,21,55,330
2016-08-14 06:50:00,20,26,26,72,432
2016-08-14 07:00:00,23,33,23,79,474
2016-08-14 07:10:00,26,44,18,88,528
2016-08-14 07:20:00,25,46,28,99,594
2016-08-14 07:30:00,30,51,30,111,666
2016-08-14 07:40:00,29,57,30,116,696
2016-08-14 07:50:00,34,65,46,145,870
2016-08-14 08:00:00,109,172,104,385,2310
2016-08-14 08:10:00,256,178,159,593,3558
2016-08-14 08:20:00,301,324,314,939,5634
2016-08-14 08:30:00,286,309,302,897,5382
2016-08-14 08:40:00,202,226,220,648,3888
2016-08-14 08:50:00,224,247,241,712,4272
2016-08-14 09:00:00,278,301,295,874,5244
2016-08-14 09:10:00,292,314,308,914,5484
2016-08-14 09:20:00,301,321,320,942,5652
2016-08-14 09:30:00,256,276,276,808,4848
2016-08-14 09:40:00,296,315,314,925,5550
2016-08-14 09:50:00,289,309,302,900,5400
2016-08-14 10:00:00,608,627,622,1857,11142
2016-08-14 10:10:00,533,554,549,1636,9816
2016-08-14 10:20:00,503,528,520,1551,9306
2016-08-14 10:30:00,396,426,418,1240,7440
2016-08-14 10:40:00,543,595,583,1721,10326
2016-08-14 10:50:00,606,649,641,1896,11376
2016-08-14 11:00:00,473,507,499,1479,8874
2016-08-14 11:10:00,308,340,331,979,5874
2016-08-14 11:20:00,292,313,306,911,5466
2016-08-14 11:30:00,394,414,409,1217,7302
2016-08-14 11:40:00,396,409,416,1221,7326
2016-08-14 11:50:00,459,478,478,1415,8490
2016-08-14 12:00:00,622,639,642,1903,11418
2016-08-14 12:10:00,621,648,638,1907,11442
2016-08-14 12:20:00,656,655,671,1982,11892
2016-08-14 12:30:00,545,570,565,1680,10080
2016-08-14 12:40:00,242,269,259,770,4620
2016-08-14 12:50:00,306,335,325,966,5796
2016-08-14 13:00:00,317,346,337,1000,6000
2016-08-14 13:10:00,584,612,607,1803,10818
2016-08-14 13:20:00,983,1000,1006,2989,17934
2016-08-14 13:30:00,649,666,667,1982,11892
2016-08-14 13:40:00,587,609,603,1799,10794
2016-08-14 13:50:00,519,542,535,1596,9576
2016-08-14 14:00:00,588,611,608,1807,10842
2016-08-14 14:10:00,398,421,418,1237,7422
2016-08-14 14:20:00,238,262,256,756,4536
2016-08-14 14:30:00,304,331,323,958,5748
2016-08-14 14:40:00,357,382,375,1114,6684
2016-08-14 14:50:00,400,425,418,1243,7458
2016-08-14 15:00:00,524,548,536,1608,9648
2016-08-14 15:10:00,520,541,531,1592,9552
2016-08-14 15:20:00,452,471,467,1390,8340
2016-08-14 15:30:00,418,438,436,1292,7752
2016-08-14 15:40:00,375,397,390,1162,6972
2016-08-14 15:50:00,324,345,339,1008,6048
2016-08-14 16:00:00,234,256,251,741,4446
2016-08-14 16:10:00,223,245,242,710,4260
2016-08-14 16:20:00,282,304,299,885,5310
2016-08-14 16:30:00,284,305,301,890,5340
2016-08-14 16:40:00,240,275,249,764,4584
2016-08-14 16:50:00,235,267,245,747,4482
2016-08-14 17:00:00,210,231,227,668,4008
2016-08-14 17:10:00,219,242,237,698,4188
2016-08-14 17:20:00,210,232,228,670,4020
2016-08-14 17:30:00,172,196,192,560,3360
2016-08-14 17:40:00,155,297,13,465,2790
2016-08-14 17:50:00,140,252,65,457,2742
2016-08-14 18:00:00,112,158,180,450,2700
2016-08-14 18:10:00,87,242,97,426,2556
2016-08-14 18:20:00,29,167,185,381,2286
2016-08-14 18:30:00,105,58,130,293,1758
2016-08-14 18:40:00,95,37,114,246,1476
2016-08-14 18:50:00,61,77,80,218,1308
2016-08-14 19:00:00,59,68,79,206,1236
2016-08-14 19:10:00,59,57,82,198,1188
2016-08-14 19:20:00,59,35,70,164,984
2016-08-14 19:30:00,20,62,26,108,648
2016-08-14 19:40:00,14,37,22,73,438
2016-08-14 19:50:00,20,27,12,59,354
2016-08-14 20:00:00,13,17,17,47,282
2016-08-14 20:10:00,9,14,14,37,222
2016-08-14 20:20:00,3,7,5,15,90
2016-08-14 20:30:00,0,0,1,1,6
2016-08-14 20:40:00,0,0,0,0,0
2016-08-14 20:50:00,0,0,0,0,0
2016-08-14 21:00:00,0,0,0,0,0
2016-08-15 05:10:00,0,0,0,0,0
2016-08-15 05:20:00,0,0,0,0,0
2016-08-15 05:30:00,0,0,0,0,0
2016-08-15 05:40:00,0,0,0,0,0
2016-08-15 05:50:00,2,4,2,8,48
2016-08-15 06:00:00,8,20,10,38,228
2016-08-15 06:10:00,21,36,29,86,516
2016-08-15 06:20:00,32,61,53,146,876
2016-08-15 06:30:00,52,82,62,196,1176
2016-08-15 06:40:00,60,78,68,206,1236
2016-08-15 06:50:00,72,88,82,242,1452
2016-08-15 07:00:00,102,102,55,259,1554
2016-08-15 07:10:00,84,95,106,285,1710
2016-08-15 07:20:00,85,137,111,333,1998
2016-08-15 07:30:00,45,159,157,361,2166
2016-08-15 07:40:00,36,190,156,382,2292
2016-08-15 07:50:00,85,174,154,413,2478
2016-08-15 08:00:00,59,185,227,471,2826
2016-08-15 08:10:00,167,213,155,535,3210
2016-08-15 08:20:00,168,205,229,602,3612
2016-08-15 08:30:00,211,236,231,678,4068
2016-08-15 08:40:00,237,262,257,756,4536
2016-08-15 08:50:00,256,282,276,814,4884
2016-08-15 09:00:00,239,262,257,758,4548
2016-08-15 09:10:00,269,292,286,847,5082
2016-08-15 09:20:00,440,464,456,1360,8160
2016-08-15 09:30:00,598,624,612,1834,11004
2016-08-15 09:40:00,684,711,699,2094,12564
2016-08-15 09:50:00,528,557,549,1634,9804
2016-08-15 10:00:00,412,438,429,1279,7674
2016-08-15 10:10:00,416,439,429,1284,7704
2016-08-15 10:20:00,484,506,496,1486,8916
2016-08-15 10:30:00,424,448,439,1311,7866
2016-08-15 10:40:00,607,637,625,1869,11214
2016-08-15 10:50:00,687,725,708,2120,12720
2016-08-15 11:00:00,891,935,918,2744,16464
2016-08-15 11:10:00,811,850,835,2496,14976
2016-08-15 11:20:00,642,679,665,1986,11916
2016-08-15 11:30:00,845,892,876,2613,15678
2016-08-15 11:40:00,943,995,976,2914,17484
2016-08-15 11:50:00,605,645,631,1881,11286
2016-08-15 12:00:00,882,923,908,2713,16278
2016-08-15 12:10:00,847,887,876,2610,15660
2016-08-15 12:20:00,975,1023,1007,3005,18030
2016-08-15 12:30:00,932,988,976,2896,17376
2016-08-15 12:40:00,916,961,956,2833,16998
2016-08-15 12:50:00,1102,1143,1135,3380,20280
2016-08-15 13:00:00,1030,1066,1054,3150,18900
2016-08-15 13:10:00,944,977,967,2888,17328
2016-08-15 13:20:00,836,872,861,2569,15414
2016-08-15 13:30:00,880,910,907,2697,16182
2016-08-15 13:40:00,741,771,765,2277,13662
2016-08-15 13:50:00,593,622,613,1828,10968
2016-08-15 14:00:00,681,715,704,2100,12600
2016-08-15 14:10:00,986,1021,1014,3021,18126
2016-08-15 14:20:00,845,885,870,2600,15600
2016-08-15 14:30:00,976,1022,1007,3005,18030
2016-08-15 14:40:00,846,879,870,2595,15570
2016-08-15 14:50:00,570,599,592,1761,10566
2016-08-15 15:00:00,729,764,754,2247,13482
2016-08-15 15:10:00,740,776,765,2281,13686
2016-08-15 15:20:00,648,678,671,1997,11982
2016-08-15 15:30:00,772,801,782,2355,14130
2016-08-15 15:40:00,341,368,358,1067,6402
2016-08-15 15:50:00,475,506,494,1475,8850
2016-08-15 16:00:00,614,650,634,1898,11388
2016-08-15 16:10:00,396,422,414,1232,7392
2016-08-15 16:20:00,287,308,301,896,5376
2016-08-15 16:30:00,287,308,303,898,5388
2016-08-15 16:40:00,305,329,321,955,5730
2016-08-15 16:50:00,259,302,267,828,4968
2016-08-15 17:00:00,237,260,258,755,4530
2016-08-15 17:10:00,350,376,370,1096,6576
2016-08-15 17:20:00,193,234,209,636,3816
2016-08-15 17:30:00,191,218,211,620,3720
2016-08-15 17:40:00,83,194,258,535,3210
2016-08-15 17:50:00,162,153,173,488,2928
2016-08-15 18:00:00,169,130,173,472,2832
2016-08-15 18:10:00,70,147,142,359,2154
2016-08-15 18:20:00,69,99,97,265,1590
2016-08-15 18:30:00,60,75,77,212,1272
2016-08-15 18:40:00,38,64,48,150,900
2016-08-15 18:50:00,25,77,52,154,924
2016-08-15 19:00:00,39,58,69,166,996
2016-08-15 19:10:00,39,51,47,137,822
2016-08-15 19:20:00,39,57,46,142,852
2016-08-15 19:30:00,42,53,20,115,690
2016-08-15 19:40:00,24,36,31,91,546
2016-08-15 19:50:00,8,42,14,64,384
2016-08-15 20:00:00,9,16,15,40,240
2016-08-15 20:10:00,6,11,10,27,162
2016-08-15 20:20:00,2,6,2,10,60
2016-08-15 20:30:00,0,0,0,0,0
2016-08-15 20:40:00,0,0,0,0,0
2016-08-15 20:50:00,0,0,0,0,0
2016-08-15 21:00:00,0,0,0,0,0
2016-08-16 05:10:00,0,0,0,0,0
2016-08-16 05:20:00,0,0,0,0,0
2016-08-16 05:30:00,0,0,0,0,0
2016-08-16 05:40:00,0,0,0,0,0
2016-08-16 05:50:00,0,0,0,0,0
2016-08-16 06:00:00,1,2,1,4,24
2016-08-16 06:10:00,3,8,5,16,96
2016-08-16 06:20:00,4,16,7,27,162
2016-08-16 06:30:00,8,19,9,36,216
2016-08-16 06:40:00,9,28,12,49,294
2016-08-16 06:50:00,16,30,15,61,366
2016-08-16 07:00:00,13,39,18,70,420
2016-08-16 07:10:00,11,44,23,78,468
2016-08-16 07:20:00,20,35,30,85,510
2016-08-16 07:30:00,19,42,32,93,558
2016-08-16 07:40:00,25,44,34,103,618
2016-08-16 07:50:00,23,44,32,99,594
2016-08-16 08:00:00,65,124,125,314,1884
2016-08-16 08:10:00,171,208,155,534,3204
2016-08-16 08:20:00,224,277,212,713,4278
2016-08-16 08:30:00,276,301,295,872,5232
2016-08-16 08:40:00,330,358,352,1040,6240
2016-08-16 08:50:00,388,413,402,1203,7218
2016-08-16 09:00:00,446,473,463,1382,8292
2016-08-16 09:10:00,498,524,518,1540,9240
2016-08-16 09:20:00,565,592,587,1744,10464
2016-08-16 09:30:00,441,468,467,1376,8256
2016-08-16 09:40:00,345,370,364,1079,6474
2016-08-16 09:50:00,373,398,391,1162,6972
2016-08-16 10:00:00,485,513,504,1502,9012
2016-08-16 10:10:00,566,595,589,1750,10500
2016-08-16 10:20:00,502,530,524,1556,9336
2016-08-16 10:30:00,533,561,552,1646,9876
2016-08-16 10:40:00,508,536,527,1571,9426
2016-08-16 10:50:00,433,460,452,1345,8070
2016-08-16 11:00:00,443,469,458,1370,8220
2016-08-16 11:10:00,527,549,537,1613,9678
2016-08-16 11:20:00,812,836,822,2470,14820
2016-08-16 11:30:00,739,755,747,2241,13446
2016-08-16 11:40:00,1004,997,1014,3015,18090
2016-08-16 11:50:00,982,991,1000,2973,17838
2016-08-16 12:00:00,984,1001,1009,2994,17964
2016-08-16 12:10:00,992,1021,1006,3019,18114
2016-08-16 12:20:00,1007,988,1012,3007,18042
2016-08-16 12:30:00,951,960,951,2862,17172
2016-08-16 12:40:00,501,520,515,1536,9216
2016-08-16 12:50:00,507,528,524,1559,9354
2016-08-16 13:00:00,352,373,370,1095,6570
2016-08-16 13:10:00,416,438,434,1288,7728
2016-08-16 13:20:00,432,452,448,1332,7992
2016-08-16 13:30:00,685,707,702,2094,12564
2016-08-16 13:40:00,734,754,741,2229,13374
2016-08-16 13:50:00,659,685,669,2013,12078
2016-08-16 14:00:00,803,832,816,2451,14706
2016-08-16 14:10:00,511,533,523,1567,9402
2016-08-16 14:20:00,468,487,483,1438,8628
2016-08-16 14:30:00,410,432,427,1269,7614
2016-08-16 14:40:00,428,451,442,1321,7926
2016-08-16 14:50:00,374,396,388,1158,6948
2016-08-16 15:00:00,595,619,605,1819,10914
2016-08-16 15:10:00,565,590,579,1734,10404
2016-08-16 15:20:00,407,429,422,1258,7548
2016-08-16 15:30:00,379,401,396,1176,7056
2016-08-16 15:40:00,441,466,460,1367,8202
2016-08-16 15:50:00,740,765,749,2254,13524
2016-08-16 16:00:00,680,704,693,2077,12462
2016-08-16 16:10:00,628,649,642,1919,11514
2016-08-16 16:20:00,587,610,603,1800,10800
2016-08-16 16:30:00,548,573,570,1691,10146
2016-08-16 16:40:00,503,524,526,1553,9318
2016-08-16 16:50:00,454,480,475,1409,8454
2016-08-16 17:00:00,399,429,423,1251,7506
2016-08-16 17:10:00,350,374,370,1094,6564
2016-08-16 17:20:00,322,343,340,1005,6030
2016-08-16 17:30:00,302,329,320,951,5706
2016-08-16 17:40:00,267,291,287,845,5070
2016-08-16 17:50:00,213,234,233,680,4080
2016-08-16 18:00:00,173,193,191,557,3342
2016-08-16 18:10:00,135,156,152,443,2658
2016-08-16 18:20:00,94,111,110,315,1890
2016-08-16 18:30:00,55,72,74,201,1206
2016-08-16 18:40:00,23,50,27,100,600
2016-08-16 18:50:00,23,35,27,85,510
2016-08-16 19:00:00,25,32,35,92,552
2016-08-16 19:10:00,22,36,26,84,504
2016-08-16 19:20:00,21,34,18,73,438
2016-08-16 19:30:00,17,28,18,63,378
2016-08-16 19:40:00,26,19,9,54,324
2016-08-16 19:50:00,15,14,13,42,252
2016-08-16 20:00:00,8,10,11,29,174
2016-08-16 20:10:00,5,6,5,16,96
2016-08-16 20:20:00,0,1,1,2,12
2016-08-16 20:30:00,0,0,0,0,0
2016-08-16 20:40:00,0,0,0,0,0
2016-08-16 20:50:00,0,0,0,0,0
2016-08-16 21:00:00,0,0,0,0,0
2016-08-17 05:20:00,0,0,0,0,0
2016-08-17 05:30:00,0,0,0,0,0
2016-08-17 05:40:00,0,0,0,0,0
2016-08-17 05:50:00,0,3,1,4,24
2016-08-17 06:00:00,7,19,13,39,234
2016-08-17 06:10:00,13,33,23,69,414
2016-08-17 06:20:00,13,40,18,71,426
2016-08-17 06:30:00,12,37,22,71,426
2016-08-17 06:40:00,15,42,22,79,474
2016-08-17 06:50:00,23,47,31,101,606
2016-08-17 07:00:00,18,81,25,124,744
2016-08-17 07:10:00,34,57,54,145,870
2016-08-17 07:20:00,30,58,57,145,870
2016-08-17 07:30:00,31,58,55,144,864
2016-08-17 07:40:00,30,64,48,142,852
2016-08-17 07:50:00,32,53,51,136,816
2016-08-17 08:00:00,32,59,44,135,810
2016-08-17 08:10:00,199,191,119,509,3054
2016-08-17 08:20:00,225,264,226,715,4290
2016-08-17 08:30:00,275,303,294,872,5232
2016-08-17 08:40:00,336,360,353,1049,6294
2016-08-17 08:50:00,397,413,408,1218,7308
2016-08-17 09:00:00,451,473,468,1392,8352
2016-08-17 09:10:00,507,532,525,1564,9384
2016-08-17 09:20:00,564,589,582,1735,10410
2016-08-17 09:30:00,619,651,641,1911,11466
2016-08-17 09:40:00,673,706,695,2074,12444
2016-08-17 09:50:00,723,751,733,2207,13242
2016-08-17 10:00:00,765,781,775,2321,13926
2016-08-17 10:10:00,806,825,820,2451,14706
2016-08-17 10:20:00,837,856,844,2537,15222
2016-08-17 10:30:00,861,874,870,2605,15630
2016-08-17 10:40:00,873,896,894,2663,15978
2016-08-17 10:50:00,895,921,920,2736,16416
2016-08-17 11:00:00,910,943,937,2790,16740
2016-08-17 11:10:00,935,954,945,2834,17004
2016-08-17 11:20:00,947,974,959,2880,17280
2016-08-17 11:30:00,959,987,974,2920,17520
2016-08-17 11:40:00,977,998,987,2962,17772
2016-08-17 11:50:00,986,1010,1000,2996,17976
2016-08-17 12:00:00,996,1017,1007,3020,18120
2016-08-17 12:10:00,1004,1027,1011,3042,18252
2016-08-17 12:20:00,1016,1030,1029,3075,18450
2016-08-17 12:30:00,1017,1042,1031,3090,18540
2016-08-17 12:40:00,1022,1043,1034,3099,18594
2016-08-17 12:50:00,1021,1049,1039,3109,18654
2016-08-17 13:00:00,1024,1047,1035,3106,18636
2016-08-17 13:10:00,1020,1042,1038,3100,18600
2016-08-17 13:20:00,1019,1041,1030,3090,18540
2016-08-17 13:30:00,1012,1041,1023,3076,18456
2016-08-17 13:40:00,998,1031,1017,3046,18276
2016-08-17 13:50:00,997,1021,1009,3027,18162
2016-08-17 14:00:00,989,1008,995,2992,17952
2016-08-17 14:10:00,975,996,986,2957,17742
2016-08-17 14:20:00,958,983,974,2915,17490
2016-08-17 14:30:00,944,970,958,2872,17232
2016-08-17 14:40:00,931,953,944,2828,16968
2016-08-17 14:50:00,912,934,928,2774,16644
2016-08-17 15:00:00,888,920,911,2719,16314
2016-08-17 15:10:00,856,884,874,2614,15684
2016-08-17 15:20:00,814,842,833,2489,14934
2016-08-17 15:30:00,783,807,801,2391,14346
2016-08-17 15:40:00,750,775,768,2293,13758
2016-08-17 15:50:00,699,724,718,2141,12846
2016-08-17 16:00:00,668,692,688,2048,12288
2016-08-17 16:10:00,618,643,639,1900,11400
2016-08-17 16:20:00,572,597,591,1760,10560
2016-08-17 16:30:00,537,561,550,1648,9888
2016-08-17 16:40:00,489,513,502,1504,9024
2016-08-17 16:50:00,435,462,452,1349,8094
2016-08-17 17:00:00,382,410,401,1193,7158
2016-08-17 17:10:00,331,359,350,1040,6240
2016-08-17 17:20:00,301,326,317,944,5664
2016-08-17 17:30:00,275,301,293,869,5214
2016-08-17 17:40:00,243,266,258,767,4602
2016-08-17 17:50:00,193,215,209,617,3702
2016-08-17 18:00:00,155,178,172,505,3030
2016-08-17 18:10:00,69,158,159,386,2316
2016-08-17 18:20:00,36,129,124,289,1734
2016-08-17 18:30:00,50,67,69,186,1116
2016-08-17 18:40:00,20,67,27,114,684
2016-08-17 18:50:00,14,99,20,133,798
2016-08-17 19:00:00,54,58,72,184,1104
2016-08-17 19:10:00,40,55,67,162,972
2016-08-17 19:20:00,23,73,24,120,720
2016-08-17 19:30:00,26,62,39,127,762
2016-08-17 19:40:00,20,33,25,78,468
2016-08-17 19:50:00,16,27,18,61,366
2016-08-17 20:00:00,7,9,9,25,150
2016-08-17 20:10:00,2,3,4,9,54
2016-08-17 20:20:00,0,0,0,0,0
2016-08-17 20:30:00,0,0,0,0,0
2016-08-17 20:40:00,0,0,0,0,0
2016-08-17 20:50:00,0,0,0,0,0
2016-08-18 05:20:00,0,0,0,0,0
2016-08-18 05:30:00,0,0,0,0,0
2016-08-18 05:40:00,0,0,0,0,0
2016-08-18 05:50:00,0,0,0,0,0
2016-08-18 06:00:00,0,0,0,0,0
2016-08-18 06:10:00,0,0,0,0,0
2016-08-18 06:20:00,8,8,9,25,150
2016-08-18 06:30:00,6,8,9,23,138
2016-08-18 06:40:00,14,24,9,47,282
2016-08-18 06:50:00,21,35,17,73,438
2016-08-18 07:00:00,24,45,26,95,570
2016-08-18 07:10:00,38,48,40,126,756
2016-08-18 07:20:00,37,64,50,151,906
2016-08-18 07:30:00,54,84,81,219,1314
2016-08-18 07:40:00,68,106,99,273,1638
2016-08-18 07:50:00,69,124,113,306,1836
2016-08-18 08:00:00,104,155,168,427,2562
2016-08-18 08:10:00,86,150,188,424,2544
2016-08-18 08:20:00,133,162,179,474,2844
2016-08-18 08:30:00,159,172,178,509,3054
2016-08-18 08:40:00,115,138,133,386,2316
2016-08-18 08:50:00,70,102,90,262,1572
2016-08-18 09:00:00,231,234,253,718,4308
2016-08-18 09:10:00,246,269,264,779,4674
2016-08-18 09:20:00,447,476,469,1392,8352
2016-08-18 09:30:00,597,629,620,1846,11076
2016-08-18 09:40:00,654,680,676,2010,12060
2016-08-18 09:50:00,700,727,721,2148,12888
2016-08-18 10:00:00,410,437,428,1275,7650
2016-08-18 10:10:00,759,788,776,2323,13938
2016-08-18 10:20:00,563,585,570,1718,10308
2016-08-18 10:30:00,369,391,385,1145,6870
2016-08-18 10:40:00,450,479,470,1399,8394
2016-08-18 10:50:00,188,217,204,609,3654
2016-08-18 11:00:00,184,208,203,595,3570
2016-08-18 11:10:00,229,318,182,729,4374
2016-08-18 11:20:00,319,266,283,868,5208
2016-08-18 11:30:00,153,262,114,529,3174
2016-08-18 11:40:00,177,203,195,575,3450
2016-08-18 11:50:00,223,252,242,717,4302
2016-08-18 12:00:00,205,231,224,660,3960
2016-08-18 12:10:00,180,222,198,600,3600
2016-08-18 12:20:00,353,380,370,1103,6618
2016-08-18 12:30:00,88,120,113,321,1926
2016-08-18 12:40:00,73,187,104,364,2184
2016-08-18 12:50:00,212,229,262,703,4218
2016-08-18 13:00:00,64,62,75,201,1206
2016-08-18 13:10:00,234,239,244,717,4302
2016-08-18 13:20:00,276,305,297,878,5268
2016-08-18 13:30:00,114,138,134,386,2316
2016-08-18 13:40:00,219,233,249,701,4206
2016-08-18 13:50:00,382,409,401,1192,7152
2016-08-18 14:00:00,525,551,542,1618,9708
2016-08-18 14:10:00,273,297,293,863,5178
2016-08-18 14:20:00,64,81,78,223,1338
2016-08-18 14:30:00,264,332,295,891,5346
2016-08-18 14:40:00,62,71,72,205,1230
2016-08-18 14:50:00,300,319,289,908,5448
2016-08-18 15:00:00,185,203,202,590,3540
2016-08-18 15:10:00,470,513,523,1506,9036
2016-08-18 15:20:00,717,742,738,2197,13182
2016-08-18 15:30:00,482,501,495,1478,8868
2016-08-18 15:40:00,274,295,291,860,5160
2016-08-18 15:50:00,356,378,373,1107,6642
2016-08-18 16:00:00,394,439,431,1264,7584
2016-08-18 16:10:00,638,676,667,1981,11886
2016-08-18 16:20:00,627,667,653,1947,11682
2016-08-18 16:30:00,123,152,149,424,2544
2016-08-18 16:40:00,375,415,408,1198,7188
2016-08-18 16:50:00,261,293,303,857,5142
2016-08-18 17:00:00,135,232,191,558,3348
2016-08-18 17:10:00,149,173,159,481,2886
2016-08-18 17:20:00,12,17,20,49,294
2016-08-18 17:30:00,17,50,38,105,630
2016-08-18 17:40:00,62,82,117,261,1566
2016-08-18 17:50:00,86,133,112,331,1986
2016-08-18 18:00:00,87,65,110,262,1572
2016-08-18 18:10:00,84,56,110,250,1500
2016-08-18 18:20:00,85,44,94,223,1338
2016-08-18 18:30:00,48,55,62,165,990
2016-08-18 18:40:00,59,45,76,180,1080
2016-08-18 18:50:00,65,58,63,186,1116
2016-08-18 19:00:00,61,62,59,182,1092
2016-08-18 19:10:00,40,69,29,138,828
2016-08-18 19:20:00,30,30,33,93,558
2016-08-18 19:30:00,18,16,23,57,342
2016-08-18 19:40:00,13,15,11,39,234
2016-08-18 19:50:00,4,4,5,13,78
2016-08-18 20:00:00,0,0,0,0,0
2016-08-18 20:10:00,0,0,0,0,0
2016-08-18 20:20:00,0,0,0,0,0
2016-08-18 20:30:00,0,0,0,0,0
2016-08-18 20:40:00,0,0,0,0,0
2016-08-19 05:20:00,0,0,0,0,0
2016-08-19 05:30:00,0,0,0,0,0
2016-08-19 05:40:00,0,0,0,0,0
2016-08-19 05:50:00,0,0,0,0,0
2016-08-19 06:00:00,1,4,1,6,36
2016-08-19 06:10:00,4,13,8,25,150
2016-08-19 06:20:00,7,22,19,48,288
2016-08-19 06:30:00,10,32,22,64,384
2016-08-19 06:40:00,13,36,23,72,432
2016-08-19 06:50:00,16,32,22,70,420
2016-08-19 07:00:00,12,37,23,72,432
2016-08-19 07:10:00,13,43,28,84,504
2016-08-19 07:20:00,17,45,30,92,552
2016-08-19 07:30:00,31,45,34,110,660
2016-08-19 07:40:00,10,94,14,118,708
2016-08-19 07:50:00,29,56,45,130,780
2016-08-19 08:00:00,39,56,52,147,882
2016-08-19 08:10:00,99,177,191,467,2802
2016-08-19 08:20:00,187,212,211,610,3660
2016-08-19 08:30:00,105,85,125,315,1890
2016-08-19 08:40:00,289,304,307,900,5400
2016-08-19 08:50:00,361,386,377,1124,6744
2016-08-19 09:00:00,300,322,314,936,5616
2016-08-19 09:10:00,269,260,266,795,4770
2016-08-19 09:20:00,507,518,520,1545,9270
2016-08-19 09:30:00,181,207,202,590,3540
2016-08-19 09:40:00,95,119,129,343,2058
2016-08-19 09:50:00,527,571,562,1660,9960
2016-08-19 10:00:00,373,401,394,1168,7008
2016-08-19 10:10:00,156,132,180,468,2808
2016-08-19 10:20:00,780,811,804,2395,14370
2016-08-19 10:30:00,912,944,929,2785,16710
2016-08-19 10:40:00,822,869,858,2549,15294
2016-08-19 10:50:00,897,936,935,2768,16608
2016-08-19 11:00:00,1013,1058,1048,3119,18714
2016-08-19 11:10:00,996,1028,1015,3039,18234
2016-08-19 11:20:00,331,331,336,998,5988
2016-08-19 11:30:00,257,280,277,814,4884
2016-08-19 11:40:00,236,262,257,755,4530
2016-08-19 11:50:00,198,224,218,640,3840
2016-08-19 12:00:00,326,352,344,1022,6132
2016-08-19 12:10:00,180,204,199,583,3498
2016-08-19 12:20:00,222,246,241,709,4254
2016-08-19 12:30:00,332,356,350,1038,6228
2016-08-19 12:40:00,229,254,249,732,4392
2016-08-19 12:50:00,240,262,258,760,4560
2016-08-19 13:00:00,187,209,206,602,3612
2016-08-19 13:10:00,217,204,203,624,3744
2016-08-19 13:20:00,738,758,756,2252,13512
2016-08-19 13:30:00,1085,1102,1103,3290,19740
2016-08-19 13:40:00,604,619,616,1839,11034
2016-08-19 13:50:00,740,760,751,2251,13506
2016-08-19 14:00:00,262,283,280,825,4950
2016-08-19 14:10:00,710,730,726,2166,12996
2016-08-19 14:20:00,391,411,407,1209,7254
2016-08-19 14:30:00,164,184,182,530,3180
2016-08-19 14:40:00,130,151,147,428,2568
2016-08-19 14:50:00,140,213,92,445,2670
2016-08-19 15:00:00,157,150,133,440,2640
2016-08-19 15:10:00,173,132,190,495,2970
2016-08-19 15:20:00,153,133,194,480,2880
2016-08-19 15:30:00,149,271,69,489,2934
2016-08-19 15:40:00,164,293,150,607,3642
2016-08-19 15:50:00,353,376,370,1099,6594
2016-08-19 16:00:00,515,537,531,1583,9498
2016-08-19 16:10:00,616,637,630,1883,11298
2016-08-19 16:20:00,510,528,520,1558,9348
2016-08-19 16:30:00,533,550,548,1631,9786
2016-08-19 16:40:00,488,505,496,1489,8934
2016-08-19 16:50:00,439,456,454,1349,8094
2016-08-19 17:00:00,379,399,396,1174,7044
2016-08-19 17:10:00,322,344,340,1006,6036
2016-08-19 17:20:00,283,308,300,891,5346
2016-08-19 17:30:00,261,282,275,818,4908
2016-08-19 17:40:00,235,258,250,743,4458
2016-08-19 17:50:00,189,212,204,605,3630
2016-08-19 18:00:00,144,167,161,472,2832
2016-08-19 18:10:00,92,138,137,367,2202
2016-08-19 18:20:00,63,90,123,276,1656
2016-08-19 18:30:00,32,74,59,165,990
2016-08-19 18:40:00,23,53,31,107,642
2016-08-19 18:50:00,36,68,48,152,912
2016-08-19 19:00:00,44,68,68,180,1080
2016-08-19 19:10:00,47,50,56,153,918
2016-08-19 19:20:00,27,78,30,135,810
2016-08-19 19:30:00,26,55,26,107,642
2016-08-19 19:40:00,47,31,14,92,552
2016-08-19 19:50:00,23,34,11,68,408
2016-08-19 20:00:00,10,19,13,42,252
2016-08-19 20:10:00,1,6,4,11,66
2016-08-19 20:20:00,0,0,0,0,0
2016-08-19 20:30:00,0,0,0,0,0
2016-08-19 20:40:00,0,0,0,0,0
2016-08-19 20:50:00,0,0,0,0,0
2016-08-20 05:40:00,0,0,0,0,0
2016-08-20 05:50:00,0,0,0,0,0
2016-08-20 06:00:00,0,0,0,0,0
2016-08-20 06:10:00,0,0,0,0,0
2016-08-20 06:20:00,0,0,0,0,0
2016-08-20 06:30:00,2,3,1,6,36
2016-08-20 06:40:00,8,19,8,35,210
2016-08-20 06:50:00,13,39,26,78,468
2016-08-20 07:00:00,5,8,5,18,108
2016-08-20 07:10:00,0,0,0,0,0
2016-08-20 07:20:00,2,5,2,9,54
2016-08-20 07:30:00,1,3,1,5,30
2016-08-20 07:40:00,3,4,3,10,60
2016-08-20 07:50:00,5,9,10,24,144
2016-08-20 08:00:00,11,14,17,42,252
2016-08-20 08:10:00,5,8,6,19,114
2016-08-20 08:20:00,8,14,6,28,168
2016-08-20 08:30:00,15,26,8,49,294
2016-08-20 08:40:00,10,16,11,37,222
2016-08-20 08:50:00,6,12,10,28,168
2016-08-20 09:00:00,11,19,13,43,258
2016-08-20 09:10:00,13,29,16,58,348
2016-08-20 09:20:00,45,64,49,158,948
2016-08-20 09:30:00,48,61,63,172,1032
2016-08-20 09:40:00,47,103,104,254,1524
2016-08-20 09:50:00,81,63,86,230,1380
2016-08-20 10:00:00,64,78,125,267,1602
2016-08-20 10:10:00,86,67,92,245,1470
2016-08-20 10:20:00,58,80,70,208,1248
2016-08-20 10:30:00,72,78,77,227,1362
2016-08-20 10:40:00,136,110,121,367,2202
2016-08-20 10:50:00,155,195,152,502,3012
2016-08-20 11:00:00,145,159,180,484,2904
2016-08-20 11:10:00,138,302,59,499,2994
2016-08-20 11:20:00,261,185,206,652,3912
2016-08-20 11:30:00,182,203,199,584,3504
2016-08-20 11:40:00,221,242,237,700,4200
2016-08-20 11:50:00,149,164,131,444,2664
2016-08-20 12:00:00,356,308,331,995,5970
2016-08-20 12:10:00,455,478,471,1404,8424
2016-08-20 12:20:00,392,411,409,1212,7272
2016-08-20 12:30:00,399,419,414,1232,7392
2016-08-20 12:40:00,373,393,389,1155,6930
2016-08-20 12:50:00,434,456,449,1339,8034
2016-08-20 13:00:00,232,254,252,738,4428
2016-08-20 13:10:00,136,231,83,450,2700
2016-08-20 13:20:00,55,169,226,450,2700
2016-08-20 13:30:00,238,293,274,805,4830
2016-08-20 13:40:00,328,347,340,1015,6090
2016-08-20 13:50:00,321,342,334,997,5982
2016-08-20 14:00:00,408,431,419,1258,7548
2016-08-20 14:10:00,439,459,452,1350,8100
2016-08-20 14:20:00,403,424,419,1246,7476
2016-08-20 14:30:00,186,208,203,597,3582
2016-08-20 14:40:00,128,147,143,418,2508
2016-08-20 14:50:00,41,81,63,185,1110
2016-08-20 15:00:00,43,68,59,170,1020
2016-08-20 15:10:00,90,150,112,352,2112
2016-08-20 15:20:00,176,184,189,549,3294
2016-08-20 15:30:00,56,93,85,234,1404
2016-08-20 15:40:00,31,97,79,207,1242
2016-08-20 15:50:00,59,148,154,361,2166
2016-08-20 16:00:00,34,156,153,343,2058
2016-08-20 16:10:00,211,249,222,682,4092
2016-08-20 16:20:00,158,206,150,514,3084
2016-08-20 16:30:00,157,186,155,498,2988
2016-08-20 16:40:00,99,135,136,370,2220
2016-08-20 16:50:00,95,67,100,262,1572
2016-08-20 17:00:00,67,73,109,249,1494
2016-08-20 17:10:00,55,140,143,338,2028
2016-08-20 17:20:00,20,123,119,262,1572
2016-08-20 17:30:00,48,80,70,198,1188
2016-08-20 17:40:00,43,64,67,174,1044
2016-08-20 17:50:00,46,79,60,185,1110
2016-08-20 18:00:00,73,83,75,231,1386
2016-08-20 18:10:00,39,80,61,180,1080
2016-08-20 18:20:00,26,61,35,122,732
2016-08-20 18:30:00,25,66,39,130,780
2016-08-20 18:40:00,35,78,89,202,1212
2016-08-20 18:50:00,41,117,138,296,1776
2016-08-20 19:00:00,22,117,129,268,1608
2016-08-20 19:10:00,74,57,94,225,1350
2016-08-20 19:20:00,58,84,78,220,1320
2016-08-20 19:30:00,53,85,67,205,1230
2016-08-20 19:40:00,44,77,53,174,1044
2016-08-20 19:50:00,15,53,25,93,558
2016-08-20 20:00:00,3,12,8,23,138
2016-08-20 20:10:00,0,1,1,2,12
2016-08-20 20:20:00,0,0,0,0,0
2016-08-20 20:30:00,0,0,0,0,0
2016-08-20 20:40:00,0,0,0,0,0
2016-08-21 05:30:00,0,0,0,0,0
2016-08-21 05:40:00,0,0,0,0,0
2016-08-21 05:50:00,0,0,0,0,0
2016-08-21 06:00:00,0,0,0,0,0
2016-08-21 06:10:00,2,5,3,10,60
2016-08-21 06:20:00,4,13,8,25,150
2016-08-21 06:30:00,8,19,12,39,234
2016-08-21 06:40:00,10,25,16,51,306
2016-08-21 06:50:00,18,31,24,73,438
2016-08-21 07:00:00,38,68,52,158,948
2016-08-21 07:10:00,58,78,71,207,1242
2016-08-21 07:20:00,49,67,51,167,1002
2016-08-21 07:30:00,25,48,19,92,552
2016-08-21 07:40:00,28,55,32,115,690
2016-08-21 07:50:00,54,83,63,200,1200
2016-08-21 08:00:00,39,116,106,261,1566
2016-08-21 08:10:00,34,80,72,186,1116
2016-08-21 08:20:00,84,123,130,337,2022
2016-08-21 08:30:00,207,298,193,698,4188
2016-08-21 08:40:00,214,237,225,676,4056
2016-08-21 08:50:00,254,280,270,804,4824
2016-08-21 09:00:00,296,321,315,932,5592
2016-08-21 09:10:00,255,273,270,798,4788
2016-08-21 09:20:00,357,373,372,1102,6612
2016-08-21 09:30:00,209,228,224,661,3966
2016-08-21 09:40:00,499,524,519,1542,9252
2016-08-21 09:50:00,309,329,323,961,5766
2016-08-21 10:00:00,151,171,169,491,2946
2016-08-21 10:10:00,265,213,185,663,3978
2016-08-21 10:20:00,269,291,286,846,5076
2016-08-21 10:30:00,250,274,270,794,4764
2016-08-21 10:40:00,466,487,487,1440,8640
2016-08-21 10:50:00,635,660,651,1946,11676
2016-08-21 11:00:00,923,941,942,2806,16836
2016-08-21 11:10:00,952,975,965,2892,17352
2016-08-21 11:20:00,977,1005,986,2968,17808
2016-08-21 11:30:00,972,993,977,2942,17652
2016-08-21 11:40:00,972,988,974,2934,17604
2016-08-21 11:50:00,981,1005,995,2981,17886
2016-08-21 12:00:00,974,1005,992,2971,17826
2016-08-21 12:10:00,983,1005,996,2984,17904
2016-08-21 12:20:00,990,1009,999,2998,17988
2016-08-21 12:30:00,1005,1025,1012,3042,18252
2016-08-21 12:40:00,1003,1036,1021,3060,18360
2016-08-21 12:50:00,1007,1031,1020,3058,18348
2016-08-21 13:00:00,1005,1034,1025,3064,18384
2016-08-21 13:10:00,997,1024,1015,3036,18216
2016-08-21 13:20:00,1005,1024,1010,3039,18234
2016-08-21 13:30:00,751,775,765,2291,13746
2016-08-21 13:40:00,714,736,729,2179,13074
2016-08-21 13:50:00,550,571,564,1685,10110
2016-08-21 14:00:00,828,857,845,2530,15180
2016-08-21 14:10:00,968,1010,993,2971,17826
2016-08-21 14:20:00,945,979,965,2889,17334
2016-08-21 14:30:00,926,956,941,2823,16938
2016-08-21 14:40:00,899,937,922,2758,16548
2016-08-21 14:50:00,864,898,885,2647,15882
2016-08-21 15:00:00,565,595,586,1746,10476
2016-08-21 15:10:00,346,369,398,1113,6678
2016-08-21 15:20:00,601,638,629,1868,11208
2016-08-21 15:30:00,752,782,774,2308,13848
2016-08-21 15:40:00,711,746,736,2193,13158
2016-08-21 15:50:00,673,700,697,2070,12420
2016-08-21 16:00:00,646,671,665,1982,11892
2016-08-21 16:10:00,596,628,620,1844,11064
2016-08-21 16:20:00,156,223,108,487,2922
2016-08-21 16:30:00,299,323,314,936,5616
2016-08-21 16:40:00,114,159,148,421,2526
2016-08-21 16:50:00,74,94,92,260,1560
2016-08-21 17:00:00,66,119,152,337,2022
2016-08-21 17:10:00,65,136,145,346,2076
2016-08-21 17:20:00,106,189,179,474,2844
2016-08-21 17:30:00,176,203,194,573,3438
2016-08-21 17:40:00,73,179,151,403,2418
2016-08-21 17:50:00,83,142,153,378,2268
2016-08-21 18:00:00,91,164,168,423,2538
2016-08-21 18:10:00,139,300,36,475,2850
2016-08-21 18:20:00,44,151,145,340,2040
2016-08-21 18:30:00,37,89,93,219,1314
2016-08-21 18:40:00,45,51,61,157,942
2016-08-21 18:50:00,31,76,83,190,1140
2016-08-21 19:00:00,27,71,66,164,984
2016-08-21 19:10:00,14,80,81,175,1050
2016-08-21 19:20:00,47,56,21,124,744
2016-08-21 19:30:00,27,43,32,102,612
2016-08-21 19:40:00,12,19,19,50,300
2016-08-21 19:50:00,5,9,12,26,156
2016-08-21 20:00:00,2,8,5,15,90
2016-08-21 20:10:00,0,1,0,1,6
2016-08-21 20:20:00,0,0,0,0,0
2016-08-21 20:30:00,0,0,0,0,0
2016-08-21 20:40:00,0,0,0,0,0
2016-08-22 05:30:00,0,0,0,0,0
2016-08-22 05:40:00,0,0,0,0,0
2016-08-22 05:50:00,0,0,0,0,0
2016-08-22 06:00:00,0,0,0,0,0
2016-08-22 06:10:00,0,1,1,2,12
2016-08-22 06:20:00,2,6,5,13,78
2016-08-22 06:30:00,4,16,9,29,174
2016-08-22 06:40:00,7,21,15,43,258
2016-08-22 06:50:00,13,25,20,58,348
2016-08-22 07:00:00,18,32,27,77,462
2016-08-22 07:10:00,30,41,40,111,666
2016-08-22 07:20:00,36,69,45,150,900
2016-08-22 07:30:00,28,59,51,138,828
2016-08-22 07:40:00,36,77,67,180,1080
2016-08-22 07:50:00,31,75,70,176,1056
2016-08-22 08:00:00,45,52,62,159,954
2016-08-22 08:10:00,71,95,93,259,1554
2016-08-22 08:20:00,40,112,129,281,1686
2016-08-22 08:30:00,193,335,157,685,4110
2016-08-22 08:40:00,290,314,309,913,5478
2016-08-22 08:50:00,346,373,367,1086,6516
2016-08-22 09:00:00,405,430,426,1261,7566
2016-08-22 09:10:00,463,482,482,1427,8562
2016-08-22 09:20:00,473,494,487,1454,8724
2016-08-22 09:30:00,535,562,553,1650,9900
2016-08-22 09:40:00,625,649,646,1920,11520
2016-08-22 09:50:00,645,668,664,1977,11862
2016-08-22 10:00:00,524,553,545,1622,9732
2016-08-22 10:10:00,418,443,438,1299,7794
2016-08-22 10:20:00,737,756,752,2245,13470
2016-08-22 10:30:00,591,620,610,1821,10926
2016-08-22 10:40:00,709,739,727,2175,13050
2016-08-22 10:50:00,856,873,869,2598,15588
2016-08-22 11:00:00,755,771,770,2296,13776
2016-08-22 11:10:00,726,755,743,2224,13344
2016-08-22 11:20:00,631,665,651,1947,11682
2016-08-22 11:30:00,725,755,747,2227,13362
2016-08-22 11:40:00,978,1010,996,2984,17904
2016-08-22 11:50:00,974,1011,995,2980,17880
2016-08-22 12:00:00,885,911,904,2700,16200
2016-08-22 12:10:00,855,883,875,2613,15678
2016-08-22 12:20:00,937,965,952,2854,17124
2016-08-22 12:30:00,995,1018,1008,3021,18126
2016-08-22 12:40:00,1006,1039,1027,3072,18432
2016-08-22 12:50:00,1016,1043,1032,3091,18546
2016-08-22 13:00:00,1001,1027,1018,3046,18276
2016-08-22 13:10:00,835,860,853,2548,15288
2016-08-22 13:20:00,796,819,812,2427,14562
2016-08-22 13:30:00,396,421,415,1232,7392
2016-08-22 13:40:00,717,742,737,2196,13176
2016-08-22 13:50:00,979,1000,992,2971,17826
2016-08-22 14:00:00,855,887,876,2618,15708
2016-08-22 14:10:00,397,426,419,1242,7452
2016-08-22 14:20:00,623,647,640,1910,11460
2016-08-22 14:30:00,306,329,325,960,5760
2016-08-22 14:40:00,314,342,333,989,5934
2016-08-22 14:50:00,428,455,450,1333,7998
2016-08-22 15:00:00,286,311,306,903,5418
2016-08-22 15:10:00,208,229,269,706,4236
2016-08-22 15:20:00,182,200,210,592,3552
2016-08-22 15:30:00,117,129,136,382,2292
2016-08-22 15:40:00,160,177,201,538,3228
2016-08-22 15:50:00,251,276,271,798,4788
2016-08-22 16:00:00,195,224,219,638,3828
2016-08-22 16:10:00,139,163,157,459,2754
2016-08-22 16:20:00,47,76,71,194,1164
2016-08-22 16:30:00,57,86,80,223,1338
2016-08-22 16:40:00,75,103,106,284,1704
2016-08-22 16:50:00,98,179,98,375,2250
2016-08-22 17:00:00,54,206,133,393,2358
2016-08-22 17:10:00,201,246,201,648,3888
2016-08-22 17:20:00,149,196,189,534,3204
2016-08-22 17:30:00,90,135,161,386,2316
2016-08-22 17:40:00,82,69,119,270,1620
2016-08-22 17:50:00,85,46,104,235,1410
2016-08-22 18:00:00,114,51,125,290,1740
2016-08-22 18:10:00,102,67,123,292,1752
2016-08-22 18:20:00,54,72,67,193,1158
2016-08-22 18:30:00,18,50,29,97,582
2016-08-22 18:40:00,13,48,27,88,528
2016-08-22 18:50:00,14,39,26,79,474
2016-08-22 19:00:00,14,22,21,57,342
2016-08-22 19:10:00,10,17,13,40,240
2016-08-22 19:20:00,6,12,7,25,150
2016-08-22 19:30:00,0,0,0,0,0
2016-08-22 19:40:00,0,0,0,0,0
2016-08-22 19:50:00,0,0,0,0,0
2016-08-22 20:00:00,0,0,0,0,0
2016-08-22 20:10:00,0,0,0,0,0
2016-08-22 20:20:00,0,0,0,0,0
2016-08-22 20:30:00,0,0,0,0,0
2016-08-23 05:30:00,0,0,0,0,0
2016-08-23 05:40:00,0,0,0,0,0
2016-08-23 05:50:00,0,0,0,0,0
2016-08-23 06:00:00,0,0,0,0,0
2016-08-23 06:10:00,0,0,0,0,0
2016-08-23 06:20:00,2,6,3,11,66
2016-08-23 06:30:00,5,11,10,26,156
2016-08-23 06:40:00,4,10,7,21,126
2016-08-23 06:50:00,3,13,7,23,138
2016-08-23 07:00:00,27,30,32,89,534
2016-08-23 07:10:00,27,56,32,115,690
2016-08-23 07:20:00,23,77,45,145,870
2016-08-23 07:30:00,45,83,52,180,1080
2016-08-23 07:40:00,31,117,115,263,1578
2016-08-23 07:50:00,25,133,132,290,1740
2016-08-23 08:00:00,38,118,109,265,1590
2016-08-23 08:10:00,81,102,89,272,1632
2016-08-23 08:20:00,73,133,118,324,1944
2016-08-23 08:30:00,134,226,120,480,2880
2016-08-23 08:40:00,123,158,173,454,2724
2016-08-23 08:50:00,66,106,104,276,1656
2016-08-23 09:00:00,50,80,68,198,1188
2016-08-23 09:10:00,38,68,62,168,1008
2016-08-23 09:20:00,25,46,28,99,594
2016-08-23 09:30:00,24,38,26,88,528
2016-08-23 09:40:00,22,56,27,105,630
2016-08-23 09:50:00,47,78,50,175,1050
2016-08-23 10:00:00,56,101,102,259,1554
2016-08-23 10:10:00,80,159,202,441,2646
2016-08-23 10:20:00,226,203,147,576,3456
2016-08-23 10:30:00,218,222,226,666,3996
2016-08-23 10:40:00,181,202,197,580,3480
2016-08-23 10:50:00,203,190,152,545,3270
2016-08-23 11:00:00,215,213,119,547,3282
2016-08-23 11:10:00,161,197,109,467,2802
2016-08-23 11:20:00,175,206,126,507,3042
2016-08-23 11:30:00,210,226,223,659,3954
2016-08-23 11:40:00,138,160,157,455,2730
2016-08-23 11:50:00,157,158,162,477,2862
2016-08-23 12:00:00,170,141,157,468,2808
2016-08-23 12:10:00,113,151,160,424,2544
2016-08-23 12:20:00,128,137,166,431,2586
2016-08-23 12:30:00,229,244,241,714,4284
2016-08-23 12:40:00,166,188,182,536,3216
2016-08-23 12:50:00,119,184,147,450,2700
2016-08-23 13:00:00,179,141,152,472,2832
2016-08-23 13:10:00,284,155,162,601,3606
2016-08-23 13:20:00,197,283,137,617,3702
2016-08-23 13:30:00,312,331,326,969,5814
2016-08-23 13:40:00,333,354,349,1036,6216
2016-08-23 13:50:00,269,212,221,702,4212
2016-08-23 14:00:00,188,150,198,536,3216
2016-08-23 14:10:00,166,234,129,529,3174
2016-08-23 14:20:00,191,211,205,607,3642
2016-08-23 14:30:00,215,240,234,689,4134
2016-08-23 14:40:00,197,245,186,628,3768
2016-08-23 14:50:00,153,160,172,485,2910
2016-08-23 15:00:00,71,98,86,255,1530
2016-08-23 15:10:00,70,86,80,236,1416
2016-08-23 15:20:00,79,105,88,272,1632
2016-08-23 15:30:00,92,132,118,342,2052
2016-08-23 15:40:00,195,239,213,647,3882
2016-08-23 15:50:00,176,206,187,569,3414
2016-08-23 16:00:00,89,108,128,325,1950
2016-08-23 16:10:00,83,121,114,318,1908
2016-08-23 16:20:00,95,119,105,319,1914
2016-08-23 16:30:00,122,127,132,381,2286
2016-08-23 16:40:00,200,210,215,625,3750
2016-08-23 16:50:00,356,377,377,1110,6660
2016-08-23 17:00:00,221,242,237,700,4200
2016-08-23 17:10:00,202,227,220,649,3894
2016-08-23 17:20:00,161,186,181,528,3168
2016-08-23 17:30:00,112,136,131,379,2274
2016-08-23 17:40:00,136,160,158,454,2724
2016-08-23 17:50:00,99,145,150,394,2364
2016-08-23 18:00:00,82,133,155,370,2220
2016-08-23 18:10:00,58,100,110,268,1608
2016-08-23 18:20:00,25,88,80,193,1158
2016-08-23 18:30:00,40,55,55,150,900
2016-08-23 18:40:00,17,75,25,117,702
2016-08-23 18:50:00,12,45,33,90,540
2016-08-23 19:00:00,15,30,26,71,426
2016-08-23 19:10:00,16,27,25,68,408
2016-08-23 19:20:00,18,18,24,60,360
2016-08-23 19:30:00,10,19,17,46,276
2016-08-23 19:40:00,7,15,12,34,204
2016-08-23 19:50:00,3,10,7,20,120
2016-08-23 20:00:00,0,2,0,2,12
2016-08-23 20:10:00,0,0,0,0,0
2016-08-23 20:20:00,0,0,0,0,0
2016-08-23 20:30:00,0,0,0,0,0
2016-08-24 05:30:00,0,0,0,0,0
2016-08-24 05:40:00,0,0,0,0,0
2016-08-24 05:50:00,0,0,0,0,0
2016-08-24 06:00:00,0,0,0,0,0
2016-08-24 06:10:00,0,1,0,1,6
2016-08-24 06:20:00,0,5,2,7,42
2016-08-24 06:30:00,3,13,4,20,120
2016-08-24 06:40:00,7,25,19,51,306
2016-08-24 06:50:00,13,42,26,81,486
2016-08-24 07:00:00,15,44,17,76,456
2016-08-24 07:10:00,31,48,29,108,648
2016-08-24 07:20:00,47,75,41,163,978
2016-08-24 07:30:00,68,83,74,225,1350
2016-08-24 07:40:00,65,114,103,282,1692
2016-08-24 07:50:00,41,120,117,278,1668
2016-08-24 08:00:00,72,129,113,314,1884
2016-08-24 08:10:00,69,138,145,352,2112
2016-08-24 08:20:00,74,95,135,304,1824
2016-08-24 08:30:00,61,124,133,318,1908
2016-08-24 08:40:00,155,199,196,550,3300
2016-08-24 08:50:00,96,145,123,364,2184
2016-08-24 09:00:00,362,385,379,1126,6756
2016-08-24 09:10:00,446,469,467,1382,8292
2016-08-24 09:20:00,533,554,547,1634,9804
2016-08-24 09:30:00,552,578,569,1699,10194
2016-08-24 09:40:00,491,518,509,1518,9108
2016-08-24 09:50:00,649,678,666,1993,11958
2016-08-24 10:00:00,635,663,654,1952,11712
2016-08-24 10:10:00,589,614,606,1809,10854
2016-08-24 10:20:00,552,580,571,1703,10218
2016-08-24 10:30:00,700,726,716,2142,12852
2016-08-24 10:40:00,708,734,723,2165,12990
2016-08-24 10:50:00,536,561,556,1653,9918
2016-08-24 11:00:00,822,849,844,2515,15090
2016-08-24 11:10:00,923,948,945,2816,16896
2016-08-24 11:20:00,907,939,928,2774,16644
2016-08-24 11:30:00,924,958,944,2826,16956
2016-08-24 11:40:00,934,961,956,2851,17106
2016-08-24 11:50:00,884,914,906,2704,16224
2016-08-24 12:00:00,772,794,789,2355,14130
2016-08-24 12:10:00,753,778,770,2301,13806
2016-08-24 12:20:00,1032,1051,1049,3132,18792
2016-08-24 12:30:00,959,981,977,2917,17502
2016-08-24 12:40:00,1011,1034,1027,3072,18432
2016-08-24 12:50:00,983,1004,1000,2987,17922
2016-08-24 13:00:00,987,1011,1005,3003,18018
2016-08-24 13:10:00,728,749,744,2221,13326
2016-08-24 13:20:00,629,651,643,1923,11538
2016-08-24 13:30:00,1008,1030,1025,3063,18378
2016-08-24 13:40:00,985,1002,1007,2994,17964
2016-08-24 13:50:00,971,993,988,2952,17712
2016-08-24 14:00:00,972,997,991,2960,17760
2016-08-24 14:10:00,953,980,975,2908,17448
2016-08-24 14:20:00,904,925,927,2756,16536
2016-08-24 14:30:00,938,964,960,2862,17172
2016-08-24 14:40:00,847,870,869,2586,15516
2016-08-24 14:50:00,863,887,880,2630,15780
2016-08-24 15:00:00,813,836,830,2479,14874
2016-08-24 15:10:00,772,795,789,2356,14136
2016-08-24 15:20:00,750,775,768,2293,13758
2016-08-24 15:30:00,705,734,725,2164,12984
2016-08-24 15:40:00,647,673,668,1988,11928
2016-08-24 15:50:00,593,613,611,1817,10902
2016-08-24 16:00:00,621,656,647,1924,11544
2016-08-24 16:10:00,587,611,605,1803,10818
2016-08-24 16:20:00,513,538,532,1583,9498
2016-08-24 16:30:00,482,506,503,1491,8946
2016-08-24 16:40:00,426,452,447,1325,7950
2016-08-24 16:50:00,192,217,212,621,3726
2016-08-24 17:00:00,363,388,380,1131,6786
2016-08-24 17:10:00,250,275,269,794,4764
2016-08-24 17:20:00,164,168,187,519,3114
2016-08-24 17:30:00,211,237,232,680,4080
2016-08-24 17:40:00,120,144,142,406,2436
2016-08-24 17:50:00,84,95,94,273,1638
2016-08-24 18:00:00,115,108,103,326,1956
2016-08-24 18:10:00,87,89,97,273,1638
2016-08-24 18:20:00,98,94,108,300,1800
2016-08-24 18:30:00,74,46,80,200,1200
2016-08-24 18:40:00,32,70,30,132,792
2016-08-24 18:50:00,32,34,37,103,618
2016-08-24 19:00:00,32,14,39,85,510
2016-08-24 19:10:00,18,26,26,70,420
2016-08-24 19:20:00,16,18,24,58,348
2016-08-24 19:30:00,15,11,19,45,270
2016-08-24 19:40:00,8,9,11,28,168
2016-08-24 19:50:00,3,9,5,17,102
2016-08-24 20:00:00,1,2,1,4,24
2016-08-24 20:10:00,0,0,0,0,0
2016-08-24 20:20:00,0,0,0,0,0
2016-08-24 20:30:00,0,0,0,0,0
2016-08-25 05:30:00,0,0,0,0,0
2016-08-25 05:40:00,0,0,0,0,0
2016-08-25 05:50:00,0,0,0,0,0
2016-08-25 06:00:00,0,0,0,0,0
2016-08-25 06:10:00,1,2,1,4,24
2016-08-25 06:20:00,3,7,2,12,72
2016-08-25 06:30:00,5,9,5,19,114
2016-08-25 06:40:00,7,10,10,27,162
2016-08-25 06:50:00,8,15,9,32,192
2016-08-25 07:00:00,13,26,20,59,354
2016-08-25 07:10:00,13,40,21,74,444
2016-08-25 07:20:00,19,43,23,85,510
2016-08-25 07:30:00,25,41,29,95,570
2016-08-25 07:40:00,31,47,28,106,636
2016-08-25 07:50:00,31,58,27,116,696
2016-08-25 08:00:00,33,59,34,126,756
2016-08-25 08:10:00,37,46,31,114,684
2016-08-25 08:20:00,48,47,46,141,846
2016-08-25 08:30:00,142,186,203,531,3186
2016-08-25 08:40:00,258,287,282,827,4962
2016-08-25 08:50:00,323,346,342,1011,6066
2016-08-25 09:00:00,384,408,403,1195,7170
2016-08-25 09:10:00,440,461,454,1355,8130
2016-08-25 09:20:00,434,454,448,1336,8016
2016-08-25 09:30:00,391,417,411,1219,7314
2016-08-25 09:40:00,261,285,282,828,4968
2016-08-25 09:50:00,468,488,488,1444,8664
2016-08-25 10:00:00,418,442,440,1300,7800
2016-08-25 10:10:00,235,257,256,748,4488
2016-08-25 10:20:00,597,622,612,1831,10986
2016-08-25 10:30:00,832,854,842,2528,15168
2016-08-25 10:40:00,807,831,822,2460,14760
2016-08-25 10:50:00,792,820,811,2423,14538
2016-08-25 11:00:00,806,832,824,2462,14772
2016-08-25 11:10:00,892,942,926,2760,16560
2016-08-25 11:20:00,893,953,950,2796,16776
2016-08-25 11:30:00,811,868,860,2539,15234
2016-08-25 11:40:00,927,951,952,2830,16980
2016-08-25 11:50:00,906,928,931,2765,16590
2016-08-25 12:00:00,901,925,925,2751,16506
2016-08-25 12:10:00,981,1014,1004,2999,17994
2016-08-25 12:20:00,949,977,972,2898,17388
2016-08-25 12:30:00,966,989,984,2939,17634
2016-08-25 12:40:00,966,990,986,2942,17652
2016-08-25 12:50:00,969,992,986,2947,17682
2016-08-25 13:00:00,977,998,989,2964,17784
2016-08-25 13:10:00,976,999,993,2968,17808
2016-08-25 13:20:00,938,973,965,2876,17256
2016-08-25 13:30:00,949,1011,999,2959,17754
2016-08-25 13:40:00,967,994,986,2947,17682
2016-08-25 13:50:00,958,983,966,2907,17442
2016-08-25 14:00:00,945,968,965,2878,17268
2016-08-25 14:10:00,933,965,954,2852,17112
2016-08-25 14:20:00,929,951,943,2823,16938
2016-08-25 14:30:00,910,935,928,2773,16638
2016-08-25 14:40:00,902,918,899,2719,16314
2016-08-25 14:50:00,877,896,883,2656,15936
2016-08-25 15:00:00,840,860,852,2552,15312
2016-08-25 15:10:00,805,825,817,2447,14682
2016-08-25 15:20:00,714,745,737,2196,13176
2016-08-25 15:30:00,700,726,720,2146,12876
2016-08-25 15:40:00,697,723,717,2137,12822
2016-08-25 15:50:00,645,682,676,2003,12018
2016-08-25 16:00:00,615,642,637,1894,11364
2016-08-25 16:10:00,570,590,582,1742,10452
2016-08-25 16:20:00,469,492,484,1445,8670
2016-08-25 16:30:00,437,464,458,1359,8154
2016-08-25 16:40:00,385,411,406,1202,7212
2016-08-25 16:50:00,404,429,425,1258,7548
2016-08-25 17:00:00,306,329,328,963,5778
2016-08-25 17:10:00,224,247,244,715,4290
2016-08-25 17:20:00,192,216,216,624,3744
2016-08-25 17:30:00,120,144,141,405,2430
2016-08-25 17:40:00,141,165,161,467,2802
2016-08-25 17:50:00,136,165,158,459,2754
2016-08-25 18:00:00,87,113,109,309,1854
2016-08-25 18:10:00,44,44,53,141,846
2016-08-25 18:20:00,26,52,31,109,654
2016-08-25 18:30:00,35,35,41,111,666
2016-08-25 18:40:00,33,23,39,95,570
2016-08-25 18:50:00,28,34,33,95,570
2016-08-25 19:00:00,30,48,36,114,684
2016-08-25 19:10:00,31,47,46,124,744
2016-08-25 19:20:00,28,60,22,110,660
2016-08-25 19:30:00,21,34,18,73,438
2016-08-25 19:40:00,9,15,12,36,216
2016-08-25 19:50:00,10,15,13,38,228
2016-08-25 20:00:00,1,2,1,4,24
2016-08-25 20:10:00,0,0,0,0,0
2016-08-25 20:20:00,0,0,0,0,0
2016-08-25 20:30:00,0,0,0,0,0
2016-08-26 05:30:00,0,0,0,0,0
2016-08-26 05:40:00,0,0,0,0,0
2016-08-26 05:50:00,0,0,0,0,0
2016-08-26 06:00:00,0,0,0,0,0
2016-08-26 06:10:00,2,4,2,8,48
2016-08-26 06:20:00,8,12,10,30,180
2016-08-26 06:30:00,5,14,7,26,156
2016-08-26 06:40:00,4,13,4,21,126
2016-08-26 06:50:00,8,12,11,31,186
2016-08-26 07:00:00,14,25,8,47,282
2016-08-26 07:10:00,23,39,18,80,480
2016-08-26 07:20:00,13,90,14,117,702
2016-08-26 07:30:00,24,52,25,101,606
2016-08-26 07:40:00,25,42,27,94,564
2016-08-26 07:50:00,22,55,25,102,612
2016-08-26 08:00:00,46,50,54,150,900
2016-08-26 08:10:00,46,52,53,151,906
2016-08-26 08:20:00,48,50,46,144,864
2016-08-26 08:30:00,46,66,66,178,1068
2016-08-26 08:40:00,218,246,225,689,4134
2016-08-26 08:50:00,288,307,302,897,5382
2016-08-26 09:00:00,370,393,390,1153,6918
2016-08-26 09:10:00,440,461,460,1361,8166
2016-08-26 09:20:00,503,522,523,1548,9288
2016-08-26 09:30:00,432,452,449,1333,7998
2016-08-26 09:40:00,540,557,553,1650,9900
2016-08-26 09:50:00,634,654,654,1942,11652
2016-08-26 10:00:00,700,719,718,2137,12822
2016-08-26 10:10:00,736,756,753,2245,13470
2016-08-26 10:20:00,770,789,788,2347,14082
2016-08-26 10:30:00,799,816,809,2424,14544
2016-08-26 10:40:00,821,840,830,2491,14946
2016-08-26 10:50:00,832,851,840,2523,15138
2016-08-26 11:00:00,841,861,861,2563,15378
2016-08-26 11:10:00,848,875,873,2596,15576
2016-08-26 11:20:00,851,883,875,2609,15654
2016-08-26 11:30:00,866,890,886,2642,15852
2016-08-26 11:40:00,880,911,905,2696,16176
2016-08-26 11:50:00,882,917,916,2715,16290
2016-08-26 12:00:00,881,917,911,2709,16254
2016-08-26 12:10:00,885,917,915,2717,16302
2016-08-26 12:20:00,893,924,925,2742,16452
2016-08-26 12:30:00,900,925,926,2751,16506
2016-08-26 12:40:00,906,934,928,2768,16608
2016-08-26 12:50:00,893,922,920,2735,16410
2016-08-26 13:00:00,908,934,929,2771,16626
2016-08-26 13:10:00,908,934,929,2771,16626
2016-08-26 13:20:00,912,938,930,2780,16680
2016-08-26 13:30:00,898,932,921,2751,16506
2016-08-26 13:40:00,903,929,924,2756,16536
2016-08-26 13:50:00,904,921,930,2755,16530
2016-08-26 14:00:00,890,915,917,2722,16332
2016-08-26 14:10:00,877,901,896,2674,16044
2016-08-26 14:20:00,866,892,886,2644,15864
2016-08-26 14:30:00,795,822,815,2432,14592
2016-08-26 14:40:00,813,831,835,2479,14874
2016-08-26 14:50:00,751,769,775,2295,13770
2016-08-26 15:00:00,694,710,714,2118,12708
2016-08-26 15:10:00,675,693,693,2061,12366
2016-08-26 15:20:00,678,701,698,2077,12462
2016-08-26 15:30:00,632,666,661,1959,11754
2016-08-26 15:40:00,577,602,603,1782,10692
2016-08-26 15:50:00,566,591,590,1747,10482
2016-08-26 16:00:00,532,557,553,1642,9852
2016-08-26 16:10:00,500,526,521,1547,9282
2016-08-26 16:20:00,456,488,481,1425,8550
2016-08-26 16:30:00,425,450,444,1319,7914
2016-08-26 16:40:00,353,376,370,1099,6594
2016-08-26 16:50:00,323,354,344,1021,6126
2016-08-26 17:00:00,270,299,291,860,5160
2016-08-26 17:10:00,256,282,274,812,4872
2016-08-26 17:20:00,195,222,214,631,3786
2016-08-26 17:30:00,161,185,175,521,3126
2016-08-26 17:40:00,140,164,156,460,2760
2016-08-26 17:50:00,109,135,126,370,2220
2016-08-26 18:00:00,65,91,85,241,1446
2016-08-26 18:10:00,33,64,79,176,1056
2016-08-26 18:20:00,43,53,65,161,966
2016-08-26 18:30:00,48,52,44,144,864
2016-08-26 18:40:00,22,74,26,122,732
2016-08-26 18:50:00,25,39,39,103,618
2016-08-26 19:00:00,28,20,34,82,492
2016-08-26 19:10:00,16,27,24,67,402
2016-08-26 19:20:00,16,23,17,56,336
2016-08-26 19:30:00,15,22,10,47,282
2016-08-26 19:40:00,11,12,13,36,216
2016-08-26 19:50:00,5,8,6,19,114
2016-08-26 20:00:00,0,1,1,2,12
2016-08-26 20:10:00,0,0,0,0,0
2016-08-26 20:20:00,0,0,0,0,0
2016-08-26 20:30:00,0,0,0,0,0
2016-08-27 05:30:00,0,0,0,0,0
2016-08-27 05:40:00,0,0,0,0,0
2016-08-27 05:50:00,0,0,0,0,0
2016-08-27 06:00:00,0,0,0,0,0
2016-08-27 06:10:00,0,0,0,0,0
2016-08-27 06:20:00,3,3,3,9,54
2016-08-27 06:30:00,5,8,7,20,120
2016-08-27 06:40:00,7,10,12,29,174
2016-08-27 06:50:00,8,18,13,39,234
2016-08-27 07:00:00,10,25,19,54,324
2016-08-27 07:10:00,12,27,23,62,372
2016-08-27 07:20:00,18,29,24,71,426
2016-08-27 07:30:00,13,43,21,77,462
2016-08-27 07:40:00,10,45,31,86,516
2016-08-27 07:50:00,12,50,32,94,564
2016-08-27 08:00:00,33,48,24,105,630
2016-08-27 08:10:00,34,37,27,98,588
2016-08-27 08:20:00,9,61,50,120,720
2016-08-27 08:30:00,17,87,24,128,768
2016-08-27 08:40:00,256,281,274,811,4866
2016-08-27 08:50:00,338,365,356,1059,6354
2016-08-27 09:00:00,399,429,420,1248,7488
2016-08-27 09:10:00,455,487,480,1422,8532
2016-08-27 09:20:00,515,539,536,1590,9540
2016-08-27 09:30:00,579,601,597,1777,10662
2016-08-27 09:40:00,636,656,658,1950,11700
2016-08-27 09:50:00,689,712,709,2110,12660
2016-08-27 10:00:00,730,752,746,2228,13368
2016-08-27 10:10:00,773,798,791,2362,14172
2016-08-27 10:20:00,812,839,832,2483,14898
2016-08-27 10:30:00,836,866,857,2559,15354
2016-08-27 10:40:00,854,886,879,2619,15714
2016-08-27 10:50:00,878,903,898,2679,16074
2016-08-27 11:00:00,899,925,917,2741,16446
2016-08-27 11:10:00,918,943,930,2791,16746
2016-08-27 11:20:00,935,960,946,2841,17046
2016-08-27 11:30:00,946,972,961,2879,17274
2016-08-27 11:40:00,961,985,973,2919,17514
2016-08-27 11:50:00,974,994,980,2948,17688
2016-08-27 12:00:00,982,1008,993,2983,17898
2016-08-27 12:10:00,952,980,966,2898,17388
2016-08-27 12:20:00,961,984,970,2915,17490
2016-08-27 12:30:00,1013,1035,1025,3073,18438
2016-08-27 12:40:00,1047,1068,1059,3174,19044
2016-08-27 12:50:00,992,1017,1005,3014,18084
2016-08-27 13:00:00,1007,1031,1015,3053,18318
2016-08-27 13:10:00,987,1011,997,2995,17970
2016-08-27 13:20:00,977,1003,989,2969,17814
2016-08-27 13:30:00,975,1001,987,2963,17778
2016-08-27 13:40:00,970,993,981,2944,17664
2016-08-27 13:50:00,962,986,976,2924,17544
2016-08-27 14:00:00,941,966,957,2864,17184
2016-08-27 14:10:00,942,966,950,2858,17148
2016-08-27 14:20:00,791,816,807,2414,14484
2016-08-27 14:30:00,756,781,771,2308,13848
2016-08-27 14:40:00,775,799,786,2360,14160
2016-08-27 14:50:00,702,725,714,2141,12846
2016-08-27 15:00:00,747,770,755,2272,13632
2016-08-27 15:10:00,560,585,577,1722,10332
2016-08-27 15:20:00,707,729,719,2155,12930
2016-08-27 15:30:00,709,734,724,2167,13002
2016-08-27 15:40:00,664,681,676,2021,12126
2016-08-27 15:50:00,624,640,635,1899,11394
2016-08-27 16:00:00,584,606,600,1790,10740
2016-08-27 16:10:00,549,567,561,1677,10062
2016-08-27 16:20:00,511,531,524,1566,9396
2016-08-27 16:30:00,468,491,483,1442,8652
2016-08-27 16:40:00,415,440,432,1287,7722
2016-08-27 16:50:00,366,388,382,1136,6816
2016-08-27 17:00:00,317,337,336,990,5940
2016-08-27 17:10:00,264,285,282,831,4986
2016-08-27 17:20:00,203,225,220,648,3888
2016-08-27 17:30:00,169,191,187,547,3282
2016-08-27 17:40:00,134,156,152,442,2652
2016-08-27 17:50:00,103,127,125,355,2130
2016-08-27 18:00:00,57,71,91,219,1314
2016-08-27 18:10:00,27,64,43,134,804
2016-08-27 18:20:00,30,52,30,112,672
2016-08-27 18:30:00,27,52,31,110,660
2016-08-27 18:40:00,31,51,18,100,600
2016-08-27 18:50:00,29,46,13,88,528
2016-08-27 19:00:00,21,35,18,74,444
2016-08-27 19:10:00,15,23,16,54,324
2016-08-27 19:20:00,14,21,7,42,252
2016-08-27 19:30:00,7,11,7,25,150
2016-08-27 19:40:00,2,3,2,7,42
2016-08-27 19:50:00,0,0,0,0,0
2016-08-27 20:00:00,0,0,0,0,0
2016-08-27 20:10:00,0,0,0,0,0
2016-08-27 20:20:00,0,0,0,0,0
2016-08-28 05:50:00,0,0,0,0,0
2016-08-28 06:00:00,0,0,0,0,0
2016-08-28 06:10:00,0,0,0,0,0
2016-08-28 06:20:00,0,0,0,0,0
2016-08-28 06:30:00,0,0,0,0,0
2016-08-28 06:40:00,1,2,2,5,30
2016-08-28 06:50:00,2,5,2,9,54
2016-08-28 07:00:00,10,13,12,35,210
2016-08-28 07:10:00,18,29,23,70,420
2016-08-28 07:20:00,28,54,33,115,690
2016-08-28 07:30:00,23,41,28,92,552
2016-08-28 07:40:00,54,75,73,202,1212
2016-08-28 07:50:00,61,110,103,274,1644
2016-08-28 08:00:00,94,32,110,236,1416
2016-08-28 08:10:00,65,81,81,227,1362
2016-08-28 08:20:00,67,79,78,224,1344
2016-08-28 08:30:00,118,48,129,295,1770
2016-08-28 08:40:00,112,136,147,395,2370
2016-08-28 08:50:00,62,210,248,520,3120
2016-08-28 09:00:00,198,152,189,539,3234
2016-08-28 09:10:00,139,108,176,423,2538
2016-08-28 09:20:00,208,231,245,684,4104
2016-08-28 09:30:00,312,331,331,974,5844
2016-08-28 09:40:00,287,305,301,893,5358
2016-08-28 09:50:00,323,345,340,1008,6048
2016-08-28 10:00:00,526,549,543,1618,9708
2016-08-28 10:10:00,581,608,601,1790,10740
2016-08-28 10:20:00,629,656,651,1936,11616
2016-08-28 10:30:00,704,733,728,2165,12990
2016-08-28 10:40:00,490,518,513,1521,9126
2016-08-28 10:50:00,653,675,675,2003,12018
2016-08-28 11:00:00,810,839,833,2482,14892
2016-08-28 11:10:00,576,606,595,1777,10662
2016-08-28 11:20:00,427,449,438,1314,7884
2016-08-28 11:30:00,343,366,353,1062,6372
2016-08-28 11:40:00,494,518,505,1517,9102
2016-08-28 11:50:00,339,359,352,1050,6300
2016-08-28 12:00:00,357,370,373,1100,6600
2016-08-28 12:10:00,323,344,339,1006,6036
2016-08-28 12:20:00,214,228,230,672,4032
2016-08-28 12:30:00,95,117,115,327,1962
2016-08-28 12:40:00,38,49,42,129,774
2016-08-28 12:50:00,31,38,26,95,570
2016-08-28 13:00:00,85,99,112,296,1776
2016-08-28 13:10:00,376,416,393,1185,7110
2016-08-28 13:20:00,493,520,512,1525,9150
2016-08-28 13:30:00,272,298,291,861,5166
2016-08-28 13:40:00,194,200,109,503,3018
2016-08-28 13:50:00,87,142,147,376,2256
2016-08-28 14:00:00,83,131,128,342,2052
2016-08-28 14:10:00,55,110,105,270,1620
2016-08-28 14:20:00,32,78,75,185,1110
2016-08-28 14:30:00,40,105,114,259,1554
2016-08-28 14:40:00,34,73,77,184,1104
2016-08-28 14:50:00,51,110,101,262,1572
2016-08-28 15:00:00,134,185,156,475,2850
2016-08-28 15:10:00,212,244,243,699,4194
2016-08-28 15:20:00,169,191,187,547,3282
2016-08-28 15:30:00,236,257,254,747,4482
2016-08-28 15:40:00,288,313,309,910,5460
2016-08-28 15:50:00,211,236,232,679,4074
2016-08-28 16:00:00,129,153,149,431,2586
2016-08-28 16:10:00,172,120,159,451,2706
2016-08-28 16:20:00,103,97,122,322,1932
2016-08-28 16:30:00,107,91,123,321,1926
2016-08-28 16:40:00,143,151,176,470,2820
2016-08-28 16:50:00,194,234,74,502,3012
2016-08-28 17:00:00,36,137,142,315,1890
2016-08-28 17:10:00,70,70,103,243,1458
2016-08-28 17:20:00,214,285,188,687,4122
2016-08-28 17:30:00,221,248,237,706,4236
2016-08-28 17:40:00,171,204,193,568,3408
2016-08-28 17:50:00,73,164,151,388,2328
2016-08-28 18:00:00,21,196,181,398,2388
2016-08-28 18:10:00,26,117,137,280,1680
2016-08-28 18:20:00,56,81,120,257,1542
2016-08-28 18:30:00,31,83,82,196,1176
2016-08-28 18:40:00,59,78,86,223,1338
2016-08-28 18:50:00,59,57,81,197,1182
2016-08-28 19:00:00,41,51,51,143,858
2016-08-28 19:10:00,23,66,27,116,696
2016-08-28 19:20:00,20,28,29,77,462
2016-08-28 19:30:00,12,15,17,44,264
2016-08-28 19:40:00,8,8,9,25,150
2016-08-28 19:50:00,2,1,2,5,30
2016-08-28 20:00:00,0,0,0,0,0
2016-08-28 20:10:00,0,0,0,0,0
2016-08-29 05:50:00,0,0,0,0,0
2016-08-29 06:00:00,0,0,0,0,0
2016-08-29 06:10:00,0,0,0,0,0
2016-08-29 06:20:00,0,0,0,0,0
2016-08-29 06:30:00,0,0,0,0,0
2016-08-29 06:40:00,0,0,0,0,0
2016-08-29 06:50:00,0,0,0,0,0
2016-08-29 07:00:00,0,0,0,0,0
2016-08-29 07:10:00,0,1,0,1,6
2016-08-29 07:20:00,4,4,5,13,78
2016-08-29 07:30:00,22,29,27,78,468
2016-08-29 07:40:00,20,33,22,75,450
2016-08-29 07:50:00,31,45,35,111,666
2016-08-29 08:00:00,16,23,17,56,336
2016-08-29 08:10:00,8,7,8,23,138
2016-08-29 08:20:00,28,48,26,102,612
2016-08-29 08:30:00,62,77,55,194,1164
2016-08-29 08:40:00,30,67,34,131,786
2016-08-29 08:50:00,60,80,73,213,1278
2016-08-29 09:00:00,77,142,168,387,2322
2016-08-29 09:10:00,111,127,135,373,2238
2016-08-29 09:20:00,185,238,261,684,4104
2016-08-29 09:30:00,263,281,278,822,4932
2016-08-29 09:40:00,322,341,340,1003,6018
2016-08-29 09:50:00,253,273,266,792,4752
2016-08-29 10:00:00,291,315,309,915,5490
2016-08-29 10:10:00,283,307,302,892,5352
2016-08-29 10:20:00,277,301,293,871,5226
2016-08-29 10:30:00,293,316,307,916,5496
2016-08-29 10:40:00,523,548,537,1608,9648
2016-08-29 10:50:00,735,768,761,2264,13584
2016-08-29 11:00:00,753,788,777,2318,13908
2016-08-29 11:10:00,818,848,841,2507,15042
2016-08-29 11:20:00,806,829,821,2456,14736
2016-08-29 11:30:00,958,980,972,2910,17460
2016-08-29 11:40:00,988,1013,1003,3004,18024
2016-08-29 11:50:00,983,1010,1003,2996,17976
2016-08-29 12:00:00,1008,1032,1027,3067,18402
2016-08-29 12:10:00,966,988,982,2936,17616
2016-08-29 12:20:00,866,902,889,2657,15942
2016-08-29 12:30:00,1059,1105,1087,3251,19506
2016-08-29 12:40:00,933,967,954,2854,17124
2016-08-29 12:50:00,110,129,124,363,2178
2016-08-29 13:00:00,73,138,105,316,1896
2016-08-29 13:10:00,252,257,206,715,4290
2016-08-29 13:20:00,612,638,630,1880,11280
2016-08-29 13:30:00,115,157,130,402,2412
2016-08-29 13:40:00,394,404,393,1191,7146
2016-08-29 13:50:00,472,493,479,1444,8664
2016-08-29 14:00:00,1048,1070,1047,3165,18990
2016-08-29 14:10:00,573,599,588,1760,10560
2016-08-29 14:20:00,259,282,275,816,4896
2016-08-29 14:30:00,659,682,671,2012,12072
2016-08-29 14:40:00,645,671,660,1976,11856
2016-08-29 14:50:00,328,347,344,1019,6114
2016-08-29 15:00:00,610,633,621,1864,11184
2016-08-29 15:10:00,377,398,391,1166,6996
2016-08-29 15:20:00,321,363,322,1006,6036
2016-08-29 15:30:00,293,317,311,921,5526
2016-08-29 15:40:00,207,213,214,634,3804
2016-08-29 15:50:00,552,586,579,1717,10302
2016-08-29 16:00:00,311,336,331,978,5868
2016-08-29 16:10:00,189,161,171,521,3126
2016-08-29 16:20:00,266,321,260,847,5082
2016-08-29 16:30:00,333,360,353,1046,6276
2016-08-29 16:40:00,201,224,219,644,3864
2016-08-29 16:50:00,78,152,146,376,2256
2016-08-29 17:00:00,56,107,96,259,1554
2016-08-29 17:10:00,97,134,118,349,2094
2016-08-29 17:20:00,78,89,107,274,1644
2016-08-29 17:30:00,81,116,131,328,1968
2016-08-29 17:40:00,62,168,186,416,2496
2016-08-29 17:50:00,102,238,103,443,2658
2016-08-29 18:00:00,41,117,81,239,1434
2016-08-29 18:10:00,35,59,43,137,822
2016-08-29 18:20:00,24,63,39,126,756
2016-08-29 18:30:00,15,42,29,86,516
2016-08-29 18:40:00,8,24,18,50,300
2016-08-29 18:50:00,16,39,26,81,486
2016-08-29 19:00:00,14,46,32,92,552
2016-08-29 19:10:00,11,29,18,58,348
2016-08-29 19:20:00,9,26,16,51,306
2016-08-29 19:30:00,10,29,17,56,336
2016-08-29 19:40:00,4,17,11,32,192
2016-08-29 19:50:00,1,2,1,4,24
2016-08-29 20:00:00,0,0,0,0,0
2016-08-29 20:10:00,0,0,0,0,0
2016-08-29 20:20:00,0,0,0,0,0
2016-08-30 05:40:00,0,0,0,0,0
2016-08-30 05:50:00,0,0,0,0,0
2016-08-30 06:00:00,0,0,0,0,0
2016-08-30 06:10:00,0,0,0,0,0
2016-08-30 06:20:00,2,2,2,6,36
2016-08-30 06:30:00,6,8,7,21,126
2016-08-30 06:40:00,14,24,16,54,324
2016-08-30 06:50:00,15,31,16,62,372
2016-08-30 07:00:00,28,63,36,127,762
2016-08-30 07:10:00,42,78,52,172,1032
2016-08-30 07:20:00,27,61,25,113,678
2016-08-30 07:30:00,57,82,67,206,1236
2016-08-30 07:40:00,52,98,84,234,1404
2016-08-30 07:50:00,62,87,81,230,1380
2016-08-30 08:00:00,39,70,50,159,954
2016-08-30 08:10:00,63,78,82,223,1338
2016-08-30 08:20:00,48,76,75,199,1194
2016-08-30 08:30:00,164,159,111,434,2604
2016-08-30 08:40:00,143,165,149,457,2742
2016-08-30 08:50:00,308,325,325,958,5748
2016-08-30 09:00:00,369,387,384,1140,6840
2016-08-30 09:10:00,433,447,444,1324,7944
2016-08-30 09:20:00,491,505,499,1495,8970
2016-08-30 09:30:00,548,565,556,1669,10014
2016-08-30 09:40:00,610,624,621,1855,11130
2016-08-30 09:50:00,666,684,677,2027,12162
2016-08-30 10:00:00,712,730,727,2169,13014
2016-08-30 10:10:00,739,758,755,2252,13512
2016-08-30 10:20:00,767,786,781,2334,14004
2016-08-30 10:30:00,824,843,839,2506,15036
2016-08-30 10:40:00,844,862,857,2563,15378
2016-08-30 10:50:00,873,892,885,2650,15900
2016-08-30 11:00:00,932,949,941,2822,16932
2016-08-30 11:10:00,512,528,523,1563,9378
2016-08-30 11:20:00,508,526,518,1552,9312
2016-08-30 11:30:00,647,668,662,1977,11862
2016-08-30 11:40:00,983,1002,991,2976,17856
2016-08-30 11:50:00,968,990,980,2938,17628
2016-08-30 12:00:00,978,1001,987,2966,17796
2016-08-30 12:10:00,868,892,881,2641,15846
2016-08-30 12:20:00,677,695,690,2062,12372
2016-08-30 12:30:00,646,662,659,1967,11802
2016-08-30 12:40:00,1025,1045,1038,3108,18648
2016-08-30 12:50:00,994,1006,1008,3008,18048
2016-08-30 13:00:00,999,1018,1007,3024,18144
2016-08-30 13:10:00,993,1014,1009,3016,18096
2016-08-30 13:20:00,931,953,947,2831,16986
2016-08-30 13:30:00,333,354,350,1037,6222
2016-08-30 13:40:00,330,352,347,1029,6174
2016-08-30 13:50:00,711,731,725,2167,13002
2016-08-30 14:00:00,330,346,345,1021,6126
2016-08-30 14:10:00,639,658,653,1950,11700
2016-08-30 14:20:00,945,969,961,2875,17250
2016-08-30 14:30:00,504,525,520,1549,9294
2016-08-30 14:40:00,272,292,291,855,5130
2016-08-30 14:50:00,216,185,186,587,3522
2016-08-30 15:00:00,202,223,221,646,3876
2016-08-30 15:10:00,351,376,383,1110,6660
2016-08-30 15:20:00,386,408,403,1197,7182
2016-08-30 15:30:00,249,278,273,800,4800
2016-08-30 15:40:00,309,332,327,968,5808
2016-08-30 15:50:00,334,352,357,1043,6258
2016-08-30 16:00:00,315,336,337,988,5928
2016-08-30 16:10:00,337,363,364,1064,6384
2016-08-30 16:20:00,486,514,506,1506,9036
2016-08-30 16:30:00,465,485,487,1437,8622
2016-08-30 16:40:00,413,421,429,1263,7578
2016-08-30 16:50:00,324,350,343,1017,6102
2016-08-30 17:00:00,247,271,264,782,4692
2016-08-30 17:10:00,206,234,217,657,3942
2016-08-30 17:20:00,191,213,208,612,3672
2016-08-30 17:30:00,131,156,149,436,2616
2016-08-30 17:40:00,76,120,115,311,1866
2016-08-30 17:50:00,66,80,92,238,1428
2016-08-30 18:00:00,31,65,60,156,936
2016-08-30 18:10:00,33,46,36,115,690
2016-08-30 18:20:00,25,50,38,113,678
2016-08-30 18:30:00,25,45,34,104,624
2016-08-30 18:40:00,26,35,31,92,552
2016-08-30 18:50:00,23,29,27,79,474
2016-08-30 19:00:00,19,32,16,67,402
2016-08-30 19:10:00,13,26,14,53,318
2016-08-30 19:20:00,10,17,12,39,234
2016-08-30 19:30:00,6,12,9,27,162
2016-08-30 19:40:00,3,6,3,12,72
2016-08-30 19:50:00,0,0,0,0,0
2016-08-30 20:00:00,0,0,0,0,0
2016-08-30 20:10:00,0,0,0,0,0
2016-08-30 20:20:00,0,0,0,0,0
2016-08-31 05:40:00,0,0,0,0,0
2016-08-31 05:50:00,0,0,0,0,0
2016-08-31 06:00:00,0,0,0,0,0
2016-08-31 06:10:00,0,0,0,0,0
2016-08-31 06:20:00,0,2,0,2,12
2016-08-31 06:30:00,2,10,4,16,96
2016-08-31 06:40:00,6,17,8,31,186
2016-08-31 06:50:00,10,22,10,42,252
2016-08-31 07:00:00,17,33,13,63,378
2016-08-31 07:10:00,18,45,17,80,480
2016-08-31 07:20:00,24,48,13,85,510
2016-08-31 07:30:00,30,50,16,96,576
2016-08-31 07:40:00,60,37,14,111,666
2016-08-31 07:50:00,40,51,48,139,834
2016-08-31 08:00:00,60,95,92,247,1482
2016-08-31 08:10:00,82,125,121,328,1968
2016-08-31 08:20:00,107,157,109,373,2238
2016-08-31 08:30:00,81,94,95,270,1620
2016-08-31 08:40:00,78,89,94,261,1566
2016-08-31 08:50:00,176,187,182,545,3270
2016-08-31 09:00:00,343,364,359,1066,6396
2016-08-31 09:10:00,412,432,427,1271,7626
2016-08-31 09:20:00,472,489,486,1447,8682
2016-08-31 09:30:00,528,551,543,1622,9732
2016-08-31 09:40:00,586,611,603,1800,10800
2016-08-31 09:50:00,649,669,663,1981,11886
2016-08-31 10:00:00,699,719,713,2131,12786
2016-08-31 10:10:00,750,772,763,2285,13710
2016-08-31 10:20:00,755,781,770,2306,13836
2016-08-31 10:30:00,805,829,816,2450,14700
2016-08-31 10:40:00,834,862,854,2550,15300
2016-08-31 10:50:00,849,873,867,2589,15534
2016-08-31 11:00:00,583,609,602,1794,10764
2016-08-31 11:10:00,832,863,851,2546,15276
2016-08-31 11:20:00,776,802,786,2364,14184
2016-08-31 11:30:00,954,988,978,2920,17520
2016-08-31 11:40:00,831,875,862,2568,15408
2016-08-31 11:50:00,784,814,804,2402,14412
2016-08-31 12:00:00,983,1007,1000,2990,17940
2016-08-31 12:10:00,957,982,971,2910,17460
2016-08-31 12:20:00,791,817,803,2411,14466
2016-08-31 12:30:00,812,842,830,2484,14904
2016-08-31 12:40:00,1022,1068,1050,3140,18840
2016-08-31 12:50:00,923,962,946,2831,16986
2016-08-31 13:00:00,772,811,797,2380,14280
2016-08-31 13:10:00,969,998,979,2946,17676
2016-08-31 13:20:00,896,929,908,2733,16398
2016-08-31 13:30:00,826,863,846,2535,15210
2016-08-31 13:40:00,774,806,793,2373,14238
2016-08-31 13:50:00,764,789,780,2333,13998
2016-08-31 14:00:00,542,569,561,1672,10032
2016-08-31 14:10:00,653,676,667,1996,11976
2016-08-31 14:20:00,715,737,728,2180,13080
2016-08-31 14:30:00,818,845,831,2494,14964
2016-08-31 14:40:00,767,801,786,2354,14124
2016-08-31 14:50:00,539,576,558,1673,10038
2016-08-31 15:00:00,549,578,569,1696,10176
2016-08-31 15:10:00,791,816,806,2413,14478
2016-08-31 15:20:00,724,746,737,2207,13242
2016-08-31 15:30:00,671,697,686,2054,12324
2016-08-31 15:40:00,394,421,411,1226,7356
2016-08-31 15:50:00,436,470,458,1364,8184
2016-08-31 16:00:00,346,375,366,1087,6522
2016-08-31 16:10:00,425,454,443,1322,7932
2016-08-31 16:20:00,488,516,503,1507,9042
2016-08-31 16:30:00,366,393,384,1143,6858
2016-08-31 16:40:00,227,279,229,735,4410
2016-08-31 16:50:00,315,340,334,989,5934
2016-08-31 17:00:00,299,329,320,948,5688
2016-08-31 17:10:00,218,245,235,698,4188
2016-08-31 17:20:00,37,153,99,289,1734
2016-08-31 17:30:00,93,201,131,425,2550
2016-08-31 17:40:00,66,119,106,291,1746
2016-08-31 17:50:00,43,100,116,259,1554
2016-08-31 18:00:00,50,78,81,209,1254
2016-08-31 18:10:00,29,55,46,130,780
2016-08-31 18:20:00,19,36,18,73,438
2016-08-31 18:30:00,21,43,25,89,534
2016-08-31 18:40:00,21,74,71,166,996
2016-08-31 18:50:00,25,71,37,133,798
2016-08-31 19:00:00,20,36,20,76,456
2016-08-31 19:10:00,15,19,18,52,312
2016-08-31 19:20:00,14,13,19,46,276
2016-08-31 19:30:00,14,20,17,51,306
2016-08-31 19:40:00,6,13,8,27,162
2016-08-31 19:50:00,0,1,0,1,6
2016-08-31 20:00:00,0,0,0,0,0
2016-08-31 20:10:00,0,0,0,0,0
2016-09-01 05:50:00,0,0,0,0,0
2016-09-01 06:00:00,0,0,0,0,0
2016-09-01 06:10:00,0,0,0,0,0
2016-09-01 06:20:00,0,1,0,1,6
2016-09-01 06:30:00,2,3,2,7,42
2016-09-01 06:40:00,6,8,9,23,138
2016-09-01 06:50:00,18,32,26,76,456
2016-09-01 07:00:00,24,50,27,101,606
2016-09-01 07:10:00,25,69,22,116,696
2016-09-01 07:20:00,37,53,35,125,750
2016-09-01 07:30:00,62,57,75,194,1164
2016-09-01 07:40:00,47,67,58,172,1032
2016-09-01 07:50:00,85,106,99,290,1740
2016-09-01 08:00:00,76,63,91,230,1380
2016-09-01 08:10:00,66,89,81,236,1416
2016-09-01 08:20:00,88,95,100,283,1698
2016-09-01 08:30:00,114,158,175,447,2682
2016-09-01 08:40:00,173,217,220,610,3660
2016-09-01 08:50:00,198,221,218,637,3822
2016-09-01 09:00:00,238,261,256,755,4530
2016-09-01 09:10:00,252,276,270,798,4788
2016-09-01 09:20:00,245,267,264,776,4656
2016-09-01 09:30:00,251,272,269,792,4752
2016-09-01 09:40:00,455,478,472,1405,8430
2016-09-01 09:50:00,435,460,455,1350,8100
2016-09-01 10:00:00,416,438,432,1286,7716
2016-09-01 10:10:00,492,522,513,1527,9162
2016-09-01 10:20:00,329,354,349,1032,6192
2016-09-01 10:30:00,367,389,385,1141,6846
2016-09-01 10:40:00,411,436,434,1281,7686
2016-09-01 10:50:00,226,234,234,694,4164
2016-09-01 11:00:00,258,281,234,773,4638
2016-09-01 11:10:00,343,364,360,1067,6402
2016-09-01 11:20:00,524,550,543,1617,9702
2016-09-01 11:30:00,960,984,975,2919,17514
2016-09-01 11:40:00,1029,1054,1033,3116,18696
2016-09-01 11:50:00,697,716,700,2113,12678
2016-09-01 12:00:00,306,330,323,959,5754
2016-09-01 12:10:00,409,434,426,1269,7614
2016-09-01 12:20:00,368,392,388,1148,6888
2016-09-01 12:30:00,247,271,264,782,4692
2016-09-01 12:40:00,445,467,463,1375,8250
2016-09-01 12:50:00,480,502,500,1482,8892
2016-09-01 13:00:00,513,538,531,1582,9492
2016-09-01 13:10:00,417,437,432,1286,7716
2016-09-01 13:20:00,480,498,491,1469,8814
2016-09-01 13:30:00,552,576,570,1698,10188
2016-09-01 13:40:00,529,553,547,1629,9774
2016-09-01 13:50:00,509,532,525,1566,9396
2016-09-01 14:00:00,493,517,510,1520,9120
2016-09-01 14:10:00,620,645,636,1901,11406
2016-09-01 14:20:00,460,487,480,1427,8562
2016-09-01 14:30:00,443,467,462,1372,8232
2016-09-01 14:40:00,361,386,381,1128,6768
2016-09-01 14:50:00,364,389,383,1136,6816
2016-09-01 15:00:00,357,380,372,1109,6654
2016-09-01 15:10:00,505,531,522,1558,9348
2016-09-01 15:20:00,545,567,560,1672,10032
2016-09-01 15:30:00,495,516,508,1519,9114
2016-09-01 15:40:00,639,666,655,1960,11760
2016-09-01 15:50:00,603,631,621,1855,11130
2016-09-01 16:00:00,554,576,569,1699,10194
2016-09-01 16:10:00,515,537,530,1582,9492
2016-09-01 16:20:00,421,447,438,1306,7836
2016-09-01 16:30:00,425,452,443,1320,7920
2016-09-01 16:40:00,415,446,438,1299,7794
2016-09-01 16:50:00,323,351,343,1017,6102
2016-09-01 17:00:00,285,310,303,898,5388
2016-09-01 17:10:00,228,256,249,733,4398
2016-09-01 17:20:00,124,169,151,444,2664
2016-09-01 17:30:00,132,168,122,422,2532
2016-09-01 17:40:00,77,74,104,255,1530
2016-09-01 17:50:00,56,63,74,193,1158
2016-09-01 18:00:00,36,58,60,154,924
2016-09-01 18:10:00,25,61,26,112,672
2016-09-01 18:20:00,33,70,46,149,894
2016-09-01 18:30:00,73,73,93,239,1434
2016-09-01 18:40:00,45,62,63,170,1020
2016-09-01 18:50:00,14,26,23,63,378
2016-09-01 19:00:00,10,33,21,64,384
2016-09-01 19:10:00,14,19,20,53,318
2016-09-01 19:20:00,8,14,13,35,210
2016-09-01 19:30:00,3,8,5,16,96
2016-09-01 19:40:00,0,0,0,0,0
2016-09-01 19:50:00,0,0,0,0,0
2016-09-01 20:00:00,0,0,0,0,0
2016-09-01 20:10:00,0,0,0,0,0
2016-09-02 05:50:00,0,0,0,0,0
2016-09-02 06:00:00,0,0,0,0,0
2016-09-02 06:10:00,0,0,0,0,0
2016-09-02 06:20:00,0,0,0,0,0
2016-09-02 06:30:00,3,4,4,11,66
2016-09-02 06:40:00,15,21,21,57,342
2016-09-02 06:50:00,25,53,31,109,654
2016-09-02 07:00:00,26,56,31,113,678
2016-09-02 07:10:00,32,56,39,127,762
2016-09-02 07:20:00,33,63,34,130,780
2016-09-02 07:30:00,57,99,92,248,1488
2016-09-02 07:40:00,41,145,128,314,1884
2016-09-02 07:50:00,28,105,94,227,1362
2016-09-02 08:00:00,123,240,93,456,2736
2016-09-02 08:10:00,74,110,117,301,1806
2016-09-02 08:20:00,138,133,128,399,2394
2016-09-02 08:30:00,72,39,78,189,1134
2016-09-02 08:40:00,46,55,57,158,948
2016-09-02 08:50:00,47,64,50,161,966
2016-09-02 09:00:00,78,93,89,260,1560
2016-09-02 09:10:00,122,210,103,435,2610
2016-09-02 09:20:00,87,119,79,285,1710
2016-09-02 09:30:00,20,45,21,86,516
2016-09-02 09:40:00,24,47,20,91,546
2016-09-02 09:50:00,84,92,93,269,1614
2016-09-02 10:00:00,65,141,190,396,2376
2016-09-02 10:10:00,85,112,90,287,1722
2016-09-02 10:20:00,111,212,136,459,2754
2016-09-02 10:30:00,127,204,111,442,2652
2016-09-02 10:40:00,256,228,240,724,4344
2016-09-02 10:50:00,789,809,805,2403,14418
2016-09-02 11:00:00,756,773,766,2295,13770
2016-09-02 11:10:00,305,329,324,958,5748
2016-09-02 11:20:00,391,415,410,1216,7296
2016-09-02 11:30:00,609,633,629,1871,11226
2016-09-02 11:40:00,593,618,611,1822,10932
2016-09-02 11:50:00,627,654,649,1930,11580
2016-09-02 12:00:00,690,721,715,2126,12756
2016-09-02 12:10:00,648,676,672,1996,11976
2016-09-02 12:20:00,358,377,376,1111,6666
2016-09-02 12:30:00,320,340,338,998,5988
2016-09-02 12:40:00,334,353,349,1036,6216
2016-09-02 12:50:00,113,161,191,465,2790
2016-09-02 13:00:00,324,326,327,977,5862
2016-09-02 13:10:00,371,389,388,1148,6888
2016-09-02 13:20:00,465,486,484,1435,8610
2016-09-02 13:30:00,264,284,283,831,4986
2016-09-02 13:40:00,628,631,642,1901,11406
2016-09-02 13:50:00,453,485,479,1417,8502
2016-09-02 14:00:00,519,556,547,1622,9732
2016-09-02 14:10:00,515,551,541,1607,9642
2016-09-02 14:20:00,697,734,723,2154,12924
2016-09-02 14:30:00,833,862,849,2544,15264
2016-09-02 14:40:00,372,395,390,1157,6942
2016-09-02 14:50:00,113,137,132,382,2292
2016-09-02 15:00:00,68,82,82,232,1392
2016-09-02 15:10:00,167,196,180,543,3258
2016-09-02 15:20:00,249,331,201,781,4686
2016-09-02 15:30:00,94,149,112,355,2130
2016-09-02 15:40:00,125,126,135,386,2316
2016-09-02 15:50:00,53,42,59,154,924
2016-09-02 16:00:00,31,45,36,112,672
2016-09-02 16:10:00,78,58,92,228,1368
2016-09-02 16:20:00,22,36,30,88,528
2016-09-02 16:30:00,26,39,32,97,582
2016-09-02 16:40:00,83,70,93,246,1476
2016-09-02 16:50:00,40,57,57,154,924
2016-09-02 17:00:00,21,47,25,93,558
2016-09-02 17:10:00,24,39,21,84,504
2016-09-02 17:20:00,20,35,20,75,450
2016-09-02 17:30:00,26,46,21,93,558
2016-09-02 17:40:00,20,53,17,90,540
2016-09-02 17:50:00,8,11,6,25,150
2016-09-02 18:00:00,7,11,7,25,150
2016-09-02 18:10:00,5,10,6,21,126
2016-09-02 18:20:00,4,7,5,16,96
2016-09-02 18:30:00,3,5,3,11,66
2016-09-02 18:40:00,1,2,2,5,30
2016-09-02 18:50:00,1,2,1,4,24
2016-09-02 19:00:00,1,1,1,3,18
2016-09-02 19:10:00,0,0,0,0,0
2016-09-02 19:20:00,0,0,0,0,0
2016-09-02 19:30:00,0,0,0,0,0
2016-09-02 19:40:00,0,0,0,0,0
2016-09-02 19:50:00,0,0,0,0,0
2016-09-03 05:50:00,0,0,0,0,0
2016-09-03 06:00:00,0,0,0,0,0
2016-09-03 06:10:00,0,0,0,0,0
2016-09-03 06:20:00,0,0,0,0,0
2016-09-03 06:30:00,2,2,2,6,36
2016-09-03 06:40:00,8,10,10,28,168
2016-09-03 06:50:00,15,18,15,48,288
2016-09-03 07:00:00,18,20,21,59,354
2016-09-03 07:10:00,26,34,21,81,486
2016-09-03 07:20:00,21,44,17,82,492
2016-09-03 07:30:00,27,34,29,90,540
2016-09-03 07:40:00,26,44,28,98,588
2016-09-03 07:50:00,25,62,24,111,666
2016-09-03 08:00:00,44,53,58,155,930
2016-09-03 08:10:00,59,51,66,176,1056
2016-09-03 08:20:00,60,73,69,202,1212
2016-09-03 08:30:00,62,88,60,210,1260
2016-09-03 08:40:00,113,100,88,301,1806
2016-09-03 08:50:00,297,304,306,907,5442
2016-09-03 09:00:00,237,257,256,750,4500
2016-09-03 09:10:00,207,227,225,659,3954
2016-09-03 09:20:00,271,289,287,847,5082
2016-09-03 09:30:00,383,406,398,1187,7122
2016-09-03 09:40:00,555,581,573,1709,10254
2016-09-03 09:50:00,483,508,504,1495,8970
2016-09-03 10:00:00,376,397,394,1167,7002
2016-09-03 10:10:00,387,411,408,1206,7236
2016-09-03 10:20:00,789,812,806,2407,14442
2016-09-03 10:30:00,877,897,895,2669,16014
2016-09-03 10:40:00,724,745,744,2213,13278
2016-09-03 10:50:00,589,615,608,1812,10872
2016-09-03 11:00:00,439,466,459,1364,8184
2016-09-03 11:10:00,699,726,718,2143,12858
2016-09-03 11:20:00,559,581,571,1711,10266
2016-09-03 11:30:00,426,448,439,1313,7878
2016-09-03 11:40:00,528,549,539,1616,9696
2016-09-03 11:50:00,692,714,703,2109,12654
2016-09-03 12:00:00,393,417,410,1220,7320
2016-09-03 12:10:00,304,327,320,951,5706
2016-09-03 12:20:00,430,454,446,1330,7980
2016-09-03 12:30:00,388,407,401,1196,7176
2016-09-03 12:40:00,118,139,136,393,2358
2016-09-03 12:50:00,250,272,269,791,4746
2016-09-03 13:00:00,269,291,286,846,5076
2016-09-03 13:10:00,506,527,518,1551,9306
2016-09-03 13:20:00,328,347,342,1017,6102
2016-09-03 13:30:00,379,400,393,1172,7032
2016-09-03 13:40:00,774,796,785,2355,14130
2016-09-03 13:50:00,791,811,802,2404,14424
2016-09-03 14:00:00,631,654,642,1927,11562
2016-09-03 14:10:00,420,440,434,1294,7764
2016-09-03 14:20:00,477,497,492,1466,8796
2016-09-03 14:30:00,95,119,112,326,1956
2016-09-03 14:40:00,89,106,104,299,1794
2016-09-03 14:50:00,318,340,335,993,5958
2016-09-03 15:00:00,494,515,510,1519,9114
2016-09-03 15:10:00,512,532,531,1575,9450
2016-09-03 15:20:00,439,460,462,1361,8166
2016-09-03 15:30:00,374,395,396,1165,6990
2016-09-03 15:40:00,349,369,367,1085,6510
2016-09-03 15:50:00,285,311,287,883,5298
2016-09-03 16:00:00,406,425,426,1257,7542
2016-09-03 16:10:00,304,326,322,952,5712
2016-09-03 16:20:00,244,264,263,771,4626
2016-09-03 16:30:00,167,188,186,541,3246
2016-09-03 16:40:00,175,196,193,564,3384
2016-09-03 16:50:00,190,210,208,608,3648
2016-09-03 17:00:00,173,193,191,557,3342
2016-09-03 17:10:00,144,164,159,467,2802
2016-09-03 17:20:00,126,150,141,417,2502
2016-09-03 17:30:00,66,144,162,372,2232
2016-09-03 17:40:00,23,135,127,285,1710
2016-09-03 17:50:00,0,132,140,272,1632
2016-09-03 18:00:00,34,99,92,225,1350
2016-09-03 18:10:00,28,73,41,142,852
2016-09-03 18:20:00,38,39,36,113,678
2016-09-03 18:30:00,15,36,14,65,390
2016-09-03 18:40:00,21,34,8,63,378
2016-09-03 18:50:00,10,16,7,33,198
2016-09-03 19:00:00,2,6,3,11,66
2016-09-03 19:10:00,1,1,1,3,18
2016-09-03 19:20:00,0,0,0,0,0
2016-09-03 19:30:00,0,0,0,0,0
2016-09-03 19:40:00,0,0,0,0,0
2016-09-03 19:50:00,0,0,0,0,0
2016-09-04 06:00:00,0,0,0,0,0
2016-09-04 06:10:00,0,0,0,0,0
2016-09-04 06:20:00,0,0,0,0,0
2016-09-04 06:30:00,0,0,0,0,0
2016-09-04 06:40:00,0,0,0,0,0
2016-09-04 06:50:00,1,7,3,11,66
2016-09-04 07:00:00,2,7,6,15,90
2016-09-04 07:10:00,4,8,5,17,102
2016-09-04 07:20:00,6,14,8,28,168
2016-09-04 07:30:00,7,14,9,30,180
2016-09-04 07:40:00,27,47,35,109,654
2016-09-04 07:50:00,34,62,48,144,864
2016-09-04 08:00:00,33,52,49,134,804
2016-09-04 08:10:00,40,61,56,157,942
2016-09-04 08:20:00,32,62,75,169,1014
2016-09-04 08:30:00,33,60,80,173,1038
2016-09-04 08:40:00,44,97,89,230,1380
2016-09-04 08:50:00,30,133,127,290,1740
2016-09-04 09:00:00,15,134,135,284,1704
2016-09-04 09:10:00,21,136,135,292,1752
2016-09-04 09:20:00,67,135,95,297,1782
2016-09-04 09:30:00,70,133,115,318,1908
2016-09-04 09:40:00,63,163,143,369,2214
2016-09-04 09:50:00,73,162,219,454,2724
2016-09-04 10:00:00,34,149,277,460,2760
2016-09-04 10:10:00,106,80,150,336,2016
2016-09-04 10:20:00,67,101,113,281,1686
2016-09-04 10:30:00,36,82,48,166,996
2016-09-04 10:40:00,51,82,53,186,1116
2016-09-04 10:50:00,41,72,35,148,888
2016-09-04 11:00:00,53,72,56,181,1086
2016-09-04 11:10:00,85,100,95,280,1680
2016-09-04 11:20:00,167,176,246,589,3534
2016-09-04 11:30:00,163,187,192,542,3252
2016-09-04 11:40:00,152,174,169,495,2970
2016-09-04 11:50:00,111,137,129,377,2262
2016-09-04 12:00:00,73,126,128,327,1962
2016-09-04 12:10:00,68,128,121,317,1902
2016-09-04 12:20:00,69,156,146,371,2226
2016-09-04 12:30:00,91,116,106,313,1878
2016-09-04 12:40:00,52,54,49,155,930
2016-09-04 12:50:00,40,75,61,176,1056
2016-09-04 13:00:00,37,108,100,245,1470
2016-09-04 13:10:00,41,72,62,175,1050
2016-09-04 13:20:00,31,66,39,136,816
2016-09-04 13:30:00,27,65,33,125,750
2016-09-04 13:40:00,17,50,28,95,570
2016-09-04 13:50:00,22,74,52,148,888
2016-09-04 14:00:00,21,113,98,232,1392
2016-09-04 14:10:00,14,124,120,258,1548
2016-09-04 14:20:00,24,81,53,158,948
2016-09-04 14:30:00,34,76,43,153,918
2016-09-04 14:40:00,20,49,27,96,576
2016-09-04 14:50:00,25,46,37,108,648
2016-09-04 15:00:00,36,73,71,180,1080
2016-09-04 15:10:00,28,68,62,158,948
2016-09-04 15:20:00,31,58,46,135,810
2016-09-04 15:30:00,25,71,52,148,888
2016-09-04 15:40:00,34,62,51,147,882
2016-09-04 15:50:00,24,62,39,125,750
2016-09-04 16:00:00,29,59,38,126,756
2016-09-04 16:10:00,38,53,52,143,858
2016-09-04 16:20:00,37,60,63,160,960
2016-09-04 16:30:00,30,62,62,154,924
2016-09-04 16:40:00,23,61,35,119,714
2016-09-04 16:50:00,19,67,34,120,720
2016-09-04 17:00:00,26,60,38,124,744
2016-09-04 17:10:00,30,60,41,131,786
2016-09-04 17:20:00,37,56,61,154,924
2016-09-04 17:30:00,20,78,74,172,1032
2016-09-04 17:40:00,21,75,53,149,894
2016-09-04 17:50:00,15,59,34,108,648
2016-09-04 18:00:00,14,44,18,76,456
2016-09-04 18:10:00,12,28,5,45,270
2016-09-04 18:20:00,7,13,5,25,150
2016-09-04 18:30:00,3,19,7,29,174
2016-09-04 18:40:00,5,24,8,37,222
2016-09-04 18:50:00,4,24,14,42,252
2016-09-04 19:00:00,7,29,19,55,330
2016-09-04 19:10:00,8,19,11,38,228
2016-09-04 19:20:00,3,18,6,27,162
2016-09-04 19:30:00,0,1,0,1,6
2016-09-04 19:40:00,0,0,0,0,0
2016-09-04 19:50:00,0,0,0,0,0
2016-09-04 20:00:00,0,0,0,0,0
2016-09-05 05:50:00,0,0,0,0,0
2016-09-05 06:00:00,0,0,0,0,0
2016-09-05 06:10:00,0,0,0,0,0
2016-09-05 06:20:00,0,0,0,0,0
2016-09-05 06:30:00,1,1,1,3,18
2016-09-05 06:40:00,3,7,4,14,84
2016-09-05 06:50:00,6,10,7,23,138
2016-09-05 07:00:00,8,15,10,33,198
2016-09-05 07:10:00,9,20,18,47,282
2016-09-05 07:20:00,13,27,17,57,342
2016-09-05 07:30:00,14,33,18,65,390
2016-09-05 07:40:00,17,30,26,73,438
2016-09-05 07:50:00,17,34,29,80,480
2016-09-05 08:00:00,17,41,31,89,534
2016-09-05 08:10:00,27,43,30,100,600
2016-09-05 08:20:00,30,41,36,107,642
2016-09-05 08:30:00,14,88,14,116,696
2016-09-05 08:40:00,26,66,32,124,744
2016-09-05 08:50:00,140,164,156,460,2760
2016-09-05 09:00:00,344,368,363,1075,6450
2016-09-05 09:10:00,405,430,426,1261,7566
2016-09-05 09:20:00,468,498,491,1457,8742
2016-09-05 09:30:00,526,554,546,1626,9756
2016-09-05 09:40:00,583,617,606,1806,10836
2016-09-05 09:50:00,643,675,666,1984,11904
2016-09-05 10:00:00,696,728,722,2146,12876
2016-09-05 10:10:00,743,776,761,2280,13680
2016-09-05 10:20:00,786,817,804,2407,14442
2016-09-05 10:30:00,812,850,838,2500,15000
2016-09-05 10:40:00,844,868,858,2570,15420
2016-09-05 10:50:00,868,894,878,2640,15840
2016-09-05 11:00:00,882,915,897,2694,16164
2016-09-05 11:10:00,904,925,919,2748,16488
2016-09-05 11:20:00,917,940,937,2794,16764
2016-09-05 11:30:00,929,965,947,2841,17046
2016-09-05 11:40:00,944,981,963,2888,17328
2016-09-05 11:50:00,952,989,974,2915,17490
2016-09-05 12:00:00,961,989,977,2927,17562
2016-09-05 12:10:00,969,994,984,2947,17682
2016-09-05 12:20:00,975,999,991,2965,17790
2016-09-05 12:30:00,979,1004,994,2977,17862
2016-09-05 12:40:00,984,1011,1000,2995,17970
2016-09-05 12:50:00,981,1014,1010,3005,18030
2016-09-05 13:00:00,996,1019,1013,3028,18168
2016-09-05 13:10:00,975,1013,1012,3000,18000
2016-09-05 13:20:00,981,1007,999,2987,17922
2016-09-05 13:30:00,974,1006,999,2979,17874
2016-09-05 13:40:00,972,1000,989,2961,17766
2016-09-05 13:50:00,958,988,973,2919,17514
2016-09-05 14:00:00,953,985,966,2904,17424
2016-09-05 14:10:00,938,970,959,2867,17202
2016-09-05 14:20:00,905,958,954,2817,16902
2016-09-05 14:30:00,880,939,935,2754,16524
2016-09-05 14:40:00,868,899,895,2662,15972
2016-09-05 14:50:00,836,867,861,2564,15384
2016-09-05 15:00:00,789,829,821,2439,14634
2016-09-05 15:10:00,738,776,770,2284,13704
2016-09-05 15:20:00,709,748,740,2197,13182
2016-09-05 15:30:00,679,713,706,2098,12588
2016-09-05 15:40:00,639,665,664,1968,11808
2016-09-05 15:50:00,586,611,613,1810,10860
2016-09-05 16:00:00,537,569,569,1675,10050
2016-09-05 16:10:00,498,526,517,1541,9246
2016-09-05 16:20:00,451,476,462,1389,8334
2016-09-05 16:30:00,407,431,422,1260,7560
2016-09-05 16:40:00,355,383,373,1111,6666
2016-09-05 16:50:00,311,337,332,980,5880
2016-09-05 17:00:00,268,293,289,850,5100
2016-09-05 17:10:00,217,241,238,696,4176
2016-09-05 17:20:00,135,188,167,490,2940
2016-09-05 17:30:00,79,97,104,280,1680
2016-09-05 17:40:00,50,48,68,166,996
2016-09-05 17:50:00,24,51,36,111,666
2016-09-05 18:00:00,31,44,33,108,648
2016-09-05 18:10:00,29,38,33,100,600
2016-09-05 18:20:00,19,41,29,89,534
2016-09-05 18:30:00,20,28,29,77,462
2016-09-05 18:40:00,11,29,18,58,348
2016-09-05 18:50:00,11,24,18,53,318
2016-09-05 19:00:00,9,10,15,34,204
2016-09-05 19:10:00,6,10,8,24,144
2016-09-05 19:20:00,3,8,6,17,102
2016-09-05 19:30:00,1,3,1,5,30
2016-09-05 19:40:00,0,0,0,0,0
2016-09-05 19:50:00,0,0,0,0,0
2016-09-05 20:00:00,0,0,0,0,0
2016-09-06 05:50:00,0,0,0,0,0
2016-09-06 06:00:00,0,0,0,0,0
2016-09-06 06:10:00,0,0,0,0,0
2016-09-06 06:20:00,0,0,0,0,0
2016-09-06 06:30:00,0,0,0,0,0
2016-09-06 06:40:00,2,4,3,9,54
2016-09-06 06:50:00,4,14,5,23,138
2016-09-06 07:00:00,5,21,7,33,198
2016-09-06 07:10:00,11,31,13,55,330
2016-09-06 07:20:00,21,51,26,98,588
2016-09-06 07:30:00,28,69,39,136,816
2016-09-06 07:40:00,42,80,67,189,1134
2016-09-06 07:50:00,35,78,66,179,1074
2016-09-06 08:00:00,44,72,57,173,1038
2016-09-06 08:10:00,61,81,68,210,1260
2016-09-06 08:20:00,43,81,56,180,1080
2016-09-06 08:30:00,22,86,21,129,774
2016-09-06 08:40:00,10,96,16,122,732
2016-09-06 08:50:00,132,166,139,437,2622
2016-09-06 09:00:00,352,363,357,1072,6432
2016-09-06 09:10:00,407,427,421,1255,7530
2016-09-06 09:20:00,473,491,485,1449,8694
2016-09-06 09:30:00,531,551,547,1629,9774
2016-09-06 09:40:00,588,604,604,1796,10776
2016-09-06 09:50:00,651,673,667,1991,11946
2016-09-06 10:00:00,705,726,719,2150,12900
2016-09-06 10:10:00,750,768,763,2281,13686
2016-09-06 10:20:00,801,808,808,2417,14502
2016-09-06 10:30:00,838,848,845,2531,15186
2016-09-06 10:40:00,856,873,867,2596,15576
2016-09-06 10:50:00,874,899,885,2658,15948
2016-09-06 11:00:00,888,916,907,2711,16266
2016-09-06 11:10:00,909,927,922,2758,16548
2016-09-06 11:20:00,933,945,945,2823,16938
2016-09-06 11:30:00,938,964,954,2856,17136
2016-09-06 11:40:00,951,975,973,2899,17394
2016-09-06 11:50:00,962,985,978,2925,17550
2016-09-06 12:00:00,967,998,978,2943,17658
2016-09-06 12:10:00,970,996,985,2951,17706
2016-09-06 12:20:00,971,995,989,2955,17730
2016-09-06 12:30:00,981,1008,996,2985,17910
2016-09-06 12:40:00,974,1011,1001,2986,17916
2016-09-06 12:50:00,979,1010,999,2988,17928
2016-09-06 13:00:00,979,1007,996,2982,17892
2016-09-06 13:10:00,976,1011,999,2986,17916
2016-09-06 13:20:00,971,1006,993,2970,17820
2016-09-06 13:30:00,975,1001,996,2972,17832
2016-09-06 13:40:00,970,994,988,2952,17712
2016-09-06 13:50:00,963,990,979,2932,17592
2016-09-06 14:00:00,933,960,947,2840,17040
2016-09-06 14:10:00,934,970,956,2860,17160
2016-09-06 14:20:00,927,957,944,2828,16968
2016-09-06 14:30:00,745,778,767,2290,13740
2016-09-06 14:40:00,812,844,835,2491,14946
2016-09-06 14:50:00,836,862,855,2553,15318
2016-09-06 15:00:00,716,742,737,2195,13170
2016-09-06 15:10:00,725,754,745,2224,13344
2016-09-06 15:20:00,693,717,710,2120,12720
2016-09-06 15:30:00,646,670,665,1981,11886
2016-09-06 15:40:00,549,578,574,1701,10206
2016-09-06 15:50:00,476,507,500,1483,8898
2016-09-06 16:00:00,334,356,348,1038,6228
2016-09-06 16:10:00,347,371,363,1081,6486
2016-09-06 16:20:00,328,354,344,1026,6156
2016-09-06 16:30:00,241,268,264,773,4638
2016-09-06 16:40:00,159,185,183,527,3162
2016-09-06 16:50:00,221,245,240,706,4236
2016-09-06 17:00:00,223,249,244,716,4296
2016-09-06 17:10:00,165,192,185,542,3252
2016-09-06 17:20:00,103,135,131,369,2214
2016-09-06 17:30:00,84,125,133,342,2052
2016-09-06 17:40:00,90,54,109,253,1518
2016-09-06 17:50:00,61,69,83,213,1278
2016-09-06 18:00:00,74,73,97,244,1464
2016-09-06 18:10:00,72,78,84,234,1404
2016-09-06 18:20:00,46,58,69,173,1038
2016-09-06 18:30:00,22,66,35,123,738
2016-09-06 18:40:00,23,49,28,100,600
2016-09-06 18:50:00,23,43,30,96,576
2016-09-06 19:00:00,13,29,20,62,372
2016-09-06 19:10:00,7,13,14,34,204
2016-09-06 19:20:00,3,7,7,17,102
2016-09-06 19:30:00,0,2,0,2,12
2016-09-06 19:40:00,0,0,0,0,0
2016-09-06 19:50:00,0,0,0,0,0
2016-09-06 20:00:00,0,0,0,0,0
2016-09-07 06:00:00,0,0,0,0,0
2016-09-07 06:10:00,0,0,0,0,0
2016-09-07 06:20:00,0,0,0,0,0
2016-09-07 06:30:00,0,0,0,0,0
2016-09-07 06:40:00,1,2,1,4,24
2016-09-07 06:50:00,5,6,5,16,96
2016-09-07 07:00:00,6,15,17,38,228
2016-09-07 07:10:00,27,17,16,60,360
2016-09-07 07:20:00,14,20,17,51,306
2016-09-07 07:30:00,19,62,22,103,618
2016-09-07 07:40:00,26,61,44,131,786
2016-09-07 07:50:00,34,58,48,140,840
2016-09-07 08:00:00,37,61,66,164,984
2016-09-07 08:10:00,69,85,88,242,1452
2016-09-07 08:20:00,143,156,116,415,2490
2016-09-07 08:30:00,88,106,106,300,1800
2016-09-07 08:40:00,94,119,114,327,1962
2016-09-07 08:50:00,163,156,185,504,3024
2016-09-07 09:00:00,134,106,133,373,2238
2016-09-07 09:10:00,115,118,106,339,2034
2016-09-07 09:20:00,84,111,106,301,1806
2016-09-07 09:30:00,100,110,103,313,1878
2016-09-07 09:40:00,72,76,80,228,1368
2016-09-07 09:50:00,108,116,93,317,1902
2016-09-07 10:00:00,106,116,167,389,2334
2016-09-07 10:10:00,126,126,189,441,2646
2016-09-07 10:20:00,142,191,150,483,2898
2016-09-07 10:30:00,168,158,183,509,3054
2016-09-07 10:40:00,338,363,358,1059,6354
2016-09-07 10:50:00,333,355,351,1039,6234
2016-09-07 11:00:00,310,331,324,965,5790
2016-09-07 11:10:00,226,247,246,719,4314
2016-09-07 11:20:00,564,588,577,1729,10374
2016-09-07 11:30:00,581,609,599,1789,10734
2016-09-07 11:40:00,302,322,319,943,5658
2016-09-07 11:50:00,385,407,401,1193,7158
2016-09-07 12:00:00,365,390,383,1138,6828
2016-09-07 12:10:00,399,422,417,1238,7428
2016-09-07 12:20:00,272,294,290,856,5136
2016-09-07 12:30:00,319,343,338,1000,6000
2016-09-07 12:40:00,361,387,380,1128,6768
2016-09-07 12:50:00,377,401,392,1170,7020
2016-09-07 13:00:00,416,438,428,1282,7692
2016-09-07 13:10:00,290,311,303,904,5424
2016-09-07 13:20:00,256,278,271,805,4830
2016-09-07 13:30:00,286,305,301,892,5352
2016-09-07 13:40:00,394,414,413,1221,7326
2016-09-07 13:50:00,457,478,474,1409,8454
2016-09-07 14:00:00,308,331,327,966,5796
2016-09-07 14:10:00,613,633,630,1876,11256
2016-09-07 14:20:00,366,389,386,1141,6846
2016-09-07 14:30:00,329,350,347,1026,6156
2016-09-07 14:40:00,246,267,263,776,4656
2016-09-07 14:50:00,236,181,195,612,3672
2016-09-07 15:00:00,273,134,179,586,3516
2016-09-07 15:10:00,316,117,187,620,3720
2016-09-07 15:20:00,249,132,168,549,3294
2016-09-07 15:30:00,183,154,178,515,3090
2016-09-07 15:40:00,231,261,247,739,4434
2016-09-07 15:50:00,167,156,181,504,3024
2016-09-07 16:00:00,149,106,155,410,2460
2016-09-07 16:10:00,84,95,107,286,1716
2016-09-07 16:20:00,120,87,128,335,2010
2016-09-07 16:30:00,104,95,120,319,1914
2016-09-07 16:40:00,85,102,101,288,1728
2016-09-07 16:50:00,55,70,70,195,1170
2016-09-07 17:00:00,61,71,73,205,1230
2016-09-07 17:10:00,46,74,64,184,1104
2016-09-07 17:20:00,37,57,50,144,864
2016-09-07 17:30:00,27,59,32,118,708
2016-09-07 17:40:00,29,43,33,105,630
2016-09-07 17:50:00,29,33,36,98,588
2016-09-07 18:00:00,24,22,32,78,468
2016-09-07 18:10:00,19,22,22,63,378
2016-09-07 18:20:00,12,26,13,51,306
2016-09-07 18:30:00,9,12,9,30,180
2016-09-07 18:40:00,4,11,5,20,120
2016-09-07 18:50:00,2,6,4,12,72
2016-09-07 19:00:00,1,2,1,4,24
2016-09-07 19:10:00,0,0,0,0,0
2016-09-07 19:20:00,0,0,0,0,0
2016-09-07 19:30:00,0,0,0,0,0
2016-09-07 19:40:00,0,0,0,0,0
2016-09-07 19:50:00,0,0,0,0,0
2016-09-08 06:00:00,0,0,0,0,0
2016-09-08 06:10:00,0,0,0,0,0
2016-09-08 06:20:00,0,0,0,0,0
2016-09-08 06:30:00,0,0,0,0,0
2016-09-08 06:40:00,3,3,5,11,66
2016-09-08 06:50:00,7,13,10,30,180
2016-09-08 07:00:00,13,24,15,52,312
2016-09-08 07:10:00,14,44,23,81,486
2016-09-08 07:20:00,25,57,27,109,654
2016-09-08 07:30:00,23,72,51,146,876
2016-09-08 07:40:00,51,79,52,182,1092
2016-09-08 07:50:00,37,77,63,177,1062
2016-09-08 08:00:00,29,72,72,173,1038
2016-09-08 08:10:00,40,75,60,175,1050
2016-09-08 08:20:00,59,86,69,214,1284
2016-09-08 08:30:00,76,92,75,243,1458
2016-09-08 08:40:00,75,113,84,272,1632
2016-09-08 08:50:00,135,162,126,423,2538
2016-09-08 09:00:00,255,277,270,802,4812
2016-09-08 09:10:00,309,330,323,962,5772
2016-09-08 09:20:00,366,389,381,1136,6816
2016-09-08 09:30:00,438,461,457,1356,8136
2016-09-08 09:40:00,522,541,538,1601,9606
2016-09-08 09:50:00,581,604,601,1786,10716
2016-09-08 10:00:00,634,654,649,1937,11622
2016-09-08 10:10:00,680,695,693,2068,12408
2016-09-08 10:20:00,735,750,745,2230,13380
2016-09-08 10:30:00,773,788,786,2347,14082
2016-09-08 10:40:00,760,775,771,2306,13836
2016-09-08 10:50:00,789,804,794,2387,14322
2016-09-08 11:00:00,831,853,848,2532,15192
2016-09-08 11:10:00,873,899,890,2662,15972
2016-09-08 11:20:00,892,916,906,2714,16284
2016-09-08 11:30:00,915,928,921,2764,16584
2016-09-08 11:40:00,928,946,939,2813,16878
2016-09-08 11:50:00,934,953,948,2835,17010
2016-09-08 12:00:00,940,959,948,2847,17082
2016-09-08 12:10:00,944,959,948,2851,17106
2016-09-08 12:20:00,945,960,950,2855,17130
2016-09-08 12:30:00,951,961,960,2872,17232
2016-09-08 12:40:00,954,966,969,2889,17334
2016-09-08 12:50:00,947,968,959,2874,17244
2016-09-08 13:00:00,940,960,953,2853,17118
2016-09-08 13:10:00,933,953,945,2831,16986
2016-09-08 13:20:00,929,944,932,2805,16830
2016-09-08 13:30:00,917,935,925,2777,16662
2016-09-08 13:40:00,904,924,914,2742,16452
2016-09-08 13:50:00,892,911,901,2704,16224
2016-09-08 14:00:00,884,902,892,2678,16068
2016-09-08 14:10:00,870,885,870,2625,15750
2016-09-08 14:20:00,852,874,858,2584,15504
2016-09-08 14:30:00,826,847,832,2505,15030
2016-09-08 14:40:00,796,828,812,2436,14616
2016-09-08 14:50:00,762,785,776,2323,13938
2016-09-08 15:00:00,709,737,730,2176,13056
2016-09-08 15:10:00,674,696,692,2062,12372
2016-09-08 15:20:00,644,667,662,1973,11838
2016-09-08 15:30:00,597,620,616,1833,10998
2016-09-08 15:40:00,543,573,567,1683,10098
2016-09-08 15:50:00,486,526,517,1529,9174
2016-09-08 16:00:00,455,488,477,1420,8520
2016-09-08 16:10:00,385,415,404,1204,7224
2016-09-08 16:20:00,393,415,405,1213,7278
2016-09-08 16:30:00,232,256,247,735,4410
2016-09-08 16:40:00,271,298,284,853,5118
2016-09-08 16:50:00,206,232,225,663,3978
2016-09-08 17:00:00,88,112,107,307,1842
2016-09-08 17:10:00,165,232,130,527,3162
2016-09-08 17:20:00,148,166,161,475,2850
2016-09-08 17:30:00,85,96,97,278,1668
2016-09-08 17:40:00,59,80,64,203,1218
2016-09-08 17:50:00,46,73,54,173,1038
2016-09-08 18:00:00,41,65,49,155,930
2016-09-08 18:10:00,23,85,27,135,810
2016-09-08 18:20:00,20,84,14,118,708
2016-09-08 18:30:00,32,46,19,97,582
2016-09-08 18:40:00,18,29,22,69,414
2016-09-08 18:50:00,17,24,19,60,360
2016-09-08 19:00:00,11,16,17,44,264
2016-09-08 19:10:00,6,13,9,28,168
2016-09-08 19:20:00,2,5,2,9,54
2016-09-08 19:30:00,0,0,0,0,0
2016-09-08 19:40:00,0,0,0,0,0
2016-09-08 19:50:00,0,0,0,0,0
2016-09-09 06:00:00,0,0,0,0,0
2016-09-09 06:10:00,0,0,0,0,0
2016-09-09 06:20:00,0,0,0,0,0
2016-09-09 06:30:00,0,0,0,0,0
2016-09-09 06:40:00,0,0,0,0,0
2016-09-09 06:50:00,3,7,4,14,84
2016-09-09 07:00:00,8,20,13,41,246
2016-09-09 07:10:00,22,28,30,80,480
2016-09-09 07:20:00,43,49,53,145,870
2016-09-09 07:30:00,30,51,52,133,798
2016-09-09 07:40:00,26,52,33,111,666
2016-09-09 07:50:00,34,48,36,118,708
2016-09-09 08:00:00,52,53,64,169,1014
2016-09-09 08:10:00,92,80,109,281,1686
2016-09-09 08:20:00,88,66,98,252,1512
2016-09-09 08:30:00,89,103,69,261,1566
2016-09-09 08:40:00,83,119,88,290,1740
2016-09-09 08:50:00,91,113,94,298,1788
2016-09-09 09:00:00,85,228,158,471,2826
2016-09-09 09:10:00,207,213,210,630,3780
2016-09-09 09:20:00,234,250,247,731,4386
2016-09-09 09:30:00,385,404,397,1186,7116
2016-09-09 09:40:00,464,484,479,1427,8562
2016-09-09 09:50:00,551,575,577,1703,10218
2016-09-09 10:00:00,623,648,650,1921,11526
2016-09-09 10:10:00,670,692,701,2063,12378
2016-09-09 10:20:00,719,752,745,2216,13296
2016-09-09 10:30:00,768,795,788,2351,14106
2016-09-09 10:40:00,798,819,820,2437,14622
2016-09-09 10:50:00,807,832,831,2470,14820
2016-09-09 11:00:00,841,866,856,2563,15378
2016-09-09 11:10:00,856,878,880,2614,15684
2016-09-09 11:20:00,870,899,891,2660,15960
2016-09-09 11:30:00,891,920,909,2720,16320
2016-09-09 11:40:00,901,933,921,2755,16530
2016-09-09 11:50:00,914,947,935,2796,16776
2016-09-09 12:00:00,929,953,943,2825,16950
2016-09-09 12:10:00,936,971,958,2865,17190
2016-09-09 12:20:00,945,968,970,2883,17298
2016-09-09 12:30:00,948,976,969,2893,17358
2016-09-09 12:40:00,951,983,975,2909,17454
2016-09-09 12:50:00,954,980,975,2909,17454
2016-09-09 13:00:00,950,978,972,2900,17400
2016-09-09 13:10:00,948,982,972,2902,17412
2016-09-09 13:20:00,947,984,973,2904,17424
2016-09-09 13:30:00,940,976,965,2881,17286
2016-09-09 13:40:00,928,960,948,2836,17016
2016-09-09 13:50:00,920,945,934,2799,16794
2016-09-09 14:00:00,912,937,924,2773,16638
2016-09-09 14:10:00,902,926,918,2746,16476
2016-09-09 14:20:00,863,892,881,2636,15816
2016-09-09 14:30:00,841,877,862,2580,15480
2016-09-09 14:40:00,808,838,827,2473,14838
2016-09-09 14:50:00,784,811,804,2399,14394
2016-09-09 15:00:00,736,762,755,2253,13518
2016-09-09 15:10:00,707,733,726,2166,12996
2016-09-09 15:20:00,663,683,680,2026,12156
2016-09-09 15:30:00,620,643,635,1898,11388
2016-09-09 15:40:00,584,608,600,1792,10752
2016-09-09 15:50:00,532,554,548,1634,9804
2016-09-09 16:00:00,501,520,514,1535,9210
2016-09-09 16:10:00,448,470,461,1379,8274
2016-09-09 16:20:00,403,426,419,1248,7488
2016-09-09 16:30:00,348,369,361,1078,6468
2016-09-09 16:40:00,302,324,320,946,5676
2016-09-09 16:50:00,256,277,272,805,4830
2016-09-09 17:00:00,211,236,229,676,4056
2016-09-09 17:10:00,164,185,179,528,3168
2016-09-09 17:20:00,116,135,131,382,2292
2016-09-09 17:30:00,50,64,61,175,1050
2016-09-09 17:40:00,25,65,32,122,732
2016-09-09 17:50:00,27,58,33,118,708
2016-09-09 18:00:00,37,42,30,109,654
2016-09-09 18:10:00,24,41,29,94,564
2016-09-09 18:20:00,18,39,25,82,492
2016-09-09 18:30:00,23,32,16,71,426
2016-09-09 18:40:00,17,20,22,59,354
2016-09-09 18:50:00,12,18,15,45,270
2016-09-09 19:00:00,8,13,10,31,186
2016-09-09 19:10:00,5,8,4,17,102
2016-09-09 19:20:00,1,2,1,4,24
2016-09-09 19:30:00,0,0,0,0,0
2016-09-09 19:40:00,0,0,0,0,0
2016-09-09 19:50:00,0,0,0,0,0
2016-09-10 06:00:00,0,0,0,0,0
2016-09-10 06:10:00,0,0,0,0,0
2016-09-10 06:20:00,0,0,0,0,0
2016-09-10 06:30:00,0,0,0,0,0
2016-09-10 06:40:00,1,3,1,5,30
2016-09-10 06:50:00,4,10,7,21,126
2016-09-10 07:00:00,9,14,15,38,228
2016-09-10 07:10:00,13,25,17,55,330
2016-09-10 07:20:00,20,32,19,71,426
2016-09-10 07:30:00,26,27,34,87,522
2016-09-10 07:40:00,25,44,34,103,618
2016-09-10 07:50:00,22,73,23,118,708
2016-09-10 08:00:00,21,81,31,133,798
2016-09-10 08:10:00,39,55,53,147,882
2016-09-10 08:20:00,23,73,68,164,984
2016-09-10 08:30:00,44,77,58,179,1074
2016-09-10 08:40:00,55,74,69,198,1188
2016-09-10 08:50:00,75,113,94,282,1692
2016-09-10 09:00:00,200,222,182,604,3624
2016-09-10 09:10:00,214,235,229,678,4068
2016-09-10 09:20:00,227,253,245,725,4350
2016-09-10 09:30:00,332,358,347,1037,6222
2016-09-10 09:40:00,457,484,473,1414,8484
2016-09-10 09:50:00,569,596,586,1751,10506
2016-09-10 10:00:00,632,657,649,1938,11628
2016-09-10 10:10:00,671,701,688,2060,12360
2016-09-10 10:20:00,714,742,729,2185,13110
2016-09-10 10:30:00,758,781,770,2309,13854
2016-09-10 10:40:00,780,804,796,2380,14280
2016-09-10 10:50:00,806,828,814,2448,14688
2016-09-10 11:00:00,830,848,834,2512,15072
2016-09-10 11:10:00,850,871,860,2581,15486
2016-09-10 11:20:00,862,883,873,2618,15708
2016-09-10 11:30:00,875,899,892,2666,15996
2016-09-10 11:40:00,891,911,898,2700,16200
2016-09-10 11:50:00,892,920,912,2724,16344
2016-09-10 12:00:00,895,922,922,2739,16434
2016-09-10 12:10:00,895,939,926,2760,16560
2016-09-10 12:20:00,906,945,931,2782,16692
2016-09-10 12:30:00,908,949,936,2793,16758
2016-09-10 12:40:00,899,931,919,2749,16494
2016-09-10 12:50:00,900,926,917,2743,16458
2016-09-10 13:00:00,897,923,920,2740,16440
2016-09-10 13:10:00,904,928,925,2757,16542
2016-09-10 13:20:00,897,920,907,2724,16344
2016-09-10 13:30:00,898,925,906,2729,16374
2016-09-10 13:40:00,882,906,891,2679,16074
2016-09-10 13:50:00,869,901,886,2656,15936
2016-09-10 14:00:00,862,890,880,2632,15792
2016-09-10 14:10:00,851,878,871,2600,15600
2016-09-10 14:20:00,845,867,857,2569,15414
2016-09-10 14:30:00,814,836,832,2482,14892
2016-09-10 14:40:00,792,822,816,2430,14580
2016-09-10 14:50:00,749,788,773,2310,13860
2016-09-10 15:00:00,710,746,739,2195,13170
2016-09-10 15:10:00,685,718,708,2111,12666
2016-09-10 15:20:00,650,674,665,1989,11934
2016-09-10 15:30:00,600,626,619,1845,11070
2016-09-10 15:40:00,555,587,578,1720,10320
2016-09-10 15:50:00,509,538,532,1579,9474
2016-09-10 16:00:00,460,486,479,1425,8550
2016-09-10 16:10:00,412,437,430,1279,7674
2016-09-10 16:20:00,357,381,376,1114,6684
2016-09-10 16:30:00,320,349,341,1010,6060
2016-09-10 16:40:00,270,295,289,854,5124
2016-09-10 16:50:00,237,261,256,754,4524
2016-09-10 17:00:00,189,211,207,607,3642
2016-09-10 17:10:00,136,158,155,449,2694
2016-09-10 17:20:00,92,119,108,319,1914
2016-09-10 17:30:00,54,73,60,187,1122
2016-09-10 17:40:00,43,54,54,151,906
2016-09-10 17:50:00,42,60,49,151,906
2016-09-10 18:00:00,34,69,33,136,816
2016-09-10 18:10:00,18,86,23,127,762
2016-09-10 18:20:00,22,62,26,110,660
2016-09-10 18:30:00,26,33,24,83,498
2016-09-10 18:40:00,18,22,24,64,384
2016-09-10 18:50:00,8,11,10,29,174
2016-09-10 19:00:00,1,2,1,4,24
2016-09-10 19:10:00,0,0,0,0,0
2016-09-10 19:20:00,0,0,0,0,0
2016-09-10 19:30:00,0,0,0,0,0
2016-09-10 19:40:00,0,0,0,0,0
2016-09-11 06:10:00,0,0,0,0,0
2016-09-11 06:20:00,0,0,0,0,0
2016-09-11 06:30:00,0,0,0,0,0
2016-09-11 06:40:00,0,0,0,0,0
2016-09-11 06:50:00,3,5,5,13,78
2016-09-11 07:00:00,8,10,11,29,174
2016-09-11 07:10:00,18,32,26,76,456
2016-09-11 07:20:00,28,48,37,113,678
2016-09-11 07:30:00,39,46,39,124,744
2016-09-11 07:40:00,29,44,31,104,624
2016-09-11 07:50:00,17,36,22,75,450
2016-09-11 08:00:00,59,69,78,206,1236
2016-09-11 08:10:00,50,67,65,182,1092
2016-09-11 08:20:00,76,93,79,248,1488
2016-09-11 08:30:00,99,123,93,315,1890
2016-09-11 08:40:00,186,130,137,453,2718
2016-09-11 08:50:00,92,106,88,286,1716
2016-09-11 09:00:00,108,131,129,368,2208
2016-09-11 09:10:00,115,142,89,346,2076
2016-09-11 09:20:00,104,102,110,316,1896
2016-09-11 09:30:00,161,163,227,551,3306
2016-09-11 09:40:00,436,457,452,1345,8070
2016-09-11 09:50:00,557,576,569,1702,10212
2016-09-11 10:00:00,627,648,645,1920,11520
2016-09-11 10:10:00,672,692,690,2054,12324
2016-09-11 10:20:00,735,754,750,2239,13434
2016-09-11 10:30:00,836,860,855,2551,15306
2016-09-11 10:40:00,815,833,832,2480,14880
2016-09-11 10:50:00,848,865,861,2574,15444
2016-09-11 11:00:00,757,778,775,2310,13860
2016-09-11 11:10:00,905,928,915,2748,16488
2016-09-11 11:20:00,950,969,962,2881,17286
2016-09-11 11:30:00,908,934,926,2768,16608
2016-09-11 11:40:00,938,971,957,2866,17196
2016-09-11 11:50:00,779,800,784,2363,14178
2016-09-11 12:00:00,758,780,765,2303,13818
2016-09-11 12:10:00,984,1006,988,2978,17868
2016-09-11 12:20:00,988,1014,1000,3002,18012
2016-09-11 12:30:00,987,1009,1002,2998,17988
2016-09-11 12:40:00,986,1010,997,2993,17958
2016-09-11 12:50:00,978,1001,992,2971,17826
2016-09-11 13:00:00,976,1001,993,2970,17820
2016-09-11 13:10:00,974,999,992,2965,17790
2016-09-11 13:20:00,969,992,990,2951,17706
2016-09-11 13:30:00,973,995,990,2958,17748
2016-09-11 13:40:00,963,985,978,2926,17556
2016-09-11 13:50:00,953,976,973,2902,17412
2016-09-11 14:00:00,951,977,969,2897,17382
2016-09-11 14:10:00,958,979,977,2914,17484
2016-09-11 14:20:00,476,496,490,1462,8772
2016-09-11 14:30:00,655,675,674,2004,12024
2016-09-11 14:40:00,970,991,990,2951,17706
2016-09-11 14:50:00,682,701,702,2085,12510
2016-09-11 15:00:00,774,800,791,2365,14190
2016-09-11 15:10:00,792,819,809,2420,14520
2016-09-11 15:20:00,640,664,655,1959,11754
2016-09-11 15:30:00,660,681,674,2015,12090
2016-09-11 15:40:00,612,637,626,1875,11250
2016-09-11 15:50:00,548,573,567,1688,10128
2016-09-11 16:00:00,500,523,514,1537,9222
2016-09-11 16:10:00,459,481,474,1414,8484
2016-09-11 16:20:00,404,426,420,1250,7500
2016-09-11 16:30:00,355,377,372,1104,6624
2016-09-11 16:40:00,300,323,318,941,5646
2016-09-11 16:50:00,219,243,239,701,4206
2016-09-11 17:00:00,170,194,190,554,3324
2016-09-11 17:10:00,153,176,171,500,3000
2016-09-11 17:20:00,100,121,116,337,2022
2016-09-11 17:30:00,30,50,46,126,756
2016-09-11 17:40:00,8,33,21,62,372
2016-09-11 17:50:00,12,38,26,76,456
2016-09-11 18:00:00,41,53,58,152,912
2016-09-11 18:10:00,33,73,78,184,1104
2016-09-11 18:20:00,50,63,80,193,1158
2016-09-11 18:30:00,54,47,66,167,1002
2016-09-11 18:40:00,26,52,28,106,636
2016-09-11 18:50:00,15,13,23,51,306
2016-09-11 19:00:00,8,11,11,30,180
2016-09-11 19:10:00,3,5,2,10,60
2016-09-11 19:20:00,0,0,0,0,0
2016-09-11 19:30:00,0,0,0,0,0
2016-09-11 19:40:00,0,0,0,0,0
2016-09-11 19:50:00,0,0,0,0,0
2016-09-12 06:10:00,0,0,0,0,0
2016-09-12 06:20:00,0,0,0,0,0
2016-09-12 06:30:00,0,0,0,0,0
2016-09-12 06:40:00,0,0,0,0,0
2016-09-12 06:50:00,0,0,0,0,0
2016-09-12 07:00:00,0,0,0,0,0
2016-09-12 07:10:00,5,8,4,17,102
2016-09-12 07:20:00,8,20,11,39,234
2016-09-12 07:30:00,14,31,20,65,390
2016-09-12 07:40:00,26,38,32,96,576
2016-09-12 07:50:00,35,46,39,120,720
2016-09-12 08:00:00,48,56,77,181,1086
2016-09-12 08:10:00,19,83,79,181,1086
2016-09-12 08:20:00,34,76,74,184,1104
2016-09-12 08:30:00,77,66,102,245,1470
2016-09-12 08:40:00,94,107,120,321,1926
2016-09-12 08:50:00,52,168,239,459,2754
2016-09-12 09:00:00,138,168,89,395,2370
2016-09-12 09:10:00,96,113,92,301,1806
2016-09-12 09:20:00,100,139,168,407,2442
2016-09-12 09:30:00,232,103,181,516,3096
2016-09-12 09:40:00,192,214,212,618,3708
2016-09-12 09:50:00,524,549,544,1617,9702
2016-09-12 10:00:00,439,464,457,1360,8160
2016-09-12 10:10:00,354,378,371,1103,6618
2016-09-12 10:20:00,386,411,403,1200,7200
2016-09-12 10:30:00,477,502,495,1474,8844
2016-09-12 10:40:00,768,795,789,2352,14112
2016-09-12 10:50:00,747,775,769,2291,13746
2016-09-12 11:00:00,815,833,837,2485,14910
2016-09-12 11:10:00,834,853,862,2549,15294
2016-09-12 11:20:00,861,887,885,2633,15798
2016-09-12 11:30:00,868,901,890,2659,15954
2016-09-12 11:40:00,887,911,896,2694,16164
2016-09-12 11:50:00,910,938,928,2776,16656
2016-09-12 12:00:00,867,901,891,2659,15954
2016-09-12 12:10:00,667,690,687,2044,12264
2016-09-12 12:20:00,914,939,939,2792,16752
2016-09-12 12:30:00,903,932,930,2765,16590
2016-09-12 12:40:00,807,836,829,2472,14832
2016-09-12 12:50:00,851,882,873,2606,15636
2016-09-12 13:00:00,808,838,830,2476,14856
2016-09-12 13:10:00,893,922,916,2731,16386
2016-09-12 13:20:00,827,856,851,2534,15204
2016-09-12 13:30:00,836,860,860,2556,15336
2016-09-12 13:40:00,1006,1024,1025,3055,18330
2016-09-12 13:50:00,945,967,961,2873,17238
2016-09-12 14:00:00,885,905,897,2687,16122
2016-09-12 14:10:00,865,884,873,2622,15732
2016-09-12 14:20:00,840,863,856,2559,15354
2016-09-12 14:30:00,809,834,826,2469,14814
2016-09-12 14:40:00,782,808,800,2390,14340
2016-09-12 14:50:00,752,778,773,2303,13818
2016-09-12 15:00:00,710,738,729,2177,13062
2016-09-12 15:10:00,676,701,693,2070,12420
2016-09-12 15:20:00,633,657,645,1935,11610
2016-09-12 15:30:00,590,616,603,1809,10854
2016-09-12 15:40:00,548,581,569,1698,10188
2016-09-12 15:50:00,508,536,526,1570,9420
2016-09-12 16:00:00,467,495,486,1448,8688
2016-09-12 16:10:00,412,440,433,1285,7710
2016-09-12 16:20:00,368,395,384,1147,6882
2016-09-12 16:30:00,315,349,336,1000,6000
2016-09-12 16:40:00,266,297,286,849,5094
2016-09-12 16:50:00,218,246,238,702,4212
2016-09-12 17:00:00,163,190,184,537,3222
2016-09-12 17:10:00,74,176,137,387,2322
2016-09-12 17:20:00,53,98,101,252,1512
2016-09-12 17:30:00,26,65,58,149,894
2016-09-12 17:40:00,29,58,38,125,750
2016-09-12 17:50:00,7,109,8,124,744
2016-09-12 18:00:00,29,58,27,114,684
2016-09-12 18:10:00,25,42,33,100,600
2016-09-12 18:20:00,22,34,28,84,504
2016-09-12 18:30:00,18,33,20,71,426
2016-09-12 18:40:00,13,23,19,55,330
2016-09-12 18:50:00,11,17,11,39,234
2016-09-12 19:00:00,6,8,8,22,132
2016-09-12 19:10:00,2,3,2,7,42
2016-09-12 19:20:00,0,0,0,0,0
2016-09-12 19:30:00,0,0,0,0,0
2016-09-12 19:40:00,0,0,0,0,0
2016-09-13 06:10:00,0,0,0,0,0
2016-09-13 06:20:00,0,0,0,0,0
2016-09-13 06:30:00,0,0,0,0,0
2016-09-13 06:40:00,0,0,0,0,0
2016-09-13 06:50:00,3,6,5,14,84
2016-09-13 07:00:00,7,17,10,34,204
2016-09-13 07:10:00,13,32,15,60,360
2016-09-13 07:20:00,30,48,9,87,522
2016-09-13 07:30:00,30,64,15,109,654
2016-09-13 07:40:00,26,82,21,129,774
2016-09-13 07:50:00,31,66,58,155,930
2016-09-13 08:00:00,36,86,64,186,1116
2016-09-13 08:10:00,59,86,73,218,1308
2016-09-13 08:20:00,35,131,134,300,1800
2016-09-13 08:30:00,122,147,121,390,2340
2016-09-13 08:40:00,117,124,134,375,2250
2016-09-13 08:50:00,161,101,164,426,2556
2016-09-13 09:00:00,77,171,236,484,2904
2016-09-13 09:10:00,179,185,150,514,3084
2016-09-13 09:20:00,178,193,168,539,3234
2016-09-13 09:30:00,252,144,196,592,3552
2016-09-13 09:40:00,326,328,334,988,5928
2016-09-13 09:50:00,378,400,396,1174,7044
2016-09-13 10:00:00,497,521,513,1531,9186
2016-09-13 10:10:00,469,492,483,1444,8664
2016-09-13 10:20:00,321,341,334,996,5976
2016-09-13 10:30:00,516,534,525,1575,9450
2016-09-13 10:40:00,707,729,718,2154,12924
2016-09-13 10:50:00,724,746,733,2203,13218
2016-09-13 11:00:00,751,774,761,2286,13716
2016-09-13 11:10:00,772,799,788,2359,14154
2016-09-13 11:20:00,791,819,807,2417,14502
2016-09-13 11:30:00,802,833,821,2456,14736
2016-09-13 11:40:00,822,853,841,2516,15096
2016-09-13 11:50:00,831,867,856,2554,15324
2016-09-13 12:00:00,841,873,864,2578,15468
2016-09-13 12:10:00,848,871,867,2586,15516
2016-09-13 12:20:00,856,876,879,2611,15666
2016-09-13 12:30:00,863,891,882,2636,15816
2016-09-13 12:40:00,862,897,882,2641,15846
2016-09-13 12:50:00,864,900,886,2650,15900
2016-09-13 13:00:00,867,900,892,2659,15954
2016-09-13 13:10:00,861,905,889,2655,15930
2016-09-13 13:20:00,862,897,880,2639,15834
2016-09-13 13:30:00,863,888,877,2628,15768
2016-09-13 13:40:00,833,886,882,2601,15606
2016-09-13 13:50:00,819,877,873,2569,15414
2016-09-13 14:00:00,822,862,855,2539,15234
2016-09-13 14:10:00,819,844,836,2499,14994
2016-09-13 14:20:00,797,826,815,2438,14628
2016-09-13 14:30:00,763,799,784,2346,14076
2016-09-13 14:40:00,737,769,760,2266,13596
2016-09-13 14:50:00,711,733,729,2173,13038
2016-09-13 15:00:00,657,689,680,2026,12156
2016-09-13 15:10:00,627,657,647,1931,11586
2016-09-13 15:20:00,577,617,607,1801,10806
2016-09-13 15:30:00,542,576,561,1679,10074
2016-09-13 15:40:00,501,535,523,1559,9354
2016-09-13 15:50:00,457,495,484,1436,8616
2016-09-13 16:00:00,421,451,442,1314,7884
2016-09-13 16:10:00,372,398,392,1162,6972
2016-09-13 16:20:00,331,360,350,1041,6246
2016-09-13 16:30:00,286,310,304,900,5400
2016-09-13 16:40:00,241,265,257,763,4578
2016-09-13 16:50:00,193,217,211,621,3726
2016-09-13 17:00:00,142,165,158,465,2790
2016-09-13 17:10:00,101,124,119,344,2064
2016-09-13 17:20:00,68,92,81,241,1446
2016-09-13 17:30:00,58,83,42,183,1098
2016-09-13 17:40:00,41,79,48,168,1008
2016-09-13 17:50:00,41,66,43,150,900
2016-09-13 18:00:00,31,58,43,132,792
2016-09-13 18:10:00,20,77,18,115,690
2016-09-13 18:20:00,21,47,29,97,582
2016-09-13 18:30:00,18,36,23,77,462
2016-09-13 18:40:00,13,28,14,55,330
2016-09-13 18:50:00,8,17,11,36,216
2016-09-13 19:00:00,3,9,6,18,108
2016-09-13 19:10:00,0,1,1,2,12
2016-09-13 19:20:00,0,0,0,0,0
2016-09-13 19:30:00,0,0,0,0,0
2016-09-13 19:40:00,0,0,0,0,0
2016-09-14 06:10:00,0,0,0,0,0
2016-09-14 06:20:00,0,0,0,0,0
2016-09-14 06:30:00,0,0,0,0,0
2016-09-14 06:40:00,0,0,0,0,0
2016-09-14 06:50:00,2,5,2,9,54
2016-09-14 07:00:00,6,9,6,21,126
2016-09-14 07:10:00,8,17,7,32,192
2016-09-14 07:20:00,11,24,11,46,276
2016-09-14 07:30:00,16,23,17,56,336
2016-09-14 07:40:00,13,34,18,65,390
2016-09-14 07:50:00,9,50,17,76,456
2016-09-14 08:00:00,18,37,31,86,516
2016-09-14 08:10:00,22,40,32,94,564
2016-09-14 08:20:00,26,46,29,101,606
2016-09-14 08:30:00,30,49,28,107,642
2016-09-14 08:40:00,24,65,28,117,702
2016-09-14 08:50:00,21,84,23,128,768
2016-09-14 09:00:00,49,49,44,142,852
2016-09-14 09:10:00,50,53,43,146,876
2016-09-14 09:20:00,44,60,56,160,960
2016-09-14 09:30:00,185,228,202,615,3690
2016-09-14 09:40:00,395,420,410,1225,7350
2016-09-14 09:50:00,542,567,557,1666,9996
2016-09-14 10:00:00,643,669,656,1968,11808
2016-09-14 10:10:00,684,714,708,2106,12636
2016-09-14 10:20:00,731,752,748,2231,13386
2016-09-14 10:30:00,772,794,787,2353,14118
2016-09-14 10:40:00,790,817,810,2417,14502
2016-09-14 10:50:00,807,836,830,2473,14838
2016-09-14 11:00:00,822,854,845,2521,15126
2016-09-14 11:10:00,833,868,859,2560,15360
2016-09-14 11:20:00,852,879,874,2605,15630
2016-09-14 11:30:00,869,897,890,2656,15936
2016-09-14 11:40:00,888,916,903,2707,16242
2016-09-14 11:50:00,896,924,911,2731,16386
2016-09-14 12:00:00,908,929,915,2752,16512
2016-09-14 12:10:00,913,931,926,2770,16620
2016-09-14 12:20:00,914,936,928,2778,16668
2016-09-14 12:30:00,913,935,925,2773,16638
2016-09-14 12:40:00,915,945,930,2790,16740
2016-09-14 12:50:00,915,938,927,2780,16680
2016-09-14 13:00:00,910,931,923,2764,16584
2016-09-14 13:10:00,905,929,919,2753,16518
2016-09-14 13:20:00,899,924,915,2738,16428
2016-09-14 13:30:00,891,916,908,2715,16290
2016-09-14 13:40:00,882,914,903,2699,16194
2016-09-14 13:50:00,875,901,890,2666,15996
2016-09-14 14:00:00,867,888,881,2636,15816
2016-09-14 14:10:00,851,872,863,2586,15516
2016-09-14 14:20:00,831,851,840,2522,15132
2016-09-14 14:30:00,794,816,804,2414,14484
2016-09-14 14:40:00,761,783,772,2316,13896
2016-09-14 14:50:00,727,749,745,2221,13326
2016-09-14 15:00:00,678,700,691,2069,12414
2016-09-14 15:10:00,639,668,659,1966,11796
2016-09-14 15:20:00,605,639,628,1872,11232
2016-09-14 15:30:00,562,593,581,1736,10416
2016-09-14 15:40:00,520,550,540,1610,9660
2016-09-14 15:50:00,473,503,495,1471,8826
2016-09-14 16:00:00,430,456,446,1332,7992
2016-09-14 16:10:00,383,414,405,1202,7212
2016-09-14 16:20:00,335,364,355,1054,6324
2016-09-14 16:30:00,288,312,308,908,5448
2016-09-14 16:40:00,243,268,265,776,4656
2016-09-14 16:50:00,191,217,212,620,3720
2016-09-14 17:00:00,131,156,150,437,2622
2016-09-14 17:10:00,75,122,125,322,1932
2016-09-14 17:20:00,73,53,86,212,1272
2016-09-14 17:30:00,38,59,45,142,852
2016-09-14 17:40:00,30,65,33,128,768
2016-09-14 17:50:00,30,74,15,119,714
2016-09-14 18:00:00,24,50,34,108,648
2016-09-14 18:10:00,14,50,29,93,558
2016-09-14 18:20:00,10,47,21,78,468
2016-09-14 18:30:00,9,36,18,63,378
2016-09-14 18:40:00,10,22,15,47,282
2016-09-14 18:50:00,9,16,6,31,186
2016-09-14 19:00:00,5,5,5,15,90
2016-09-14 19:10:00,0,1,0,1,6
2016-09-14 19:20:00,0,0,0,0,0
2016-09-14 19:30:00,0,0,0,0,0
2016-09-14 19:40:00,0,0,0,0,0
2016-09-15 06:10:00,0,0,0,0,0
2016-09-15 06:20:00,0,0,0,0,0
2016-09-15 06:30:00,0,0,0,0,0
2016-09-15 06:40:00,0,0,0,0,0
2016-09-15 06:50:00,3,2,2,7,42
2016-09-15 07:00:00,5,11,7,23,138
2016-09-15 07:10:00,8,18,15,41,246
2016-09-15 07:20:00,12,29,22,63,378
2016-09-15 07:30:00,12,49,25,86,516
2016-09-15 07:40:00,17,64,30,111,666
2016-09-15 07:50:00,32,60,48,140,840
2016-09-15 08:00:00,43,62,71,176,1056
2016-09-15 08:10:00,69,77,90,236,1416
2016-09-15 08:20:00,77,141,141,359,2154
2016-09-15 08:30:00,83,123,115,321,1926
2016-09-15 08:40:00,92,121,111,324,1944
2016-09-15 08:50:00,94,117,113,324,1944
2016-09-15 09:00:00,107,118,129,354,2124
2016-09-15 09:10:00,109,142,156,407,2442
2016-09-15 09:20:00,90,187,154,431,2586
2016-09-15 09:30:00,134,250,144,528,3168
2016-09-15 09:40:00,224,303,206,733,4398
2016-09-15 09:50:00,419,444,434,1297,7782
2016-09-15 10:00:00,492,518,506,1516,9096
2016-09-15 10:10:00,443,467,458,1368,8208
2016-09-15 10:20:00,433,454,452,1339,8034
2016-09-15 10:30:00,607,630,623,1860,11160
2016-09-15 10:40:00,665,688,685,2038,12228
2016-09-15 10:50:00,745,763,761,2269,13614
2016-09-15 11:00:00,746,764,763,2273,13638
2016-09-15 11:10:00,764,782,781,2327,13962
2016-09-15 11:20:00,779,800,796,2375,14250
2016-09-15 11:30:00,792,811,801,2404,14424
2016-09-15 11:40:00,794,816,803,2413,14478
2016-09-15 11:50:00,426,446,441,1313,7878
2016-09-15 12:00:00,361,385,379,1125,6750
2016-09-15 12:10:00,397,419,414,1230,7380
2016-09-15 12:20:00,644,671,663,1978,11868
2016-09-15 12:30:00,749,774,767,2290,13740
2016-09-15 12:40:00,850,873,865,2588,15528
2016-09-15 12:50:00,755,777,765,2297,13782
2016-09-15 13:00:00,847,869,854,2570,15420
2016-09-15 13:10:00,837,860,844,2541,15246
2016-09-15 13:20:00,832,858,843,2533,15198
2016-09-15 13:30:00,836,864,844,2544,15264
2016-09-15 13:40:00,814,846,835,2495,14970
2016-09-15 13:50:00,804,835,825,2464,14784
2016-09-15 14:00:00,799,826,812,2437,14622
2016-09-15 14:10:00,786,812,800,2398,14388
2016-09-15 14:20:00,768,793,786,2347,14082
2016-09-15 14:30:00,744,770,761,2275,13650
2016-09-15 14:40:00,708,735,726,2169,13014
2016-09-15 14:50:00,682,706,697,2085,12510
2016-09-15 15:00:00,639,662,656,1957,11742
2016-09-15 15:10:00,608,635,626,1869,11214
2016-09-15 15:20:00,561,589,582,1732,10392
2016-09-15 15:30:00,520,552,543,1615,9690
2016-09-15 15:40:00,481,511,501,1493,8958
2016-09-15 15:50:00,446,469,457,1372,8232
2016-09-15 16:00:00,405,427,422,1254,7524
2016-09-15 16:10:00,356,375,373,1104,6624
2016-09-15 16:20:00,308,332,326,966,5796
2016-09-15 16:30:00,264,287,283,834,5004
2016-09-15 16:40:00,221,242,237,700,4200
2016-09-15 16:50:00,170,194,189,553,3318
2016-09-15 17:00:00,122,145,140,407,2442
2016-09-15 17:10:00,90,113,109,312,1872
2016-09-15 17:20:00,64,84,82,230,1380
2016-09-15 17:30:00,37,85,83,205,1230
2016-09-15 17:40:00,8,90,81,179,1074
2016-09-15 17:50:00,23,68,64,155,930
2016-09-15 18:00:00,33,61,39,133,798
2016-09-15 18:10:00,23,74,18,115,690
2016-09-15 18:20:00,26,37,28,91,546
2016-09-15 18:30:00,21,35,11,67,402
2016-09-15 18:40:00,16,22,9,47,282
2016-09-15 18:50:00,8,9,11,28,168
2016-09-15 19:00:00,3,4,4,11,66
2016-09-15 19:10:00,0,0,0,0,0
2016-09-15 19:20:00,0,0,0,0,0
2016-09-15 19:30:00,0,0,0,0,0
2016-09-16 06:10:00,0,0,0,0,0
2016-09-16 06:20:00,0,0,0,0,0
2016-09-16 06:30:00,0,0,0,0,0
2016-09-16 06:40:00,0,0,0,0,0
2016-09-16 06:50:00,1,1,1,3,18
2016-09-16 07:00:00,5,6,5,16,96
2016-09-16 07:10:00,9,14,9,32,192
2016-09-16 07:20:00,14,18,15,47,282
2016-09-16 07:30:00,17,29,14,60,360
2016-09-16 07:40:00,16,38,21,75,450
2016-09-16 07:50:00,20,41,31,92,552
2016-09-16 08:00:00,33,44,31,108,648
2016-09-16 08:10:00,14,91,14,119,714
2016-09-16 08:20:00,40,57,38,135,810
2016-09-16 08:30:00,46,55,44,145,870
2016-09-16 08:40:00,40,55,46,141,846
2016-09-16 08:50:00,45,55,52,152,912
2016-09-16 09:00:00,54,50,69,173,1038
2016-09-16 09:10:00,54,78,55,187,1122
2016-09-16 09:20:00,53,78,69,200,1200
2016-09-16 09:30:00,90,101,96,287,1722
2016-09-16 09:40:00,378,402,398,1178,7068
2016-09-16 09:50:00,526,551,544,1621,9726
2016-09-16 10:00:00,635,656,649,1940,11640
2016-09-16 10:10:00,691,714,708,2113,12678
2016-09-16 10:20:00,732,764,749,2245,13470
2016-09-16 10:30:00,752,778,765,2295,13770
2016-09-16 10:40:00,676,705,694,2075,12450
2016-09-16 10:50:00,790,815,809,2414,14484
2016-09-16 11:00:00,802,831,823,2456,14736
2016-09-16 11:10:00,784,808,799,2391,14346
2016-09-16 11:20:00,796,814,807,2417,14502
2016-09-16 11:30:00,730,749,743,2222,13332
2016-09-16 11:40:00,816,839,831,2486,14916
2016-09-16 11:50:00,799,823,815,2437,14622
2016-09-16 12:00:00,778,800,797,2375,14250
2016-09-16 12:10:00,772,800,790,2362,14172
2016-09-16 12:20:00,845,864,857,2566,15396
2016-09-16 12:30:00,893,938,930,2761,16566
2016-09-16 12:40:00,847,872,858,2577,15462
2016-09-16 12:50:00,768,794,787,2349,14094
2016-09-16 13:00:00,864,895,893,2652,15912
2016-09-16 13:10:00,909,944,933,2786,16716
2016-09-16 13:20:00,814,844,838,2496,14976
2016-09-16 13:30:00,772,804,797,2373,14238
2016-09-16 13:40:00,788,821,814,2423,14538
2016-09-16 13:50:00,869,901,892,2662,15972
2016-09-16 14:00:00,785,816,808,2409,14454
2016-09-16 14:10:00,764,791,786,2341,14046
2016-09-16 14:20:00,712,742,732,2186,13116
2016-09-16 14:30:00,841,895,875,2611,15666
2016-09-16 14:40:00,754,802,787,2343,14058
2016-09-16 14:50:00,671,718,703,2092,12552
2016-09-16 15:00:00,619,662,646,1927,11562
2016-09-16 15:10:00,584,624,611,1819,10914
2016-09-16 15:20:00,373,408,397,1178,7068
2016-09-16 15:30:00,353,388,377,1118,6708
2016-09-16 15:40:00,369,401,391,1161,6966
2016-09-16 15:50:00,370,400,388,1158,6948
2016-09-16 16:00:00,225,250,242,717,4302
2016-09-16 16:10:00,197,193,209,599,3594
2016-09-16 16:20:00,103,189,223,515,3090
2016-09-16 16:30:00,243,272,256,771,4626
2016-09-16 16:40:00,191,219,213,623,3738
2016-09-16 16:50:00,173,200,194,567,3402
2016-09-16 17:00:00,155,183,176,514,3084
2016-09-16 17:10:00,60,130,127,317,1902
2016-09-16 17:20:00,106,45,115,266,1596
2016-09-16 17:30:00,66,105,95,266,1596
2016-09-16 17:40:00,93,118,77,288,1728
2016-09-16 17:50:00,98,45,108,251,1506
2016-09-16 18:00:00,53,67,70,190,1140
2016-09-16 18:10:00,32,63,45,140,840
2016-09-16 18:20:00,29,48,31,108,648
2016-09-16 18:30:00,22,40,28,90,540
2016-09-16 18:40:00,11,31,16,58,348
2016-09-16 18:50:00,4,9,5,18,108
2016-09-16 19:00:00,0,0,0,0,0
2016-09-16 19:10:00,0,0,0,0,0
2016-09-16 19:20:00,0,0,0,0,0
2016-09-16 19:30:00,0,0,0,0,0
2016-09-17 06:20:00,0,0,0,0,0
2016-09-17 06:30:00,0,0,0,0,0
2016-09-17 06:40:00,0,0,0,0,0
2016-09-17 06:50:00,0,0,0,0,0
2016-09-17 07:00:00,1,1,0,2,12
2016-09-17 07:10:00,2,4,2,8,48
2016-09-17 07:20:00,6,8,6,20,120
2016-09-17 07:30:00,9,15,11,35,210
2016-09-17 07:40:00,13,20,20,53,318
2016-09-17 07:50:00,20,29,27,76,456
2016-09-17 08:00:00,23,61,27,111,666
2016-09-17 08:10:00,30,60,50,140,840
2016-09-17 08:20:00,51,62,75,188,1128
2016-09-17 08:30:00,94,43,106,243,1458
2016-09-17 08:40:00,84,81,122,287,1722
2016-09-17 08:50:00,68,119,111,298,1788
2016-09-17 09:00:00,91,124,124,339,2034
2016-09-17 09:10:00,200,156,187,543,3258
2016-09-17 09:20:00,205,227,222,654,3924
2016-09-17 09:30:00,168,190,185,543,3258
2016-09-17 09:40:00,182,128,204,514,3084
2016-09-17 09:50:00,150,135,207,492,2952
2016-09-17 10:00:00,225,186,178,589,3534
2016-09-17 10:10:00,289,310,306,905,5430
2016-09-17 10:20:00,379,401,396,1176,7056
2016-09-17 10:30:00,368,388,381,1137,6822
2016-09-17 10:40:00,323,337,331,991,5946
2016-09-17 10:50:00,270,292,286,848,5088
2016-09-17 11:00:00,317,340,342,999,5994
2016-09-17 11:10:00,356,388,384,1128,6768
2016-09-17 11:20:00,253,279,276,808,4848
2016-09-17 11:30:00,222,245,238,705,4230
2016-09-17 11:40:00,254,276,268,798,4788
2016-09-17 11:50:00,375,395,389,1159,6954
2016-09-17 12:00:00,365,382,377,1124,6744
2016-09-17 12:10:00,331,349,342,1022,6132
2016-09-17 12:20:00,396,415,407,1218,7308
2016-09-17 12:30:00,897,916,903,2716,16296
2016-09-17 12:40:00,707,734,724,2165,12990
2016-09-17 12:50:00,597,627,614,1838,11028
2016-09-17 13:00:00,578,605,599,1782,10692
2016-09-17 13:10:00,444,470,466,1380,8280
2016-09-17 13:20:00,445,477,467,1389,8334
2016-09-17 13:30:00,416,453,443,1312,7872
2016-09-17 13:40:00,502,536,528,1566,9396
2016-09-17 13:50:00,462,487,481,1430,8580
2016-09-17 14:00:00,463,489,478,1430,8580
2016-09-17 14:10:00,397,427,416,1240,7440
2016-09-17 14:20:00,325,356,345,1026,6156
2016-09-17 14:30:00,398,430,418,1246,7476
2016-09-17 14:40:00,850,883,867,2600,15600
2016-09-17 14:50:00,537,559,547,1643,9858
2016-09-17 15:00:00,452,474,464,1390,8340
2016-09-17 15:10:00,428,452,439,1319,7914
2016-09-17 15:20:00,546,573,562,1681,10086
2016-09-17 15:30:00,327,351,344,1022,6132
2016-09-17 15:40:00,477,500,491,1468,8808
2016-09-17 15:50:00,605,633,623,1861,11166
2016-09-17 16:00:00,477,506,497,1480,8880
2016-09-17 16:10:00,317,339,332,988,5928
2016-09-17 16:20:00,319,341,337,997,5982
2016-09-17 16:30:00,274,296,291,861,5166
2016-09-17 16:40:00,255,276,271,802,4812
2016-09-17 16:50:00,165,185,180,530,3180
2016-09-17 17:00:00,119,140,136,395,2370
2016-09-17 17:10:00,85,92,104,281,1686
2016-09-17 17:20:00,60,49,82,191,1146
2016-09-17 17:30:00,44,46,55,145,870
2016-09-17 17:40:00,25,67,26,118,708
2016-09-17 17:50:00,28,44,33,105,630
2016-09-17 18:00:00,35,42,33,110,660
2016-09-17 18:10:00,17,74,29,120,720
2016-09-17 18:20:00,23,47,27,97,582
2016-09-17 18:30:00,17,26,16,59,354
2016-09-17 18:40:00,10,19,8,37,222
2016-09-17 18:50:00,6,8,2,16,96
2016-09-17 19:00:00,1,2,1,4,24
2016-09-17 19:10:00,0,0,0,0,0
2016-09-17 19:20:00,0,0,0,0,0
2016-09-17 19:30:00,0,0,0,0,0
2016-09-18 06:20:00,0,0,0,0,0
2016-09-18 06:30:00,0,0,0,0,0
2016-09-18 06:40:00,0,0,0,0,0
2016-09-18 06:50:00,0,0,0,0,0
2016-09-18 07:00:00,2,6,4,12,72
2016-09-18 07:10:00,5,10,8,23,138
2016-09-18 07:20:00,9,17,9,35,210
2016-09-18 07:30:00,10,27,11,48,288
2016-09-18 07:40:00,11,27,21,59,354
2016-09-18 07:50:00,20,19,30,69,414
2016-09-18 08:00:00,19,30,28,77,462
2016-09-18 08:10:00,27,23,36,86,516
2016-09-18 08:20:00,29,36,28,93,558
2016-09-18 08:30:00,31,50,21,102,612
2016-09-18 08:40:00,35,46,31,112,672
2016-09-18 08:50:00,27,70,30,127,762
2016-09-18 09:00:00,44,60,37,141,846
2016-09-18 09:10:00,51,55,53,159,954
2016-09-18 09:20:00,46,64,70,180,1080
2016-09-18 09:30:00,64,61,79,204,1224
2016-09-18 09:40:00,246,288,266,800,4800
2016-09-18 09:50:00,457,493,485,1435,8610
2016-09-18 10:00:00,294,325,317,936,5616
2016-09-18 10:10:00,247,272,267,786,4716
2016-09-18 10:20:00,292,317,312,921,5526
2016-09-18 10:30:00,286,301,296,883,5298
2016-09-18 10:40:00,277,293,289,859,5154
2016-09-18 10:50:00,336,344,352,1032,6192
2016-09-18 11:00:00,337,356,354,1047,6282
2016-09-18 11:10:00,387,401,406,1194,7164
2016-09-18 11:20:00,365,388,384,1137,6822
2016-09-18 11:30:00,347,365,369,1081,6486
2016-09-18 11:40:00,307,326,327,960,5760
2016-09-18 11:50:00,231,250,242,723,4338
2016-09-18 12:00:00,249,271,266,786,4716
2016-09-18 12:10:00,273,295,288,856,5136
2016-09-18 12:20:00,356,377,368,1101,6606
2016-09-18 12:30:00,600,623,612,1835,11010
2016-09-18 12:40:00,883,902,887,2672,16032
2016-09-18 12:50:00,979,995,994,2968,17808
2016-09-18 13:00:00,986,1002,1011,2999,17994
2016-09-18 13:10:00,953,981,987,2921,17526
2016-09-18 13:20:00,846,870,869,2585,15510
2016-09-18 13:30:00,985,1009,1003,2997,17982
2016-09-18 13:40:00,937,960,957,2854,17124
2016-09-18 13:50:00,921,953,944,2818,16908
2016-09-18 14:00:00,912,942,933,2787,16722
2016-09-18 14:10:00,708,740,730,2178,13068
2016-09-18 14:20:00,883,918,907,2708,16248
2016-09-18 14:30:00,840,875,861,2576,15456
2016-09-18 14:40:00,810,838,833,2481,14886
2016-09-18 14:50:00,771,798,791,2360,14160
2016-09-18 15:00:00,737,764,758,2259,13554
2016-09-18 15:10:00,700,728,723,2151,12906
2016-09-18 15:20:00,655,682,675,2012,12072
2016-09-18 15:30:00,539,569,562,1670,10020
2016-09-18 15:40:00,537,565,555,1657,9942
2016-09-18 15:50:00,516,543,531,1590,9540
2016-09-18 16:00:00,461,488,478,1427,8562
2016-09-18 16:10:00,414,439,430,1283,7698
2016-09-18 16:20:00,355,381,376,1112,6672
2016-09-18 16:30:00,303,330,325,958,5748
2016-09-18 16:40:00,255,282,276,813,4878
2016-09-18 16:50:00,224,248,243,715,4290
2016-09-18 17:00:00,160,183,178,521,3126
2016-09-18 17:10:00,108,135,129,372,2232
2016-09-18 17:20:00,44,56,55,155,930
2016-09-18 17:30:00,8,10,21,39,234
2016-09-18 17:40:00,1,2,0,3,18
2016-09-18 17:50:00,0,0,0,0,0
2016-09-18 18:00:00,0,0,0,0,0
2016-09-18 18:10:00,0,0,0,0,0
2016-09-18 18:20:00,0,0,0,0,0
2016-09-18 18:30:00,0,0,0,0,0
2016-09-18 18:40:00,0,0,0,0,0
2016-09-18 18:50:00,0,0,0,0,0
2016-09-18 19:00:00,0,0,0,0,0
2016-09-18 19:10:00,0,0,0,0,0
2016-09-18 19:20:00,0,0,0,0,0
2016-09-19 06:30:00,0,0,0,0,0
2016-09-19 06:40:00,0,0,0,0,0
2016-09-19 06:50:00,0,0,0,0,0
2016-09-19 07:00:00,0,0,0,0,0
2016-09-19 07:10:00,0,1,0,1,6
2016-09-19 07:20:00,2,4,1,7,42
2016-09-19 07:30:00,3,6,4,13,78
2016-09-19 07:40:00,4,11,7,22,132
2016-09-19 07:50:00,7,13,10,30,180
2016-09-19 08:00:00,10,20,17,47,282
2016-09-19 08:10:00,13,21,20,54,324
2016-09-19 08:20:00,13,17,19,49,294
2016-09-19 08:30:00,9,23,18,50,300
2016-09-19 08:40:00,12,36,22,70,420
2016-09-19 08:50:00,21,64,37,122,732
2016-09-19 09:00:00,18,71,46,135,810
2016-09-19 09:10:00,25,73,30,128,768
2016-09-19 09:20:00,23,51,58,132,792
2016-09-19 09:30:00,39,57,64,160,960
2016-09-19 09:40:00,47,141,137,325,1950
2016-09-19 09:50:00,195,226,222,643,3858
2016-09-19 10:00:00,140,169,162,471,2826
2016-09-19 10:10:00,282,316,302,900,5400
2016-09-19 10:20:00,790,816,799,2405,14430
2016-09-19 10:30:00,824,844,837,2505,15030
2016-09-19 10:40:00,531,554,548,1633,9798
2016-09-19 10:50:00,884,909,898,2691,16146
2016-09-19 11:00:00,863,884,874,2621,15726
2016-09-19 11:10:00,819,854,850,2523,15138
2016-09-19 11:20:00,896,936,933,2765,16590
2016-09-19 11:30:00,689,708,705,2102,12612
2016-09-19 11:40:00,755,783,778,2316,13896
2016-09-19 11:50:00,718,754,754,2226,13356
2016-09-19 12:00:00,610,637,635,1882,11292
2016-09-19 12:10:00,513,536,534,1583,9498
2016-09-19 12:20:00,475,499,495,1469,8814
2016-09-19 12:30:00,477,501,496,1474,8844
2016-09-19 12:40:00,535,557,555,1647,9882
2016-09-19 12:50:00,558,579,578,1715,10290
2016-09-19 13:00:00,875,892,886,2653,15918
2016-09-19 13:10:00,728,748,741,2217,13302
2016-09-19 13:20:00,833,854,851,2538,15228
2016-09-19 13:30:00,714,734,729,2177,13062
2016-09-19 13:40:00,684,705,700,2089,12534
2016-09-19 13:50:00,756,778,769,2303,13818
2016-09-19 14:00:00,823,847,837,2507,15042
2016-09-19 14:10:00,912,939,925,2776,16656
2016-09-19 14:20:00,857,885,874,2616,15696
2016-09-19 14:30:00,820,858,848,2526,15156
2016-09-19 14:40:00,798,824,813,2435,14610
2016-09-19 14:50:00,768,792,776,2336,14016
2016-09-19 15:00:00,720,749,735,2204,13224
2016-09-19 15:10:00,689,716,705,2110,12660
2016-09-19 15:20:00,637,663,654,1954,11724
2016-09-19 15:30:00,604,636,626,1866,11196
2016-09-19 15:40:00,567,596,587,1750,10500
2016-09-19 15:50:00,513,541,532,1586,9516
2016-09-19 16:00:00,440,470,461,1371,8226
2016-09-19 16:10:00,330,362,352,1044,6264
2016-09-19 16:20:00,306,334,327,967,5802
2016-09-19 16:30:00,260,285,277,822,4932
2016-09-19 16:40:00,160,183,178,521,3126
2016-09-19 16:50:00,144,167,162,473,2838
2016-09-19 17:00:00,114,134,130,378,2268
2016-09-19 17:10:00,84,91,100,275,1650
2016-09-19 17:20:00,33,78,77,188,1128
2016-09-19 17:30:00,43,76,71,190,1140
2016-09-19 17:40:00,45,85,73,203,1218
2016-09-19 17:50:00,22,79,76,177,1062
2016-09-19 18:00:00,24,78,30,132,792
2016-09-19 18:10:00,19,48,32,99,594
2016-09-19 18:20:00,11,41,25,77,462
2016-09-19 18:30:00,7,27,15,49,294
2016-09-19 18:40:00,6,13,12,31,186
2016-09-19 18:50:00,3,4,3,10,60
2016-09-19 19:00:00,0,0,0,0,0
2016-09-19 19:10:00,0,0,0,0,0
2016-09-19 19:20:00,0,0,0,0,0
2016-09-20 06:30:00,0,0,0,0,0
2016-09-20 06:40:00,0,0,0,0,0
2016-09-20 06:50:00,0,0,0,0,0
2016-09-20 07:00:00,0,0,0,0,0
2016-09-20 07:10:00,0,1,0,1,6
2016-09-20 07:20:00,3,9,6,18,108
2016-09-20 07:30:00,5,23,14,42,252
2016-09-20 07:40:00,8,37,17,62,372
2016-09-20 07:50:00,10,51,25,86,516
2016-09-20 08:00:00,12,85,28,125,750
2016-09-20 08:10:00,36,50,47,133,798
2016-09-20 08:20:00,55,38,23,116,696
2016-09-20 08:30:00,29,52,31,112,672
2016-09-20 08:40:00,23,73,43,139,834
2016-09-20 08:50:00,4,86,80,170,1020
2016-09-20 09:00:00,3,89,83,175,1050
2016-09-20 09:10:00,22,80,81,183,1098
2016-09-20 09:20:00,55,88,77,220,1320
2016-09-20 09:30:00,45,73,77,195,1170
2016-09-20 09:40:00,18,71,82,171,1026
2016-09-20 09:50:00,37,76,79,192,1152
2016-09-20 10:00:00,63,86,78,227,1362
2016-09-20 10:10:00,0,140,142,282,1692
2016-09-20 10:20:00,69,139,123,331,1986
2016-09-20 10:30:00,47,162,150,359,2154
2016-09-20 10:40:00,73,143,139,355,2130
2016-09-20 10:50:00,42,152,148,342,2052
2016-09-20 11:00:00,63,162,174,399,2394
2016-09-20 11:10:00,37,214,247,498,2988
2016-09-20 11:20:00,111,168,142,421,2526
2016-09-20 11:30:00,46,152,162,360,2160
2016-09-20 11:40:00,23,177,175,375,2250
2016-09-20 11:50:00,80,240,94,414,2484
2016-09-20 12:00:00,232,242,130,604,3624
2016-09-20 12:10:00,273,297,292,862,5172
2016-09-20 12:20:00,371,397,389,1157,6942
2016-09-20 12:30:00,778,802,793,2373,14238
2016-09-20 12:40:00,1022,1050,1033,3105,18630
2016-09-20 12:50:00,487,513,503,1503,9018
2016-09-20 13:00:00,377,405,398,1180,7080
2016-09-20 13:10:00,299,328,320,947,5682
2016-09-20 13:20:00,493,535,523,1551,9306
2016-09-20 13:30:00,459,485,475,1419,8514
2016-09-20 13:40:00,475,501,494,1470,8820
2016-09-20 13:50:00,539,566,554,1659,9954
2016-09-20 14:00:00,591,620,607,1818,10908
2016-09-20 14:10:00,718,750,737,2205,13230
2016-09-20 14:20:00,726,755,748,2229,13374
2016-09-20 14:30:00,601,625,622,1848,11088
2016-09-20 14:40:00,577,608,595,1780,10680
2016-09-20 14:50:00,556,588,575,1719,10314
2016-09-20 15:00:00,543,579,567,1689,10134
2016-09-20 15:10:00,515,544,538,1597,9582
2016-09-20 15:20:00,450,476,467,1393,8358
2016-09-20 15:30:00,425,456,441,1322,7932
2016-09-20 15:40:00,269,298,289,856,5136
2016-09-20 15:50:00,381,408,398,1187,7122
2016-09-20 16:00:00,310,335,326,971,5826
2016-09-20 16:10:00,188,210,204,602,3612
2016-09-20 16:20:00,170,248,109,527,3162
2016-09-20 16:30:00,163,313,0,476,2856
2016-09-20 16:40:00,115,269,48,432,2592
2016-09-20 16:50:00,82,139,144,365,2190
2016-09-20 17:00:00,76,137,136,349,2094
2016-09-20 17:10:00,90,118,123,331,1986
2016-09-20 17:20:00,79,128,109,316,1896
2016-09-20 17:30:00,91,104,102,297,1782
2016-09-20 17:40:00,77,79,89,245,1470
2016-09-20 17:50:00,62,70,77,209,1254
2016-09-20 18:00:00,42,57,66,165,990
2016-09-20 18:10:00,34,61,30,125,750
2016-09-20 18:20:00,12,49,27,88,528
2016-09-20 18:30:00,13,30,17,60,360
2016-09-20 18:40:00,5,17,11,33,198
2016-09-20 18:50:00,0,6,1,7,42
2016-09-20 19:00:00,0,0,0,0,0
2016-09-20 19:10:00,0,0,0,0,0
2016-09-20 19:20:00,0,0,0,0,0
2016-09-21 06:20:00,0,0,0,0,0
2016-09-21 06:30:00,0,0,0,0,0
2016-09-21 06:40:00,0,0,0,0,0
2016-09-21 06:50:00,0,0,0,0,0
2016-09-21 07:00:00,0,0,0,0,0
2016-09-21 07:10:00,0,2,0,2,12
2016-09-21 07:20:00,4,10,6,20,120
2016-09-21 07:30:00,6,27,14,47,282
2016-09-21 07:40:00,7,43,19,69,414
2016-09-21 07:50:00,9,49,31,89,534
2016-09-21 08:00:00,19,47,35,101,606
2016-09-21 08:10:00,33,62,65,160,960
2016-09-21 08:20:00,105,81,117,303,1818
2016-09-21 08:30:00,33,190,159,382,2292
2016-09-21 08:40:00,74,117,132,323,1938
2016-09-21 08:50:00,32,143,130,305,1830
2016-09-21 09:00:00,169,220,168,557,3342
2016-09-21 09:10:00,132,181,203,516,3096
2016-09-21 09:20:00,74,117,112,303,1818
2016-09-21 09:30:00,101,139,131,371,2226
2016-09-21 09:40:00,115,182,113,410,2460
2016-09-21 09:50:00,328,339,327,994,5964
2016-09-21 10:00:00,540,562,556,1658,9948
2016-09-21 10:10:00,660,682,674,2016,12096
2016-09-21 10:20:00,679,701,692,2072,12432
2016-09-21 10:30:00,752,775,766,2293,13758
2016-09-21 10:40:00,752,772,762,2286,13716
2016-09-21 10:50:00,783,801,793,2377,14262
2016-09-21 11:00:00,802,815,814,2431,14586
2016-09-21 11:10:00,841,857,852,2550,15300
2016-09-21 11:20:00,866,880,874,2620,15720
2016-09-21 11:30:00,836,853,842,2531,15186
2016-09-21 11:40:00,751,767,770,2288,13728
2016-09-21 11:50:00,901,917,908,2726,16356
2016-09-21 12:00:00,609,630,623,1862,11172
2016-09-21 12:10:00,953,974,960,2887,17322
2016-09-21 12:20:00,692,719,707,2118,12708
2016-09-21 12:30:00,604,634,624,1862,11172
2016-09-21 12:40:00,532,560,554,1646,9876
2016-09-21 12:50:00,527,563,539,1629,9774
2016-09-21 13:00:00,679,702,690,2071,12426
2016-09-21 13:10:00,367,397,386,1150,6900
2016-09-21 13:20:00,523,556,532,1611,9666
2016-09-21 13:30:00,217,240,234,691,4146
2016-09-21 13:40:00,794,819,808,2421,14526
2016-09-21 13:50:00,618,646,635,1899,11394
2016-09-21 14:00:00,768,798,787,2353,14118
2016-09-21 14:10:00,361,389,379,1129,6774
2016-09-21 14:20:00,508,534,525,1567,9402
2016-09-21 14:30:00,388,413,405,1206,7236
2016-09-21 14:40:00,623,652,640,1915,11490
2016-09-21 14:50:00,314,326,298,938,5628
2016-09-21 15:00:00,711,743,731,2185,13110
2016-09-21 15:10:00,473,505,494,1472,8832
2016-09-21 15:20:00,377,403,394,1174,7044
2016-09-21 15:30:00,539,568,557,1664,9984
2016-09-21 15:40:00,485,513,502,1500,9000
2016-09-21 15:50:00,441,475,464,1380,8280
2016-09-21 16:00:00,411,439,427,1277,7662
2016-09-21 16:10:00,369,388,379,1136,6816
2016-09-21 16:20:00,323,349,339,1011,6066
2016-09-21 16:30:00,263,288,277,828,4968
2016-09-21 16:40:00,211,240,230,681,4086
2016-09-21 16:50:00,112,165,171,448,2688
2016-09-21 17:00:00,43,124,123,290,1740
2016-09-21 17:10:00,33,70,67,170,1020
2016-09-21 17:20:00,21,56,34,111,666
2016-09-21 17:30:00,28,38,34,100,600
2016-09-21 17:40:00,19,45,33,97,582
2016-09-21 17:50:00,16,42,23,81,486
2016-09-21 18:00:00,15,34,16,65,390
2016-09-21 18:10:00,9,26,13,48,288
2016-09-21 18:20:00,7,15,9,31,186
2016-09-21 18:30:00,4,10,4,18,108
2016-09-21 18:40:00,1,3,2,6,36
2016-09-21 18:50:00,0,0,0,0,0
2016-09-21 19:00:00,0,0,0,0,0
2016-09-21 19:10:00,0,0,0,0,0
2016-09-21 19:20:00,0,0,0,0,0
2016-09-22 06:30:00,0,0,0,0,0
2016-09-22 06:40:00,0,0,0,0,0
2016-09-22 06:50:00,0,0,0,0,0
2016-09-22 07:00:00,1,3,2,6,36
2016-09-22 07:10:00,4,13,9,26,156
2016-09-22 07:20:00,7,23,17,47,282
2016-09-22 07:30:00,12,36,25,73,438
2016-09-22 07:40:00,19,49,31,99,594
2016-09-22 07:50:00,21,81,38,140,840
2016-09-22 08:00:00,22,80,71,173,1038
2016-09-22 08:10:00,47,87,78,212,1272
2016-09-22 08:20:00,80,76,88,244,1464
2016-09-22 08:30:00,89,78,107,274,1644
2016-09-22 08:40:00,76,130,109,315,1890
2016-09-22 08:50:00,47,147,165,359,2154
2016-09-22 09:00:00,57,152,178,387,2322
2016-09-22 09:10:00,104,134,155,393,2358
2016-09-22 09:20:00,143,171,92,406,2436
2016-09-22 09:30:00,143,295,0,438,2628
2016-09-22 09:40:00,93,189,227,509,3054
2016-09-22 09:50:00,280,304,286,870,5220
2016-09-22 10:00:00,465,485,483,1433,8598
2016-09-22 10:10:00,510,548,542,1600,9600
2016-09-22 10:20:00,558,608,598,1764,10584
2016-09-22 10:30:00,608,638,633,1879,11274
2016-09-22 10:40:00,700,723,718,2141,12846
2016-09-22 10:50:00,757,779,767,2303,13818
2016-09-22 11:00:00,789,814,803,2406,14436
2016-09-22 11:10:00,806,829,816,2451,14706
2016-09-22 11:20:00,814,840,832,2486,14916
2016-09-22 11:30:00,827,848,836,2511,15066
2016-09-22 11:40:00,933,949,941,2823,16938
2016-09-22 11:50:00,918,933,931,2782,16692
2016-09-22 12:00:00,724,743,735,2202,13212
2016-09-22 12:10:00,804,819,814,2437,14622
2016-09-22 12:20:00,947,960,956,2863,17178
2016-09-22 12:30:00,941,960,958,2859,17154
2016-09-22 12:40:00,915,939,934,2788,16728
2016-09-22 12:50:00,933,955,949,2837,17022
2016-09-22 13:00:00,936,958,953,2847,17082
2016-09-22 13:10:00,936,957,952,2845,17070
2016-09-22 13:20:00,932,948,947,2827,16962
2016-09-22 13:30:00,924,935,935,2794,16764
2016-09-22 13:40:00,923,936,930,2789,16734
2016-09-22 13:50:00,911,929,917,2757,16542
2016-09-22 14:00:00,912,929,907,2748,16488
2016-09-22 14:10:00,871,892,875,2638,15828
2016-09-22 14:20:00,834,856,841,2531,15186
2016-09-22 14:30:00,778,798,786,2362,14172
2016-09-22 14:40:00,623,645,635,1903,11418
2016-09-22 14:50:00,583,605,596,1784,10704
2016-09-22 15:00:00,562,584,577,1723,10338
2016-09-22 15:10:00,546,566,556,1668,10008
2016-09-22 15:20:00,547,576,567,1690,10140
2016-09-22 15:30:00,540,567,559,1666,9996
2016-09-22 15:40:00,458,488,484,1430,8580
2016-09-22 15:50:00,308,333,330,971,5826
2016-09-22 16:00:00,292,316,313,921,5526
2016-09-22 16:10:00,271,295,291,857,5142
2016-09-22 16:20:00,198,221,217,636,3816
2016-09-22 16:30:00,147,170,164,481,2886
2016-09-22 16:40:00,90,130,108,328,1968
2016-09-22 16:50:00,50,125,115,290,1740
2016-09-22 17:00:00,80,118,104,302,1812
2016-09-22 17:10:00,19,123,131,273,1638
2016-09-22 17:20:00,109,31,117,257,1542
2016-09-22 17:30:00,75,87,83,245,1470
2016-09-22 17:40:00,47,57,82,186,1116
2016-09-22 17:50:00,32,64,59,155,930
2016-09-22 18:00:00,38,56,57,151,906
2016-09-22 18:10:00,34,60,41,135,810
2016-09-22 18:20:00,23,42,28,93,558
2016-09-22 18:30:00,8,20,11,39,234
2016-09-22 18:40:00,2,8,5,15,90
2016-09-22 18:50:00,0,1,1,2,12
2016-09-22 19:00:00,0,0,0,0,0
2016-09-22 19:10:00,0,0,0,0,0
2016-09-23 06:30:00,0,0,0,0,0
2016-09-23 06:40:00,0,0,0,0,0
2016-09-23 06:50:00,0,0,0,0,0
2016-09-23 07:00:00,0,0,0,0,0
2016-09-23 07:10:00,6,11,5,22,132
2016-09-23 07:20:00,10,22,11,43,258
2016-09-23 07:30:00,14,36,19,69,414
2016-09-23 07:40:00,29,64,38,131,786
2016-09-23 07:50:00,59,82,67,208,1248
2016-09-23 08:00:00,53,96,90,239,1434
2016-09-23 08:10:00,15,121,121,257,1542
2016-09-23 08:20:00,72,85,83,240,1440
2016-09-23 08:30:00,86,116,107,309,1854
2016-09-23 08:40:00,114,132,68,314,1884
2016-09-23 08:50:00,101,122,56,279,1674
2016-09-23 09:00:00,64,64,72,200,1200
2016-09-23 09:10:00,114,138,74,326,1956
2016-09-23 09:20:00,79,164,166,409,2454
2016-09-23 09:30:00,149,171,44,364,2184
2016-09-23 09:40:00,206,195,200,601,3606
2016-09-23 09:50:00,258,279,279,816,4896
2016-09-23 10:00:00,263,284,281,828,4968
2016-09-23 10:10:00,366,390,388,1144,6864
2016-09-23 10:20:00,317,341,332,990,5940
2016-09-23 10:30:00,302,329,323,954,5724
2016-09-23 10:40:00,633,655,647,1935,11610
2016-09-23 10:50:00,800,822,814,2436,14616
2016-09-23 11:00:00,800,825,814,2439,14634
2016-09-23 11:10:00,773,799,788,2360,14160
2016-09-23 11:20:00,577,602,595,1774,10644
2016-09-23 11:30:00,859,890,879,2628,15768
2016-09-23 11:40:00,869,888,889,2646,15876
2016-09-23 11:50:00,893,911,911,2715,16290
2016-09-23 12:00:00,896,929,917,2742,16452
2016-09-23 12:10:00,891,932,920,2743,16458
2016-09-23 12:20:00,916,943,934,2793,16758
2016-09-23 12:30:00,935,951,949,2835,17010
2016-09-23 12:40:00,935,959,954,2848,17088
2016-09-23 12:50:00,930,969,960,2859,17154
2016-09-23 13:00:00,917,953,942,2812,16872
2016-09-23 13:10:00,920,951,944,2815,16890
2016-09-23 13:20:00,903,938,935,2776,16656
2016-09-23 13:30:00,892,928,928,2748,16488
2016-09-23 13:40:00,882,923,919,2724,16344
2016-09-23 13:50:00,881,914,910,2705,16230
2016-09-23 14:00:00,703,726,731,2160,12960
2016-09-23 14:10:00,545,564,571,1680,10080
2016-09-23 14:20:00,417,441,441,1299,7794
2016-09-23 14:30:00,186,211,208,605,3630
2016-09-23 14:40:00,232,238,236,706,4236
2016-09-23 14:50:00,355,375,368,1098,6588
2016-09-23 15:00:00,285,305,300,890,5340
2016-09-23 15:10:00,482,523,514,1519,9114
2016-09-23 15:20:00,180,198,196,574,3444
2016-09-23 15:30:00,313,331,327,971,5826
2016-09-23 15:40:00,88,106,122,316,1896
2016-09-23 15:50:00,109,140,129,378,2268
2016-09-23 16:00:00,311,331,322,964,5784
2016-09-23 16:10:00,202,221,219,642,3852
2016-09-23 16:20:00,125,143,140,408,2448
2016-09-23 16:30:00,144,160,158,462,2772
2016-09-23 16:40:00,145,162,160,467,2802
2016-09-23 16:50:00,102,121,108,331,1986
2016-09-23 17:00:00,66,102,97,265,1590
2016-09-23 17:10:00,44,75,62,181,1086
2016-09-23 17:20:00,37,61,34,132,792
2016-09-23 17:30:00,29,57,29,115,690
2016-09-23 17:40:00,28,46,29,103,618
2016-09-23 17:50:00,21,37,26,84,504
2016-09-23 18:00:00,18,37,22,77,462
2016-09-23 18:10:00,19,27,19,65,390
2016-09-23 18:20:00,16,23,13,52,312
2016-09-23 18:30:00,5,9,5,19,114
2016-09-23 18:40:00,1,1,1,3,18
2016-09-23 18:50:00,0,0,0,0,0
2016-09-23 19:00:00,0,0,0,0,0
2016-09-23 19:10:00,0,0,0,0,0
2016-09-24 06:30:00,0,0,0,0,0
2016-09-24 06:40:00,0,0,0,0,0
2016-09-24 06:50:00,0,0,0,0,0
2016-09-24 07:00:00,0,0,0,0,0
2016-09-24 07:10:00,1,3,1,5,30
2016-09-24 07:20:00,5,9,7,21,126
2016-09-24 07:30:00,10,13,13,36,216
2016-09-24 07:40:00,13,19,17,49,294
2016-09-24 07:50:00,18,37,13,68,408
2016-09-24 08:00:00,23,46,11,80,480
2016-09-24 08:10:00,28,48,20,96,576
2016-09-24 08:20:00,32,57,37,126,756
2016-09-24 08:30:00,52,83,65,200,1200
2016-09-24 08:40:00,71,112,96,279,1674
2016-09-24 08:50:00,63,96,85,244,1464
2016-09-24 09:00:00,69,73,59,201,1206
2016-09-24 09:10:00,72,75,61,208,1248
2016-09-24 09:20:00,135,194,63,392,2352
2016-09-24 09:30:00,171,177,133,481,2886
2016-09-24 09:40:00,164,201,157,522,3132
2016-09-24 09:50:00,249,268,264,781,4686
2016-09-24 10:00:00,449,466,465,1380,8280
2016-09-24 10:10:00,669,686,682,2037,12222
2016-09-24 10:20:00,690,704,703,2097,12582
2016-09-24 10:30:00,757,774,765,2296,13776
2016-09-24 10:40:00,758,779,765,2302,13812
2016-09-24 10:50:00,803,819,806,2428,14568
2016-09-24 11:00:00,832,848,843,2523,15138
2016-09-24 11:10:00,835,850,847,2532,15192
2016-09-24 11:20:00,841,852,843,2536,15216
2016-09-24 11:30:00,717,732,725,2174,13044
2016-09-24 11:40:00,795,818,814,2427,14562
2016-09-24 11:50:00,727,748,737,2212,13272
2016-09-24 12:00:00,826,854,837,2517,15102
2016-09-24 12:10:00,536,551,541,1628,9768
2016-09-24 12:20:00,874,883,873,2630,15780
2016-09-24 12:30:00,945,960,952,2857,17142
2016-09-24 12:40:00,889,912,898,2699,16194
2016-09-24 12:50:00,797,820,813,2430,14580
2016-09-24 13:00:00,960,979,977,2916,17496
2016-09-24 13:10:00,962,990,986,2938,17628
2016-09-24 13:20:00,881,905,895,2681,16086
2016-09-24 13:30:00,833,851,844,2528,15168
2016-09-24 13:40:00,829,848,841,2518,15108
2016-09-24 13:50:00,528,547,541,1616,9696
2016-09-24 14:00:00,857,875,867,2599,15594
2016-09-24 14:10:00,847,869,859,2575,15450
2016-09-24 14:20:00,818,832,830,2480,14880
2016-09-24 14:30:00,793,813,800,2406,14436
2016-09-24 14:40:00,762,780,766,2308,13848
2016-09-24 14:50:00,670,690,682,2042,12252
2016-09-24 15:00:00,601,627,622,1850,11100
2016-09-24 15:10:00,601,626,619,1846,11076
2016-09-24 15:20:00,608,631,622,1861,11166
2016-09-24 15:30:00,496,519,514,1529,9174
2016-09-24 15:40:00,351,378,368,1097,6582
2016-09-24 15:50:00,231,254,250,735,4410
2016-09-24 16:00:00,155,174,172,501,3006
2016-09-24 16:10:00,189,212,209,610,3660
2016-09-24 16:20:00,242,264,261,767,4602
2016-09-24 16:30:00,186,206,203,595,3570
2016-09-24 16:40:00,86,107,104,297,1782
2016-09-24 16:50:00,71,96,89,256,1536
2016-09-24 17:00:00,55,111,96,262,1572
2016-09-24 17:10:00,40,63,34,137,822
2016-09-24 17:20:00,30,50,26,106,636
2016-09-24 17:30:00,30,41,22,93,558
2016-09-24 17:40:00,24,34,16,74,444
2016-09-24 17:50:00,16,26,13,55,330
2016-09-24 18:00:00,13,23,8,44,264
2016-09-24 18:10:00,9,16,9,34,204
2016-09-24 18:20:00,8,10,9,27,162
2016-09-24 18:30:00,3,6,4,13,78
2016-09-24 18:40:00,0,0,0,0,0
2016-09-24 18:50:00,0,0,0,0,0
2016-09-24 19:00:00,0,0,0,0,0
2016-09-24 19:10:00,0,0,0,0,0
2016-09-25 06:30:00,0,0,0,0,0
2016-09-25 06:40:00,0,0,0,0,0
2016-09-25 06:50:00,0,0,0,0,0
2016-09-25 07:00:00,0,0,0,0,0
2016-09-25 07:10:00,2,5,4,11,66
2016-09-25 07:20:00,5,15,10,30,180
2016-09-25 07:30:00,13,23,13,49,294
2016-09-25 07:40:00,13,42,17,72,432
2016-09-25 07:50:00,21,52,28,101,606
2016-09-25 08:00:00,26,66,38,130,780
2016-09-25 08:10:00,46,73,69,188,1128
2016-09-25 08:20:00,72,85,76,233,1398
2016-09-25 08:30:00,45,107,108,260,1560
2016-09-25 08:40:00,37,112,118,267,1602
2016-09-25 08:50:00,36,116,120,272,1632
2016-09-25 09:00:00,93,122,63,278,1668
2016-09-25 09:10:00,82,126,104,312,1872
2016-09-25 09:20:00,114,128,115,357,2142
2016-09-25 09:30:00,125,151,125,401,2406
2016-09-25 09:40:00,124,145,169,438,2628
2016-09-25 09:50:00,178,203,215,596,3576
2016-09-25 10:00:00,328,353,347,1028,6168
2016-09-25 10:10:00,477,504,496,1477,8862
2016-09-25 10:20:00,588,611,604,1803,10818
2016-09-25 10:30:00,650,672,663,1985,11910
2016-09-25 10:40:00,700,713,718,2131,12786
2016-09-25 10:50:00,703,726,729,2158,12948
2016-09-25 11:00:00,777,797,793,2367,14202
2016-09-25 11:10:00,803,824,822,2449,14694
2016-09-25 11:20:00,792,809,810,2411,14466
2016-09-25 11:30:00,849,851,862,2562,15372
2016-09-25 11:40:00,883,890,889,2662,15972
2016-09-25 11:50:00,887,904,898,2689,16134
2016-09-25 12:00:00,891,910,903,2704,16224
2016-09-25 12:10:00,889,908,900,2697,16182
2016-09-25 12:20:00,880,898,890,2668,16008
2016-09-25 12:30:00,877,894,890,2661,15966
2016-09-25 12:40:00,919,939,932,2790,16740
2016-09-25 12:50:00,909,931,921,2761,16566
2016-09-25 13:00:00,892,908,897,2697,16182
2016-09-25 13:10:00,891,910,901,2702,16212
2016-09-25 13:20:00,898,912,908,2718,16308
2016-09-25 13:30:00,873,891,887,2651,15906
2016-09-25 13:40:00,871,893,884,2648,15888
2016-09-25 13:50:00,865,879,878,2622,15732
2016-09-25 14:00:00,858,872,869,2599,15594
2016-09-25 14:10:00,829,840,840,2509,15054
2016-09-25 14:20:00,796,812,807,2415,14490
2016-09-25 14:30:00,762,774,773,2309,13854
2016-09-25 14:40:00,729,739,738,2206,13236
2016-09-25 14:50:00,691,705,705,2101,12606
2016-09-25 15:00:00,644,662,664,1970,11820
2016-09-25 15:10:00,610,626,630,1866,11196
2016-09-25 15:20:00,557,577,576,1710,10260
2016-09-25 15:30:00,517,539,538,1594,9564
2016-09-25 15:40:00,465,486,484,1435,8610
2016-09-25 15:50:00,420,441,439,1300,7800
2016-09-25 16:00:00,368,388,388,1144,6864
2016-09-25 16:10:00,294,314,312,920,5520
2016-09-25 16:20:00,220,239,238,697,4182
2016-09-25 16:30:00,178,197,196,571,3426
2016-09-25 16:40:00,128,148,146,422,2532
2016-09-25 16:50:00,104,120,84,308,1848
2016-09-25 17:00:00,58,87,55,200,1200
2016-09-25 17:10:00,39,67,37,143,858
2016-09-25 17:20:00,45,64,46,155,930
2016-09-25 17:30:00,28,69,30,127,762
2016-09-25 17:40:00,28,47,27,102,612
2016-09-25 17:50:00,20,36,12,68,408
2016-09-25 18:00:00,22,32,11,65,390
2016-09-25 18:10:00,19,31,16,66,396
2016-09-25 18:20:00,12,21,15,48,288
2016-09-25 18:30:00,6,11,7,24,144
2016-09-25 18:40:00,1,3,1,5,30
2016-09-25 18:50:00,0,0,0,0,0
2016-09-25 19:00:00,0,0,0,0,0
2016-09-25 19:10:00,0,0,0,0,0
2016-09-26 06:40:00,0,0,0,0,0
2016-09-26 06:50:00,0,0,0,0,0
2016-09-26 07:00:00,0,0,0,0,0
2016-09-26 07:10:00,0,0,0,0,0
2016-09-26 07:20:00,0,0,0,0,0
2016-09-26 07:30:00,1,3,1,5,30
2016-09-26 07:40:00,13,31,14,58,348
2016-09-26 07:50:00,17,31,22,70,420
2016-09-26 08:00:00,14,24,20,58,348
2016-09-26 08:10:00,26,43,32,101,606
2016-09-26 08:20:00,35,59,64,158,948
2016-09-26 08:30:00,30,51,47,128,768
2016-09-26 08:40:00,6,14,10,30,180
2016-09-26 08:50:00,19,26,26,71,426
2016-09-26 09:00:00,8,14,14,36,216
2016-09-26 09:10:00,3,5,6,14,84
2016-09-26 09:20:00,12,29,19,60,360
2016-09-26 09:30:00,7,29,14,50,300
2016-09-26 09:40:00,8,20,17,45,270
2016-09-26 09:50:00,17,40,27,84,504
2016-09-26 10:00:00,36,58,40,134,804
2016-09-26 10:10:00,39,57,45,141,846
2016-09-26 10:20:00,48,70,62,180,1080
2016-09-26 10:30:00,58,74,68,200,1200
2016-09-26 10:40:00,70,92,91,253,1518
2016-09-26 10:50:00,94,121,111,326,1956
2016-09-26 11:00:00,96,151,193,440,2640
2016-09-26 11:10:00,200,230,192,622,3732
2016-09-26 11:20:00,231,256,250,737,4422
2016-09-26 11:30:00,211,233,228,672,4032
2016-09-26 11:40:00,241,263,258,762,4572
2016-09-26 11:50:00,178,200,195,573,3438
2016-09-26 12:00:00,205,227,225,657,3942
2016-09-26 12:10:00,384,405,404,1193,7158
2016-09-26 12:20:00,804,825,817,2446,14676
2016-09-26 12:30:00,885,905,898,2688,16128
2016-09-26 12:40:00,874,893,888,2655,15930
2016-09-26 12:50:00,787,809,805,2401,14406
2016-09-26 13:00:00,744,766,761,2271,13626
2016-09-26 13:10:00,701,723,723,2147,12882
2016-09-26 13:20:00,390,416,410,1216,7296
2016-09-26 13:30:00,282,310,304,896,5376
2016-09-26 13:40:00,699,731,723,2153,12918
2016-09-26 13:50:00,678,705,697,2080,12480
2016-09-26 14:00:00,394,421,416,1231,7386
2016-09-26 14:10:00,348,376,368,1092,6552
2016-09-26 14:20:00,618,647,637,1902,11412
2016-09-26 14:30:00,757,781,775,2313,13878
2016-09-26 14:40:00,583,605,605,1793,10758
2016-09-26 14:50:00,139,161,159,459,2754
2016-09-26 15:00:00,428,451,450,1329,7974
2016-09-26 15:10:00,105,118,123,346,2076
2016-09-26 15:20:00,76,95,97,268,1608
2016-09-26 15:30:00,81,88,101,270,1620
2016-09-26 15:40:00,161,178,176,515,3090
2016-09-26 15:50:00,164,163,184,511,3066
2016-09-26 16:00:00,187,209,202,598,3588
2016-09-26 16:10:00,275,296,290,861,5166
2016-09-26 16:20:00,160,182,178,520,3120
2016-09-26 16:30:00,157,184,179,520,3120
2016-09-26 16:40:00,117,110,152,379,2274
2016-09-26 16:50:00,72,97,105,274,1644
2016-09-26 17:00:00,78,87,51,216,1296
2016-09-26 17:10:00,40,46,51,137,822
2016-09-26 17:20:00,27,60,31,118,708
2016-09-26 17:30:00,29,50,31,110,660
2016-09-26 17:40:00,18,44,33,95,570
2016-09-26 17:50:00,16,36,26,78,468
2016-09-26 18:00:00,17,36,29,82,492
2016-09-26 18:10:00,14,43,27,84,504
2016-09-26 18:20:00,7,17,16,40,240
2016-09-26 18:30:00,4,10,6,20,120
2016-09-26 18:40:00,0,0,0,0,0
2016-09-26 18:50:00,0,0,0,0,0
2016-09-26 19:00:00,0,0,0,0,0
2016-09-27 06:30:00,0,0,0,0,0
2016-09-27 06:40:00,0,0,0,0,0
2016-09-27 06:50:00,0,0,0,0,0
2016-09-27 07:00:00,0,0,0,0,0
2016-09-27 07:10:00,0,0,0,0,0
2016-09-27 07:20:00,1,2,1,4,24
2016-09-27 07:30:00,4,12,4,20,120
2016-09-27 07:40:00,5,22,10,37,222
2016-09-27 07:50:00,9,34,21,64,384
2016-09-27 08:00:00,20,44,31,95,570
2016-09-27 08:10:00,22,77,22,121,726
2016-09-27 08:20:00,37,49,45,131,786
2016-09-27 08:30:00,20,81,19,120,720
2016-09-27 08:40:00,11,97,16,124,744
2016-09-27 08:50:00,33,62,43,138,828
2016-09-27 09:00:00,69,112,114,295,1770
2016-09-27 09:10:00,85,133,132,350,2100
2016-09-27 09:20:00,65,138,166,369,2214
2016-09-27 09:30:00,67,123,143,333,1998
2016-09-27 09:40:00,239,220,216,675,4050
2016-09-27 09:50:00,253,238,248,739,4434
2016-09-27 10:00:00,402,424,420,1246,7476
2016-09-27 10:10:00,449,473,467,1389,8334
2016-09-27 10:20:00,472,492,448,1412,8472
2016-09-27 10:30:00,544,587,577,1708,10248
2016-09-27 10:40:00,701,738,728,2167,13002
2016-09-27 10:50:00,791,813,805,2409,14454
2016-09-27 11:00:00,558,580,573,1711,10266
2016-09-27 11:10:00,255,272,268,795,4770
2016-09-27 11:20:00,356,383,372,1111,6666
2016-09-27 11:30:00,636,662,653,1951,11706
2016-09-27 11:40:00,801,833,822,2456,14736
2016-09-27 11:50:00,614,642,634,1890,11340
2016-09-27 12:00:00,874,901,888,2663,15978
2016-09-27 12:10:00,884,911,903,2698,16188
2016-09-27 12:20:00,774,797,784,2355,14130
2016-09-27 12:30:00,915,933,927,2775,16650
2016-09-27 12:40:00,895,917,911,2723,16338
2016-09-27 12:50:00,920,929,936,2785,16710
2016-09-27 13:00:00,911,923,928,2762,16572
2016-09-27 13:10:00,900,916,919,2735,16410
2016-09-27 13:20:00,892,922,916,2730,16380
2016-09-27 13:30:00,893,912,908,2713,16278
2016-09-27 13:40:00,882,908,902,2692,16152
2016-09-27 13:50:00,856,885,878,2619,15714
2016-09-27 14:00:00,843,851,852,2546,15276
2016-09-27 14:10:00,814,832,833,2479,14874
2016-09-27 14:20:00,801,817,828,2446,14676
2016-09-27 14:30:00,768,783,787,2338,14028
2016-09-27 14:40:00,738,763,758,2259,13554
2016-09-27 14:50:00,680,701,700,2081,12486
2016-09-27 15:00:00,649,669,666,1984,11904
2016-09-27 15:10:00,609,627,626,1862,11172
2016-09-27 15:20:00,561,587,581,1729,10374
2016-09-27 15:30:00,495,523,516,1534,9204
2016-09-27 15:40:00,444,474,469,1387,8322
2016-09-27 15:50:00,398,419,412,1229,7374
2016-09-27 16:00:00,345,365,359,1069,6414
2016-09-27 16:10:00,256,278,275,809,4854
2016-09-27 16:20:00,178,200,196,574,3444
2016-09-27 16:30:00,136,158,154,448,2688
2016-09-27 16:40:00,110,131,127,368,2208
2016-09-27 16:50:00,73,130,125,328,1968
2016-09-27 17:00:00,57,107,105,269,1614
2016-09-27 17:10:00,53,52,66,171,1026
2016-09-27 17:20:00,64,46,78,188,1128
2016-09-27 17:30:00,63,35,73,171,1026
2016-09-27 17:40:00,37,58,40,135,810
2016-09-27 17:50:00,29,40,31,100,600
2016-09-27 18:00:00,12,37,18,67,402
2016-09-27 18:10:00,8,16,13,37,222
2016-09-27 18:20:00,5,10,6,21,126
2016-09-27 18:30:00,1,2,1,4,24
2016-09-27 18:40:00,0,0,0,0,0
2016-09-27 18:50:00,0,0,0,0,0
2016-09-27 19:00:00,0,0,0,0,0
2016-09-28 06:50:00,0,0,0,0,0
2016-09-28 07:00:00,0,0,0,0,0
2016-09-28 07:10:00,0,0,0,0,0
2016-09-28 07:20:00,0,0,0,0,0
2016-09-28 07:30:00,0,0,0,0,0
2016-09-28 07:40:00,3,5,3,11,66
2016-09-28 07:50:00,18,25,20,63,378
2016-09-28 08:00:00,34,60,33,127,762
2016-09-28 08:10:00,41,52,43,136,816
2016-09-28 08:20:00,37,51,39,127,762
2016-09-28 08:30:00,56,50,47,153,918
2016-09-28 08:40:00,32,72,31,135,810
2016-09-28 08:50:00,19,92,20,131,786
2016-09-28 09:00:00,58,58,63,179,1074
2016-09-28 09:10:00,58,40,64,162,972
2016-09-28 09:20:00,83,102,99,284,1704
2016-09-28 09:30:00,72,92,121,285,1710
2016-09-28 09:40:00,162,213,82,457,2742
2016-09-28 09:50:00,186,254,96,536,3216
2016-09-28 10:00:00,285,303,299,887,5322
2016-09-28 10:10:00,427,447,445,1319,7914
2016-09-28 10:20:00,559,579,571,1709,10254
2016-09-28 10:30:00,591,613,601,1805,10830
2016-09-28 10:40:00,686,710,695,2091,12546
2016-09-28 10:50:00,544,566,554,1664,9984
2016-09-28 11:00:00,104,122,91,317,1902
2016-09-28 11:10:00,193,209,199,601,3606
2016-09-28 11:20:00,295,304,250,849,5094
2016-09-28 11:30:00,901,919,914,2734,16404
2016-09-28 11:40:00,482,500,498,1480,8880
2016-09-28 11:50:00,372,391,387,1150,6900
2016-09-28 12:00:00,80,98,74,252,1512
2016-09-28 12:10:00,147,200,153,500,3000
2016-09-28 12:20:00,247,267,264,778,4668
2016-09-28 12:30:00,257,275,274,806,4836
2016-09-28 12:40:00,174,194,191,559,3354
2016-09-28 12:50:00,379,403,395,1177,7062
2016-09-28 13:00:00,498,524,512,1534,9204
2016-09-28 13:10:00,482,507,501,1490,8940
2016-09-28 13:20:00,358,378,375,1111,6666
2016-09-28 13:30:00,453,469,468,1390,8340
2016-09-28 13:40:00,482,500,496,1478,8868
2016-09-28 13:50:00,218,236,236,690,4140
2016-09-28 14:00:00,254,275,272,801,4806
2016-09-28 14:10:00,562,591,585,1738,10428
2016-09-28 14:20:00,241,250,261,752,4512
2016-09-28 14:30:00,152,152,176,480,2880
2016-09-28 14:40:00,327,349,347,1023,6138
2016-09-28 14:50:00,267,292,288,847,5082
2016-09-28 15:00:00,230,254,251,735,4410
2016-09-28 15:10:00,192,200,201,593,3558
2016-09-28 15:20:00,215,217,219,651,3906
2016-09-28 15:30:00,227,150,169,546,3276
2016-09-28 15:40:00,196,200,201,597,3582
2016-09-28 15:50:00,178,201,198,577,3462
2016-09-28 16:00:00,105,126,124,355,2130
2016-09-28 16:10:00,110,112,129,351,2106
2016-09-28 16:20:00,157,201,71,429,2574
2016-09-28 16:30:00,112,93,111,316,1896
2016-09-28 16:40:00,93,123,102,318,1908
2016-09-28 16:50:00,76,54,88,218,1308
2016-09-28 17:00:00,45,56,56,157,942
2016-09-28 17:10:00,59,59,58,176,1056
2016-09-28 17:20:00,65,59,77,201,1206
2016-09-28 17:30:00,32,45,39,116,696
2016-09-28 17:40:00,11,36,22,69,414
2016-09-28 17:50:00,15,24,6,45,270
2016-09-28 18:00:00,12,15,7,34,204
2016-09-28 18:10:00,2,2,1,5,30
2016-09-28 18:20:00,0,0,0,0,0
2016-09-28 18:30:00,0,0,0,0,0
2016-09-28 18:40:00,0,0,0,0,0
2016-09-28 18:50:00,0,0,0,0,0
2016-09-29 07:00:00,0,0,0,0,0
2016-09-29 07:10:00,0,0,0,0,0
2016-09-29 07:20:00,0,0,0,0,0
2016-09-29 07:30:00,0,0,0,0,0
2016-09-29 07:40:00,0,0,0,0,0
2016-09-29 07:50:00,0,0,0,0,0
2016-09-29 08:00:00,2,3,2,7,42
2016-09-29 08:10:00,9,11,12,32,192
2016-09-29 08:20:00,2,2,2,6,36
2016-09-29 08:30:00,11,18,15,44,264
2016-09-29 08:40:00,20,31,18,69,414
2016-09-29 08:50:00,25,30,33,88,528
2016-09-29 09:00:00,26,41,30,97,582
2016-09-29 09:10:00,23,41,28,92,552
2016-09-29 09:20:00,41,51,42,134,804
2016-09-29 09:30:00,79,94,57,230,1380
2016-09-29 09:40:00,126,105,125,356,2136
2016-09-29 09:50:00,199,210,199,608,3648
2016-09-29 10:00:00,146,168,164,478,2868
2016-09-29 10:10:00,67,80,65,212,1272
2016-09-29 10:20:00,67,73,75,215,1290
2016-09-29 10:30:00,86,76,99,261,1566
2016-09-29 10:40:00,209,222,226,657,3942
2016-09-29 10:50:00,112,119,122,353,2118
2016-09-29 11:00:00,139,114,140,393,2358
2016-09-29 11:10:00,55,60,55,170,1020
2016-09-29 11:20:00,48,73,60,181,1086
2016-09-29 11:30:00,75,99,97,271,1626
2016-09-29 11:40:00,76,106,92,274,1644
2016-09-29 11:50:00,173,182,180,535,3210
2016-09-29 12:00:00,174,171,172,517,3102
2016-09-29 12:10:00,58,70,67,195,1170
2016-09-29 12:20:00,48,66,51,165,990
2016-09-29 12:30:00,51,62,59,172,1032
2016-09-29 12:40:00,55,68,52,175,1050
2016-09-29 12:50:00,45,66,32,143,858
2016-09-29 13:00:00,36,56,28,120,720
2016-09-29 13:10:00,54,80,52,186,1116
2016-09-29 13:20:00,52,70,48,170,1020
2016-09-29 13:30:00,32,32,36,100,600
2016-09-29 13:40:00,93,99,83,275,1650
2016-09-29 13:50:00,69,80,61,210,1260
2016-09-29 14:00:00,35,37,30,102,612
2016-09-29 14:10:00,26,46,25,97,582
2016-09-29 14:20:00,19,20,22,61,366
2016-09-29 14:30:00,69,69,85,223,1338
2016-09-29 14:40:00,44,165,248,457,2742
2016-09-29 14:50:00,185,97,195,477,2862
2016-09-29 15:00:00,90,98,109,297,1782
2016-09-29 15:10:00,78,93,72,243,1458
2016-09-29 15:20:00,86,100,90,276,1656
2016-09-29 15:30:00,87,97,102,286,1716
2016-09-29 15:40:00,164,122,176,462,2772
2016-09-29 15:50:00,347,375,371,1093,6558
2016-09-29 16:00:00,324,349,345,1018,6108
2016-09-29 16:10:00,223,251,246,720,4320
2016-09-29 16:20:00,147,171,176,494,2964
2016-09-29 16:30:00,160,160,131,451,2706
2016-09-29 16:40:00,154,198,84,436,2616
2016-09-29 16:50:00,120,117,107,344,2064
2016-09-29 17:00:00,56,81,66,203,1218
2016-09-29 17:10:00,21,63,26,110,660
2016-09-29 17:20:00,22,73,38,133,798
2016-09-29 17:30:00,19,90,67,176,1056
2016-09-29 17:40:00,41,58,42,141,846
2016-09-29 17:50:00,30,40,35,105,630
2016-09-29 18:00:00,12,10,14,36,216
2016-09-29 18:10:00,9,10,8,27,162
2016-09-29 18:20:00,4,5,3,12,72
2016-09-29 18:30:00,0,0,0,0,0
2016-09-29 18:40:00,0,0,0,0,0
2016-09-29 18:50:00,0,0,0,0,0
2016-09-29 19:00:00,0,0,0,0,0
2016-09-30 06:40:00,0,0,0,0,0
2016-09-30 06:50:00,0,0,0,0,0
2016-09-30 07:00:00,0,0,0,0,0
2016-09-30 07:10:00,0,0,0,0,0
2016-09-30 07:20:00,0,0,0,0,0
2016-09-30 07:30:00,10,16,5,31,186
2016-09-30 07:40:00,21,32,21,74,444
2016-09-30 07:50:00,17,21,19,57,342
2016-09-30 08:00:00,56,73,52,181,1086
2016-09-30 08:10:00,36,56,45,137,822
2016-09-30 08:20:00,55,69,60,184,1104
2016-09-30 08:30:00,26,63,32,121,726
2016-09-30 08:40:00,100,149,83,332,1992
2016-09-30 08:50:00,65,95,86,246,1476
2016-09-30 09:00:00,30,62,40,132,792
2016-09-30 09:10:00,47,77,64,188,1128
2016-09-30 09:20:00,76,94,62,232,1392
2016-09-30 09:30:00,124,118,113,355,2130
2016-09-30 09:40:00,126,130,133,389,2334
2016-09-30 09:50:00,261,278,274,813,4878
2016-09-30 10:00:00,480,503,496,1479,8874
2016-09-30 10:10:00,371,391,388,1150,6900
2016-09-30 10:20:00,190,214,209,613,3678
2016-09-30 10:30:00,458,481,476,1415,8490
2016-09-30 10:40:00,295,318,313,926,5556
2016-09-30 10:50:00,497,522,516,1535,9210
2016-09-30 11:00:00,640,667,660,1967,11802
2016-09-30 11:10:00,509,530,528,1567,9402
2016-09-30 11:20:00,866,888,876,2630,15780
2016-09-30 11:30:00,337,356,353,1046,6276
2016-09-30 11:40:00,386,405,405,1196,7176
2016-09-30 11:50:00,628,647,647,1922,11532
2016-09-30 12:00:00,584,609,602,1795,10770
2016-09-30 12:10:00,435,458,456,1349,8094
2016-09-30 12:20:00,489,513,510,1512,9072
2016-09-30 12:30:00,861,884,875,2620,15720
2016-09-30 12:40:00,978,995,987,2960,17760
2016-09-30 12:50:00,851,875,864,2590,15540
2016-09-30 13:00:00,731,754,745,2230,13380
2016-09-30 13:10:00,744,768,757,2269,13614
2016-09-30 13:20:00,62,81,73,216,1296
2016-09-30 13:30:00,229,249,241,719,4314
2016-09-30 13:40:00,802,827,827,2456,14736
2016-09-30 13:50:00,881,907,903,2691,16146
2016-09-30 14:00:00,773,804,797,2374,14244
2016-09-30 14:10:00,510,534,531,1575,9450
2016-09-30 14:20:00,601,643,639,1883,11298
2016-09-30 14:30:00,672,704,700,2076,12456
2016-09-30 14:40:00,757,790,790,2337,14022
2016-09-30 14:50:00,735,770,764,2269,13614
2016-09-30 15:00:00,661,690,682,2033,12198
2016-09-30 15:10:00,253,276,273,802,4812
2016-09-30 15:20:00,475,496,492,1463,8778
2016-09-30 15:30:00,490,513,508,1511,9066
2016-09-30 15:40:00,434,458,453,1345,8070
2016-09-30 15:50:00,405,430,424,1259,7554
2016-09-30 16:00:00,96,119,114,329,1974
2016-09-30 16:10:00,99,89,118,306,1836
2016-09-30 16:20:00,144,145,147,436,2616
2016-09-30 16:30:00,71,88,85,244,1464
2016-09-30 16:40:00,78,95,101,274,1644
2016-09-30 16:50:00,31,72,56,159,954
2016-09-30 17:00:00,19,75,20,114,684
2016-09-30 17:10:00,13,34,13,60,360
2016-09-30 17:20:00,31,41,27,99,594
2016-09-30 17:30:00,49,71,66,186,1116
2016-09-30 17:40:00,28,47,30,105,630
2016-09-30 17:50:00,19,27,10,56,336
2016-09-30 18:00:00,13,16,7,36,216
2016-09-30 18:10:00,7,10,5,22,132
2016-09-30 18:20:00,2,3,1,6,36
2016-09-30 18:30:00,0,0,0,0,0
2016-09-30 18:40:00,0,0,0,0,0
2016-09-30 18:50:00,0,0,0,0,0
2016-10-01 06:40:00,0,0,0,0,0
2016-10-01 06:50:00,0,0,0,0,0
2016-10-01 07:00:00,0,0,0,0,0
2016-10-01 07:10:00,0,0,0,0,0
2016-10-01 07:20:00,1,2,1,4,24
2016-10-01 07:30:00,8,14,5,27,162
2016-10-01 07:40:00,15,26,12,53,318
2016-10-01 07:50:00,18,40,12,70,420
2016-10-01 08:00:00,21,50,28,99,594
2016-10-01 08:10:00,31,68,13,112,672
2016-10-01 08:20:00,38,68,34,140,840
2016-10-01 08:30:00,50,73,64,187,1122
2016-10-01 08:40:00,42,64,61,167,1002
2016-10-01 08:50:00,66,86,73,225,1350
2016-10-01 09:00:00,94,60,103,257,1542
2016-10-01 09:10:00,119,118,117,354,2124
2016-10-01 09:20:00,151,178,141,470,2820
2016-10-01 09:30:00,148,180,113,441,2646
2016-10-01 09:40:00,51,181,256,488,2928
2016-10-01 09:50:00,132,130,157,419,2514
2016-10-01 10:00:00,97,144,154,395,2370
2016-10-01 10:10:00,89,139,158,386,2316
2016-10-01 10:20:00,106,134,146,386,2316
2016-10-01 10:30:00,136,195,171,502,3012
2016-10-01 10:40:00,37,169,259,465,2790
2016-10-01 10:50:00,126,111,141,378,2268
2016-10-01 11:00:00,134,156,113,403,2418
2016-10-01 11:10:00,141,288,27,456,2736
2016-10-01 11:20:00,210,163,187,560,3360
2016-10-01 11:30:00,259,236,249,744,4464
2016-10-01 11:40:00,283,302,297,882,5292
2016-10-01 11:50:00,238,258,254,750,4500
2016-10-01 12:00:00,293,313,310,916,5496
2016-10-01 12:10:00,450,470,468,1388,8328
2016-10-01 12:20:00,741,764,760,2265,13590
2016-10-01 12:30:00,613,632,628,1873,11238
2016-10-01 12:40:00,733,750,743,2226,13356
2016-10-01 12:50:00,751,771,764,2286,13716
2016-10-01 13:00:00,731,752,740,2223,13338
2016-10-01 13:10:00,548,569,560,1677,10062
2016-10-01 13:20:00,194,215,210,619,3714
2016-10-01 13:30:00,167,188,184,539,3234
2016-10-01 13:40:00,181,204,200,585,3510
2016-10-01 13:50:00,403,429,422,1254,7524
2016-10-01 14:00:00,174,198,192,564,3384
2016-10-01 14:10:00,223,245,239,707,4242
2016-10-01 14:20:00,181,195,196,572,3432
2016-10-01 14:30:00,47,103,97,247,1482
2016-10-01 14:40:00,54,60,63,177,1062
2016-10-01 14:50:00,89,113,61,263,1578
2016-10-01 15:00:00,183,197,141,521,3126
2016-10-01 15:10:00,214,235,229,678,4068
2016-10-01 15:20:00,123,147,138,408,2448
2016-10-01 15:30:00,111,158,164,433,2598
2016-10-01 15:40:00,94,123,80,297,1782
2016-10-01 15:50:00,112,104,94,310,1860
2016-10-01 16:00:00,106,136,100,342,2052
2016-10-01 16:10:00,100,127,97,324,1944
2016-10-01 16:20:00,127,148,84,359,2154
2016-10-01 16:30:00,44,131,106,281,1686
2016-10-01 16:40:00,79,97,67,243,1458
2016-10-01 16:50:00,34,124,119,277,1662
2016-10-01 17:00:00,11,131,127,269,1614
2016-10-01 17:10:00,46,85,61,192,1152
2016-10-01 17:20:00,73,86,39,198,1188
2016-10-01 17:30:00,48,109,89,246,1476
2016-10-01 17:40:00,34,96,69,199,1194
2016-10-01 17:50:00,20,26,17,63,378
2016-10-01 18:00:00,9,10,11,30,180
2016-10-01 18:10:00,2,3,3,8,48
2016-10-01 18:20:00,0,0,0,0,0
2016-10-01 18:30:00,0,0,0,0,0
2016-10-01 18:40:00,0,0,0,0,0
2016-10-01 18:50:00,0,0,0,0,0
2016-10-02 07:00:00,0,0,0,0,0
2016-10-02 07:10:00,0,0,0,0,0
2016-10-02 07:20:00,0,0,0,0,0
2016-10-02 07:30:00,0,0,0,0,0
2016-10-02 07:40:00,0,0,0,0,0
2016-10-02 07:50:00,0,0,0,0,0
2016-10-02 08:00:00,0,1,0,1,6
2016-10-02 08:10:00,4,11,7,22,132
2016-10-02 08:20:00,8,18,8,34,204
2016-10-02 08:30:00,15,31,9,55,330
2016-10-02 08:40:00,12,20,9,41,246
2016-10-02 08:50:00,14,31,8,53,318
2016-10-02 09:00:00,12,19,12,43,258
2016-10-02 09:10:00,20,24,18,62,372
2016-10-02 09:20:00,30,44,29,103,618
2016-10-02 09:30:00,14,22,18,54,324
2016-10-02 09:40:00,24,41,26,91,546
2016-10-02 09:50:00,30,59,28,117,702
2016-10-02 10:00:00,22,39,26,87,522
2016-10-02 10:10:00,43,79,32,154,924
2016-10-02 10:20:00,144,192,113,449,2694
2016-10-02 10:30:00,55,78,62,195,1170
2016-10-02 10:40:00,39,72,50,161,966
2016-10-02 10:50:00,76,95,55,226,1356
2016-10-02 11:00:00,118,144,51,313,1878
2016-10-02 11:10:00,321,368,338,1027,6162
2016-10-02 11:20:00,293,316,319,928,5568
2016-10-02 11:30:00,162,184,179,525,3150
2016-10-02 11:40:00,254,189,187,630,3780
2016-10-02 11:50:00,111,133,125,369,2214
2016-10-02 12:00:00,186,137,152,475,2850
2016-10-02 12:10:00,74,72,80,226,1356
2016-10-02 12:20:00,87,105,57,249,1494
2016-10-02 12:30:00,74,101,84,259,1554
2016-10-02 12:40:00,255,154,199,608,3648
2016-10-02 12:50:00,146,207,171,524,3144
2016-10-02 13:00:00,255,284,268,807,4842
2016-10-02 13:10:00,262,283,276,821,4926
2016-10-02 13:20:00,280,301,298,879,5274
2016-10-02 13:30:00,251,269,269,789,4734
2016-10-02 13:40:00,858,874,866,2598,15588
2016-10-02 13:50:00,416,434,429,1279,7674
2016-10-02 14:00:00,371,390,386,1147,6882
2016-10-02 14:10:00,370,387,383,1140,6840
2016-10-02 14:20:00,291,309,308,908,5448
2016-10-02 14:30:00,256,272,269,797,4782
2016-10-02 14:40:00,96,126,120,342,2052
2016-10-02 14:50:00,127,135,149,411,2466
2016-10-02 15:00:00,253,209,219,681,4086
2016-10-02 15:10:00,314,334,327,975,5850
2016-10-02 15:20:00,222,242,238,702,4212
2016-10-02 15:30:00,285,307,302,894,5364
2016-10-02 15:40:00,153,170,170,493,2958
2016-10-02 15:50:00,62,79,72,213,1278
2016-10-02 16:00:00,64,83,70,217,1302
2016-10-02 16:10:00,27,59,18,104,624
2016-10-02 16:20:00,21,33,17,71,426
2016-10-02 16:30:00,26,41,23,90,540
2016-10-02 16:40:00,25,40,19,84,504
2016-10-02 16:50:00,7,8,6,21,126
2016-10-02 17:00:00,7,8,8,23,138
2016-10-02 17:10:00,3,6,3,12,72
2016-10-02 17:20:00,0,1,0,1,6
2016-10-02 17:30:00,2,5,3,10,60
2016-10-02 17:40:00,10,15,13,38,228
2016-10-02 17:50:00,10,12,7,29,174
2016-10-02 18:00:00,6,12,1,19,114
2016-10-02 18:10:00,1,3,1,5,30
2016-10-02 18:20:00,0,0,0,0,0
2016-10-02 18:30:00,0,0,0,0,0
2016-10-02 18:40:00,0,0,0,0,0
2016-10-03 07:00:00,0,0,0,0,0
2016-10-03 07:10:00,0,0,0,0,0
2016-10-03 07:20:00,0,0,0,0,0
2016-10-03 07:30:00,0,0,0,0,0
2016-10-03 07:40:00,0,0,0,0,0
2016-10-03 07:50:00,1,1,1,3,18
2016-10-03 08:00:00,6,9,4,19,114
2016-10-03 08:10:00,18,32,8,58,348
2016-10-03 08:20:00,13,23,8,44,264
2016-10-03 08:30:00,22,42,19,83,498
2016-10-03 08:40:00,47,75,41,163,978
2016-10-03 08:50:00,34,61,28,123,738
2016-10-03 09:00:00,43,62,31,136,816
2016-10-03 09:10:00,31,46,33,110,660
2016-10-03 09:20:00,16,18,11,45,270
2016-10-03 09:30:00,13,46,19,78,468
2016-10-03 09:40:00,44,71,52,167,1002
2016-10-03 09:50:00,54,126,95,275,1650
2016-10-03 10:00:00,114,208,67,389,2334
2016-10-03 10:10:00,119,154,149,422,2532
2016-10-03 10:20:00,48,82,63,193,1158
2016-10-03 10:30:00,51,48,61,160,960
2016-10-03 10:40:00,29,45,29,103,618
2016-10-03 10:50:00,46,55,46,147,882
2016-10-03 11:00:00,66,70,63,199,1194
2016-10-03 11:10:00,81,98,71,250,1500
2016-10-03 11:20:00,76,97,74,247,1482
2016-10-03 11:30:00,172,172,178,522,3132
2016-10-03 11:40:00,178,167,184,529,3174
2016-10-03 11:50:00,149,154,159,462,2772
2016-10-03 12:00:00,195,173,150,518,3108
2016-10-03 12:10:00,407,429,429,1265,7590
2016-10-03 12:20:00,266,235,244,745,4470
2016-10-03 12:30:00,204,223,221,648,3888
2016-10-03 12:40:00,345,365,359,1069,6414
2016-10-03 12:50:00,286,306,303,895,5370
2016-10-03 13:00:00,246,265,265,776,4656
2016-10-03 13:10:00,141,123,122,386,2316
2016-10-03 13:20:00,113,101,130,344,2064
2016-10-03 13:30:00,139,112,122,373,2238
2016-10-03 13:40:00,143,135,118,396,2376
2016-10-03 13:50:00,231,218,185,634,3804
2016-10-03 14:00:00,179,198,198,575,3450
2016-10-03 14:10:00,290,318,326,934,5604
2016-10-03 14:20:00,342,364,360,1066,6396
2016-10-03 14:30:00,593,614,614,1821,10926
2016-10-03 14:40:00,710,731,731,2172,13032
2016-10-03 14:50:00,665,684,683,2032,12192
2016-10-03 15:00:00,569,586,586,1741,10446
2016-10-03 15:10:00,397,418,416,1231,7386
2016-10-03 15:20:00,374,397,391,1162,6972
2016-10-03 15:30:00,406,429,423,1258,7548
2016-10-03 15:40:00,284,306,304,894,5364
2016-10-03 15:50:00,355,385,380,1120,6720
2016-10-03 16:00:00,305,330,325,960,5760
2016-10-03 16:10:00,242,268,262,772,4632
2016-10-03 16:20:00,173,192,188,553,3318
2016-10-03 16:30:00,76,99,96,271,1626
2016-10-03 16:40:00,29,60,29,118,708
2016-10-03 16:50:00,25,50,20,95,570
2016-10-03 17:00:00,22,48,29,99,594
2016-10-03 17:10:00,21,38,30,89,534
2016-10-03 17:20:00,18,33,27,78,468
2016-10-03 17:30:00,12,36,19,67,402
2016-10-03 17:40:00,11,21,20,52,312
2016-10-03 17:50:00,8,12,14,34,204
2016-10-03 18:00:00,3,13,6,22,132
2016-10-03 18:10:00,2,4,4,10,60
2016-10-03 18:20:00,0,0,0,0,0
2016-10-03 18:30:00,0,0,0,0,0
2016-10-03 18:40:00,0,0,0,0,0
2016-10-03 18:50:00,0,0,0,0,0
2016-10-04 06:50:00,0,0,0,0,0
2016-10-04 07:00:00,0,0,0,0,0
2016-10-04 07:10:00,0,0,0,0,0
2016-10-04 07:20:00,0,0,0,0,0
2016-10-04 07:30:00,3,4,3,10,60
2016-10-04 07:40:00,6,7,10,23,138
2016-10-04 07:50:00,8,10,13,31,186
2016-10-04 08:00:00,12,20,12,44,264
2016-10-04 08:10:00,17,26,9,52,312
2016-10-04 08:20:00,19,25,25,69,414
2016-10-04 08:30:00,23,52,23,98,588
2016-10-04 08:40:00,30,45,11,86,516
2016-10-04 08:50:00,37,64,38,139,834
2016-10-04 09:00:00,40,69,58,167,1002
2016-10-04 09:10:00,30,71,40,141,846
2016-10-04 09:20:00,18,88,18,124,744
2016-10-04 09:30:00,34,63,36,133,798
2016-10-04 09:40:00,51,63,61,175,1050
2016-10-04 09:50:00,187,219,210,616,3696
2016-10-04 10:00:00,479,499,491,1469,8814
2016-10-04 10:10:00,666,686,679,2031,12186
2016-10-04 10:20:00,727,754,745,2226,13356
2016-10-04 10:30:00,777,803,789,2369,14214
2016-10-04 10:40:00,803,828,810,2441,14646
2016-10-04 10:50:00,830,857,836,2523,15138
2016-10-04 11:00:00,854,877,860,2591,15546
2016-10-04 11:10:00,869,896,880,2645,15870
2016-10-04 11:20:00,885,908,901,2694,16164
2016-10-04 11:30:00,899,925,913,2737,16422
2016-10-04 11:40:00,913,928,927,2768,16608
2016-10-04 11:50:00,923,943,935,2801,16806
2016-10-04 12:00:00,935,952,947,2834,17004
2016-10-04 12:10:00,943,967,957,2867,17202
2016-10-04 12:20:00,939,969,960,2868,17208
2016-10-04 12:30:00,949,975,966,2890,17340
2016-10-04 12:40:00,948,970,963,2881,17286
2016-10-04 12:50:00,949,966,955,2870,17220
2016-10-04 13:00:00,939,965,953,2857,17142
2016-10-04 13:10:00,936,958,950,2844,17064
2016-10-04 13:20:00,931,951,948,2830,16980
2016-10-04 13:30:00,926,947,941,2814,16884
2016-10-04 13:40:00,918,942,929,2789,16734
2016-10-04 13:50:00,905,923,915,2743,16458
2016-10-04 14:00:00,867,897,879,2643,15858
2016-10-04 14:10:00,826,855,837,2518,15108
2016-10-04 14:20:00,775,804,793,2372,14232
2016-10-04 14:30:00,751,783,773,2307,13842
2016-10-04 14:40:00,692,722,716,2130,12780
2016-10-04 14:50:00,669,702,693,2064,12384
2016-10-04 15:00:00,618,659,643,1920,11520
2016-10-04 15:10:00,571,605,597,1773,10638
2016-10-04 15:20:00,529,558,550,1637,9822
2016-10-04 15:30:00,475,499,492,1466,8796
2016-10-04 15:40:00,429,454,449,1332,7992
2016-10-04 15:50:00,365,391,384,1140,6840
2016-10-04 16:00:00,305,334,327,966,5796
2016-10-04 16:10:00,256,278,272,806,4836
2016-10-04 16:20:00,178,202,193,573,3438
2016-10-04 16:30:00,73,95,98,266,1596
2016-10-04 16:40:00,50,82,73,205,1230
2016-10-04 16:50:00,67,107,76,250,1500
2016-10-04 17:00:00,43,96,74,213,1278
2016-10-04 17:10:00,45,85,64,194,1164
2016-10-04 17:20:00,46,72,65,183,1098
2016-10-04 17:30:00,27,63,31,121,726
2016-10-04 17:40:00,28,44,31,103,618
2016-10-04 17:50:00,18,21,16,55,330
2016-10-04 18:00:00,7,12,8,27,162
2016-10-04 18:10:00,5,7,6,18,108
2016-10-04 18:20:00,0,1,0,1,6
2016-10-04 18:30:00,0,0,0,0,0
2016-10-04 18:40:00,0,0,0,0,0
2016-10-04 18:50:00,0,0,0,0,0
2016-10-05 06:50:00,0,0,0,0,0
2016-10-05 07:00:00,0,0,0,0,0
2016-10-05 07:10:00,0,0,0,0,0
2016-10-05 07:20:00,0,0,0,0,0
2016-10-05 07:30:00,2,3,1,6,36
2016-10-05 07:40:00,5,7,3,15,90
2016-10-05 07:50:00,11,12,14,37,222
2016-10-05 08:00:00,24,40,30,94,564
2016-10-05 08:10:00,34,56,48,138,828
2016-10-05 08:20:00,38,68,44,150,900
2016-10-05 08:30:00,43,68,43,154,924
2016-10-05 08:40:00,60,87,81,228,1368
2016-10-05 08:50:00,83,103,88,274,1644
2016-10-05 09:00:00,87,117,108,312,1872
2016-10-05 09:10:00,113,131,140,384,2304
2016-10-05 09:20:00,126,154,124,404,2424
2016-10-05 09:30:00,146,168,164,478,2868
2016-10-05 09:40:00,123,193,157,473,2838
2016-10-05 09:50:00,124,157,179,460,2760
2016-10-05 10:00:00,181,209,208,598,3588
2016-10-05 10:10:00,393,413,407,1213,7278
2016-10-05 10:20:00,642,671,661,1974,11844
2016-10-05 10:30:00,716,741,732,2189,13134
2016-10-05 10:40:00,497,513,509,1519,9114
2016-10-05 10:50:00,736,745,742,2223,13338
2016-10-05 11:00:00,731,743,735,2209,13254
2016-10-05 11:10:00,867,884,874,2625,15750
2016-10-05 11:20:00,789,809,798,2396,14376
2016-10-05 11:30:00,907,928,913,2748,16488
2016-10-05 11:40:00,922,944,926,2792,16752
2016-10-05 11:50:00,930,945,933,2808,16848
2016-10-05 12:00:00,924,945,936,2805,16830
2016-10-05 12:10:00,944,970,963,2877,17262
2016-10-05 12:20:00,949,974,962,2885,17310
2016-10-05 12:30:00,959,981,961,2901,17406
2016-10-05 12:40:00,961,972,960,2893,17358
2016-10-05 12:50:00,966,973,961,2900,17400
2016-10-05 13:00:00,962,977,970,2909,17454
2016-10-05 13:10:00,945,972,972,2889,17334
2016-10-05 13:20:00,966,991,986,2943,17658
2016-10-05 13:30:00,848,871,867,2586,15516
2016-10-05 13:40:00,945,960,965,2870,17220
2016-10-05 13:50:00,804,819,823,2446,14676
2016-10-05 14:00:00,831,849,848,2528,15168
2016-10-05 14:10:00,737,761,754,2252,13512
2016-10-05 14:20:00,681,703,695,2079,12474
2016-10-05 14:30:00,407,429,425,1261,7566
2016-10-05 14:40:00,381,403,402,1186,7116
2016-10-05 14:50:00,596,612,620,1828,10968
2016-10-05 15:00:00,373,395,398,1166,6996
2016-10-05 15:10:00,594,619,620,1833,10998
2016-10-05 15:20:00,537,556,560,1653,9918
2016-10-05 15:30:00,475,497,492,1464,8784
2016-10-05 15:40:00,361,383,377,1121,6726
2016-10-05 15:50:00,361,384,378,1123,6738
2016-10-05 16:00:00,300,323,319,942,5652
2016-10-05 16:10:00,240,261,258,759,4554
2016-10-05 16:20:00,142,157,167,466,2796
2016-10-05 16:30:00,55,85,82,222,1332
2016-10-05 16:40:00,32,72,38,142,852
2016-10-05 16:50:00,60,63,66,189,1134
2016-10-05 17:00:00,47,42,47,136,816
2016-10-05 17:10:00,35,44,36,115,690
2016-10-05 17:20:00,41,39,47,127,762
2016-10-05 17:30:00,27,30,32,89,534
2016-10-05 17:40:00,15,22,21,58,348
2016-10-05 17:50:00,5,32,17,54,324
2016-10-05 18:00:00,6,16,6,28,168
2016-10-05 18:10:00,3,5,5,13,78
2016-10-05 18:20:00,0,0,0,0,0
2016-10-05 18:30:00,0,0,0,0,0
2016-10-05 18:40:00,0,0,0,0,0
2016-10-06 07:00:00,0,0,0,0,0
2016-10-06 07:10:00,0,0,0,0,0
2016-10-06 07:20:00,0,0,0,0,0
2016-10-06 07:30:00,0,0,0,0,0
2016-10-06 07:40:00,0,0,0,0,0
2016-10-06 07:50:00,0,0,0,0,0
2016-10-06 08:00:00,0,0,0,0,0
2016-10-06 08:10:00,0,1,0,1,6
2016-10-06 08:20:00,6,8,3,17,102
2016-10-06 08:30:00,10,13,3,26,156
2016-10-06 08:40:00,13,17,4,34,204
2016-10-06 08:50:00,38,24,3,65,390
2016-10-06 09:00:00,23,31,9,63,378
2016-10-06 09:10:00,16,21,14,51,306
2016-10-06 09:20:00,17,22,14,53,318
2016-10-06 09:30:00,25,38,9,72,432
2016-10-06 09:40:00,28,52,12,92,552
2016-10-06 09:50:00,25,57,16,98,588
2016-10-06 10:00:00,21,56,27,104,624
2016-10-06 10:10:00,38,57,34,129,774
2016-10-06 10:20:00,62,56,63,181,1086
2016-10-06 10:30:00,62,68,67,197,1182
2016-10-06 10:40:00,55,75,38,168,1008
2016-10-06 10:50:00,59,88,52,199,1194
2016-10-06 11:00:00,58,58,70,186,1116
2016-10-06 11:10:00,54,75,63,192,1152
2016-10-06 11:20:00,63,71,72,206,1236
2016-10-06 11:30:00,63,80,77,220,1320
2016-10-06 11:40:00,71,92,69,232,1392
2016-10-06 11:50:00,68,82,47,197,1182
2016-10-06 12:00:00,62,80,50,192,1152
2016-10-06 12:10:00,54,78,65,197,1182
2016-10-06 12:20:00,54,53,64,171,1026
2016-10-06 12:30:00,60,63,77,200,1200
2016-10-06 12:40:00,51,51,68,170,1020
2016-10-06 12:50:00,60,66,62,188,1128
2016-10-06 13:00:00,93,108,98,299,1794
2016-10-06 13:10:00,73,95,75,243,1458
2016-10-06 13:20:00,72,96,81,249,1494
2016-10-06 13:30:00,97,123,100,320,1920
2016-10-06 13:40:00,187,239,56,482,2892
2016-10-06 13:50:00,99,136,110,345,2070
2016-10-06 14:00:00,91,107,103,301,1806
2016-10-06 14:10:00,84,98,93,275,1650
2016-10-06 14:20:00,80,113,78,271,1626
2016-10-06 14:30:00,68,93,68,229,1374
2016-10-06 14:40:00,83,99,49,231,1386
2016-10-06 14:50:00,69,78,55,202,1212
2016-10-06 15:00:00,63,78,54,195,1170
2016-10-06 15:10:00,67,87,65,219,1314
2016-10-06 15:20:00,38,68,38,144,864
2016-10-06 15:30:00,44,65,35,144,864
2016-10-06 15:40:00,54,60,54,168,1008
2016-10-06 15:50:00,44,66,42,152,912
2016-10-06 16:00:00,38,83,40,161,966
2016-10-06 16:10:00,61,82,53,196,1176
2016-10-06 16:20:00,55,59,51,165,990
2016-10-06 16:30:00,51,61,44,156,936
2016-10-06 16:40:00,60,75,69,204,1224
2016-10-06 16:50:00,38,63,42,143,858
2016-10-06 17:00:00,21,84,22,127,762
2016-10-06 17:10:00,34,55,33,122,732
2016-10-06 17:20:00,44,29,15,88,528
2016-10-06 17:30:00,19,30,22,71,426
2016-10-06 17:40:00,14,21,14,49,294
2016-10-06 17:50:00,8,16,7,31,186
2016-10-06 18:00:00,4,12,3,19,114
2016-10-06 18:10:00,2,5,1,8,48
2016-10-06 18:20:00,0,0,0,0,0
2016-10-06 18:30:00,0,0,0,0,0
2016-10-06 18:40:00,0,0,0,0,0
2016-10-07 07:00:00,0,0,0,0,0
2016-10-07 07:10:00,0,0,0,0,0
2016-10-07 07:20:00,0,0,0,0,0
2016-10-07 07:30:00,0,0,0,0,0
2016-10-07 07:40:00,0,0,0,0,0
2016-10-07 07:50:00,2,2,2,6,36
2016-10-07 08:00:00,9,9,5,23,138
2016-10-07 08:10:00,12,19,18,49,294
2016-10-07 08:20:00,19,30,28,77,462
2016-10-07 08:30:00,27,42,31,100,600
2016-10-07 08:40:00,28,43,32,103,618
2016-10-07 08:50:00,33,53,44,130,780
2016-10-07 09:00:00,25,45,32,102,612
2016-10-07 09:10:00,29,61,30,120,720
2016-10-07 09:20:00,49,60,48,157,942
2016-10-07 09:30:00,23,52,27,102,612
2016-10-07 09:40:00,22,37,27,86,516
2016-10-07 09:50:00,52,49,59,160,960
2016-10-07 10:00:00,45,47,56,148,888
2016-10-07 10:10:00,43,58,37,138,828
2016-10-07 10:20:00,47,49,42,138,828
2016-10-07 10:30:00,34,57,38,129,774
2016-10-07 10:40:00,49,65,57,171,1026
2016-10-07 10:50:00,64,79,73,216,1296
2016-10-07 11:00:00,68,101,96,265,1590
2016-10-07 11:10:00,63,92,82,237,1422
2016-10-07 11:20:00,66,106,96,268,1608
2016-10-07 11:30:00,103,93,125,321,1926
2016-10-07 11:40:00,100,85,107,292,1752
2016-10-07 11:50:00,121,156,113,390,2340
2016-10-07 12:00:00,75,124,134,333,1998
2016-10-07 12:10:00,97,98,105,300,1800
2016-10-07 12:20:00,75,90,85,250,1500
2016-10-07 12:30:00,61,88,77,226,1356
2016-10-07 12:40:00,99,116,104,319,1914
2016-10-07 12:50:00,153,167,170,490,2940
2016-10-07 13:00:00,197,219,216,632,3792
2016-10-07 13:10:00,608,629,626,1863,11178
2016-10-07 13:20:00,491,513,508,1512,9072
2016-10-07 13:30:00,181,201,200,582,3492
2016-10-07 13:40:00,129,151,148,428,2568
2016-10-07 13:50:00,315,338,335,988,5928
2016-10-07 14:00:00,189,211,208,608,3648
2016-10-07 14:10:00,307,328,324,959,5754
2016-10-07 14:20:00,315,377,305,997,5982
2016-10-07 14:30:00,140,160,157,457,2742
2016-10-07 14:40:00,139,147,183,469,2814
2016-10-07 14:50:00,219,234,233,686,4116
2016-10-07 15:00:00,216,238,234,688,4128
2016-10-07 15:10:00,146,153,134,433,2598
2016-10-07 15:20:00,99,110,115,324,1944
2016-10-07 15:30:00,93,100,98,291,1746
2016-10-07 15:40:00,156,216,79,451,2706
2016-10-07 15:50:00,77,102,87,266,1596
2016-10-07 16:00:00,76,73,87,236,1416
2016-10-07 16:10:00,93,97,82,272,1632
2016-10-07 16:20:00,53,73,79,205,1230
2016-10-07 16:30:00,61,78,88,227,1362
2016-10-07 16:40:00,67,88,92,247,1482
2016-10-07 16:50:00,47,62,58,167,1002
2016-10-07 17:00:00,30,54,34,118,708
2016-10-07 17:10:00,11,44,31,86,516
2016-10-07 17:20:00,16,31,23,70,420
2016-10-07 17:30:00,12,28,17,57,342
2016-10-07 17:40:00,8,24,9,41,246
2016-10-07 17:50:00,5,14,6,25,150
2016-10-07 18:00:00,2,6,3,11,66
2016-10-07 18:10:00,0,1,0,1,6
2016-10-07 18:20:00,0,0,0,0,0
2016-10-07 18:30:00,0,0,0,0,0
2016-10-07 18:40:00,0,0,0,0,0
2016-10-08 07:00:00,0,0,0,0,0
2016-10-08 07:10:00,0,0,0,0,0
2016-10-08 07:20:00,0,0,0,0,0
2016-10-08 07:30:00,0,0,0,0,0
2016-10-08 07:40:00,2,5,3,10,60
2016-10-08 07:50:00,6,6,5,17,102
2016-10-08 08:00:00,8,11,12,31,186
2016-10-08 08:10:00,5,8,6,19,114
2016-10-08 08:20:00,6,8,6,20,120
2016-10-08 08:30:00,13,14,18,45,270
2016-10-08 08:40:00,36,33,46,115,690
2016-10-08 08:50:00,38,51,58,147,882
2016-10-08 09:00:00,44,69,59,172,1032
2016-10-08 09:10:00,29,53,28,110,660
2016-10-08 09:20:00,49,79,64,192,1152
2016-10-08 09:30:00,30,76,73,179,1074
2016-10-08 09:40:00,116,150,136,402,2412
2016-10-08 09:50:00,49,78,69,196,1176
2016-10-08 10:00:00,119,127,138,384,2304
2016-10-08 10:10:00,128,150,152,430,2580
2016-10-08 10:20:00,88,116,108,312,1872
2016-10-08 10:30:00,88,188,118,394,2364
2016-10-08 10:40:00,184,176,182,542,3252
2016-10-08 10:50:00,190,201,213,604,3624
2016-10-08 11:00:00,347,373,368,1088,6528
2016-10-08 11:10:00,270,297,291,858,5148
2016-10-08 11:20:00,233,258,256,747,4482
2016-10-08 11:30:00,236,273,174,683,4098
2016-10-08 11:40:00,444,461,455,1360,8160
2016-10-08 11:50:00,182,188,200,570,3420
2016-10-08 12:00:00,247,301,199,747,4482
2016-10-08 12:10:00,763,786,779,2328,13968
2016-10-08 12:20:00,570,593,592,1755,10530
2016-10-08 12:30:00,869,892,885,2646,15876
2016-10-08 12:40:00,566,586,584,1736,10416
2016-10-08 12:50:00,389,414,407,1210,7260
2016-10-08 13:00:00,460,488,478,1426,8556
2016-10-08 13:10:00,235,258,252,745,4470
2016-10-08 13:20:00,118,163,157,438,2628
2016-10-08 13:30:00,220,230,235,685,4110
2016-10-08 13:40:00,87,134,160,381,2286
2016-10-08 13:50:00,347,395,420,1162,6972
2016-10-08 14:00:00,260,286,280,826,4956
2016-10-08 14:10:00,236,168,234,638,3828
2016-10-08 14:20:00,244,283,259,786,4716
2016-10-08 14:30:00,178,206,191,575,3450
2016-10-08 14:40:00,212,241,247,700,4200
2016-10-08 14:50:00,162,172,157,491,2946
2016-10-08 15:00:00,187,210,206,603,3618
2016-10-08 15:10:00,136,182,146,464,2784
2016-10-08 15:20:00,91,107,104,302,1812
2016-10-08 15:30:00,90,106,96,292,1752
2016-10-08 15:40:00,79,117,153,349,2094
2016-10-08 15:50:00,45,54,47,146,876
2016-10-08 16:00:00,59,65,76,200,1200
2016-10-08 16:10:00,60,79,74,213,1278
2016-10-08 16:20:00,23,39,25,87,522
2016-10-08 16:30:00,23,55,29,107,642
2016-10-08 16:40:00,24,86,68,178,1068
2016-10-08 16:50:00,24,39,11,74,444
2016-10-08 17:00:00,23,45,18,86,516
2016-10-08 17:10:00,16,25,11,52,312
2016-10-08 17:20:00,7,10,8,25,150
2016-10-08 17:30:00,1,3,1,5,30
2016-10-08 17:40:00,0,0,0,0,0
2016-10-08 17:50:00,0,0,0,0,0
2016-10-08 18:00:00,0,0,0,0,0
2016-10-08 18:10:00,0,0,0,0,0
2016-10-08 18:20:00,0,0,0,0,0
2016-10-08 18:30:00,0,0,0,0,0
2016-10-09 07:20:00,0,0,0,0,0
2016-10-09 07:30:00,0,0,0,0,0
2016-10-09 07:40:00,0,0,0,0,0
2016-10-09 07:50:00,1,2,1,4,24
2016-10-09 08:00:00,1,2,1,4,24
2016-10-09 08:10:00,2,3,2,7,42
2016-10-09 08:20:00,4,7,5,16,96
2016-10-09 08:30:00,8,15,13,36,216
2016-10-09 08:40:00,10,15,13,38,228
2016-10-09 08:50:00,15,22,14,51,306
2016-10-09 09:00:00,25,36,15,76,456
2016-10-09 09:10:00,19,27,20,66,396
2016-10-09 09:20:00,26,41,22,89,534
2016-10-09 09:30:00,36,65,18,119,714
2016-10-09 09:40:00,41,78,56,175,1050
2016-10-09 09:50:00,77,122,112,311,1866
2016-10-09 10:00:00,45,86,77,208,1248
2016-10-09 10:10:00,36,80,52,168,1008
2016-10-09 10:20:00,44,62,54,160,960
2016-10-09 10:30:00,45,79,70,194,1164
2016-10-09 10:40:00,34,54,28,116,696
2016-10-09 10:50:00,47,72,53,172,1032
2016-10-09 11:00:00,48,82,46,176,1056
2016-10-09 11:10:00,70,93,59,222,1332
2016-10-09 11:20:00,50,162,145,357,2142
2016-10-09 11:30:00,55,141,88,284,1704
2016-10-09 11:40:00,92,123,119,334,2004
2016-10-09 11:50:00,197,267,227,691,4146
2016-10-09 12:00:00,216,235,232,683,4098
2016-10-09 12:10:00,198,220,216,634,3804
2016-10-09 12:20:00,178,200,194,572,3432
2016-10-09 12:30:00,116,135,131,382,2292
2016-10-09 12:40:00,20,47,13,80,480
2016-10-09 12:50:00,73,94,74,241,1446
2016-10-09 13:00:00,116,144,132,392,2352
2016-10-09 13:10:00,33,61,40,134,804
2016-10-09 13:20:00,102,155,116,373,2238
2016-10-09 13:30:00,372,396,387,1155,6930
2016-10-09 13:40:00,49,94,75,218,1308
2016-10-09 13:50:00,153,241,215,609,3654
2016-10-09 14:00:00,443,463,453,1359,8154
2016-10-09 14:10:00,105,187,124,416,2496
2016-10-09 14:20:00,171,140,153,464,2784
2016-10-09 14:30:00,299,319,312,930,5580
2016-10-09 14:40:00,55,94,69,218,1308
2016-10-09 14:50:00,124,166,96,386,2316
2016-10-09 15:00:00,44,97,81,222,1332
2016-10-09 15:10:00,37,65,41,143,858
2016-10-09 15:20:00,58,76,58,192,1152
2016-10-09 15:30:00,78,102,81,261,1566
2016-10-09 15:40:00,136,133,112,381,2286
2016-10-09 15:50:00,28,79,28,135,810
2016-10-09 16:00:00,163,111,116,390,2340
2016-10-09 16:10:00,202,161,132,495,2970
2016-10-09 16:20:00,71,102,84,257,1542
2016-10-09 16:30:00,66,101,93,260,1560
2016-10-09 16:40:00,12,30,13,55,330
2016-10-09 16:50:00,17,30,13,60,360
2016-10-09 17:00:00,19,33,9,61,366
2016-10-09 17:10:00,18,27,4,49,294
2016-10-09 17:20:00,5,9,2,16,96
2016-10-09 17:30:00,1,4,2,7,42
2016-10-09 17:40:00,3,6,2,11,66
2016-10-09 17:50:00,2,5,1,8,48
2016-10-09 18:00:00,0,0,0,0,0
2016-10-09 18:10:00,0,0,0,0,0
2016-10-09 18:20:00,0,0,0,0,0
2016-10-09 18:30:00,0,0,0,0,0
2016-10-10 07:00:00,0,0,0,0,0
2016-10-10 07:10:00,0,0,0,0,0
2016-10-10 07:20:00,0,0,0,0,0
2016-10-10 07:30:00,0,0,0,0,0
2016-10-10 07:40:00,0,0,1,1,6
2016-10-10 07:50:00,0,0,0,0,0
2016-10-10 08:00:00,0,0,0,0,0
2016-10-10 08:10:00,5,10,6,21,126
2016-10-10 08:20:00,12,28,16,56,336
2016-10-10 08:30:00,6,19,13,38,228
2016-10-10 08:40:00,5,13,12,30,180
2016-10-10 08:50:00,10,28,9,47,282
2016-10-10 09:00:00,20,55,26,101,606
2016-10-10 09:10:00,44,62,43,149,894
2016-10-10 09:20:00,27,44,20,91,546
2016-10-10 09:30:00,10,15,11,36,216
2016-10-10 09:40:00,32,46,39,117,702
2016-10-10 09:50:00,28,50,29,107,642
2016-10-10 10:00:00,15,45,16,76,456
2016-10-10 10:10:00,40,73,71,184,1104
2016-10-10 10:20:00,20,39,32,91,546
2016-10-10 10:30:00,13,23,20,56,336
2016-10-10 10:40:00,33,48,41,122,732
2016-10-10 10:50:00,14,19,15,48,288
2016-10-10 11:00:00,45,61,33,139,834
2016-10-10 11:10:00,23,38,27,88,528
2016-10-10 11:20:00,28,51,39,118,708
2016-10-10 11:30:00,14,23,20,57,342
2016-10-10 11:40:00,13,26,15,54,324
2016-10-10 11:50:00,14,25,23,62,372
2016-10-10 12:00:00,19,53,35,107,642
2016-10-10 12:10:00,39,78,73,190,1140
2016-10-10 12:20:00,28,47,34,109,654
2016-10-10 12:30:00,50,77,68,195,1170
2016-10-10 12:40:00,30,113,114,257,1542
2016-10-10 12:50:00,56,73,59,188,1128
2016-10-10 13:00:00,38,63,46,147,882
2016-10-10 13:10:00,26,59,44,129,774
2016-10-10 13:20:00,39,69,66,174,1044
2016-10-10 13:30:00,45,73,71,189,1134
2016-10-10 13:40:00,45,73,62,180,1080
2016-10-10 13:50:00,57,80,71,208,1248
2016-10-10 14:00:00,54,76,66,196,1176
2016-10-10 14:10:00,42,72,48,162,972
2016-10-10 14:20:00,21,45,28,94,564
2016-10-10 14:30:00,37,46,46,129,774
2016-10-10 14:40:00,41,58,61,160,960
2016-10-10 14:50:00,26,46,37,109,654
2016-10-10 15:00:00,25,44,28,97,582
2016-10-10 15:10:00,18,27,21,66,396
2016-10-10 15:20:00,17,62,22,101,606
2016-10-10 15:30:00,24,51,31,106,636
2016-10-10 15:40:00,19,45,23,87,522
2016-10-10 15:50:00,14,22,13,49,294
2016-10-10 16:00:00,10,19,9,38,228
2016-10-10 16:10:00,5,10,5,20,120
2016-10-10 16:20:00,1,3,1,5,30
2016-10-10 16:30:00,2,2,1,5,30
2016-10-10 16:40:00,2,2,2,6,36
2016-10-10 16:50:00,2,3,4,9,54
2016-10-10 17:00:00,2,4,6,12,72
2016-10-10 17:10:00,1,1,1,3,18
2016-10-10 17:20:00,1,1,1,3,18
2016-10-10 17:30:00,2,3,3,8,48
2016-10-10 17:40:00,0,0,0,0,0
2016-10-10 17:50:00,0,0,0,0,0
2016-10-10 18:00:00,0,0,0,0,0
2016-10-10 18:10:00,0,0,0,0,0
2016-10-11 07:20:00,0,0,0,0,0
2016-10-11 07:30:00,0,0,0,0,0
2016-10-11 07:40:00,0,0,0,0,0
2016-10-11 07:50:00,0,0,0,0,0
2016-10-11 08:00:00,0,0,0,0,0
2016-10-11 08:10:00,5,8,1,14,84
2016-10-11 08:20:00,11,22,7,40,240
2016-10-11 08:30:00,15,32,11,58,348
2016-10-11 08:40:00,21,45,17,83,498
2016-10-11 08:50:00,35,71,26,132,792
2016-10-11 09:00:00,46,59,47,152,912
2016-10-11 09:10:00,49,69,42,160,960
2016-10-11 09:20:00,55,68,56,179,1074
2016-10-11 09:30:00,58,77,71,206,1236
2016-10-11 09:40:00,53,73,68,194,1164
2016-10-11 09:50:00,74,76,82,232,1392
2016-10-11 10:00:00,64,82,77,223,1338
2016-10-11 10:10:00,23,59,33,115,690
2016-10-11 10:20:00,16,26,15,57,342
2016-10-11 10:30:00,13,19,16,48,288
2016-10-11 10:40:00,20,29,22,71,426
2016-10-11 10:50:00,20,43,50,113,678
2016-10-11 11:00:00,31,60,38,129,774
2016-10-11 11:10:00,25,57,30,112,672
2016-10-11 11:20:00,22,47,22,91,546
2016-10-11 11:30:00,24,61,40,125,750
2016-10-11 11:40:00,28,62,42,132,792
2016-10-11 11:50:00,38,60,52,150,900
2016-10-11 12:00:00,69,88,64,221,1326
2016-10-11 12:10:00,104,126,81,311,1866
2016-10-11 12:20:00,99,119,107,325,1950
2016-10-11 12:30:00,92,124,96,312,1872
2016-10-11 12:40:00,119,144,115,378,2268
2016-10-11 12:50:00,125,140,160,425,2550
2016-10-11 13:00:00,135,123,136,394,2364
2016-10-11 13:10:00,92,120,126,338,2028
2016-10-11 13:20:00,81,104,89,274,1644
2016-10-11 13:30:00,80,104,96,280,1680
2016-10-11 13:40:00,87,52,102,241,1446
2016-10-11 13:50:00,67,77,73,217,1302
2016-10-11 14:00:00,55,75,65,195,1170
2016-10-11 14:10:00,59,76,71,206,1236
2016-10-11 14:20:00,44,64,40,148,888
2016-10-11 14:30:00,39,55,36,130,780
2016-10-11 14:40:00,15,86,17,118,708
2016-10-11 14:50:00,24,52,28,104,624
2016-10-11 15:00:00,19,44,23,86,516
2016-10-11 15:10:00,24,53,23,100,600
2016-10-11 15:20:00,18,64,19,101,606
2016-10-11 15:30:00,16,50,29,95,570
2016-10-11 15:40:00,21,50,25,96,576
2016-10-11 15:50:00,16,50,25,91,546
2016-10-11 16:00:00,12,36,16,64,384
2016-10-11 16:10:00,18,43,20,81,486
2016-10-11 16:20:00,21,48,24,93,558
2016-10-11 16:30:00,18,44,19,81,486
2016-10-11 16:40:00,13,35,14,62,372
2016-10-11 16:50:00,6,28,10,44,264
2016-10-11 17:00:00,10,14,1,25,150
2016-10-11 17:10:00,5,7,1,13,78
2016-10-11 17:20:00,3,5,1,9,54
2016-10-11 17:30:00,0,1,0,1,6
2016-10-11 17:40:00,0,0,0,0,0
2016-10-11 17:50:00,0,0,0,0,0
2016-10-11 18:00:00,0,0,0,0,0
2016-10-11 18:10:00,0,0,0,0,0
2016-10-12 07:10:00,0,0,0,0,0
2016-10-12 07:20:00,0,0,0,0,0
2016-10-12 07:30:00,0,0,0,0,0
2016-10-12 07:40:00,0,0,0,0,0
2016-10-12 07:50:00,0,0,0,0,0
2016-10-12 08:00:00,0,1,0,1,6
2016-10-12 08:10:00,4,7,1,12,72
2016-10-12 08:20:00,10,15,4,29,174
2016-10-12 08:30:00,13,32,11,56,336
2016-10-12 08:40:00,25,56,20,101,606
2016-10-12 08:50:00,38,61,68,167,1002
2016-10-12 09:00:00,66,74,81,221,1326
2016-10-12 09:10:00,162,127,135,424,2544
2016-10-12 09:20:00,189,206,116,511,3066
2016-10-12 09:30:00,188,160,162,510,3060
2016-10-12 09:40:00,191,215,210,616,3696
2016-10-12 09:50:00,211,235,227,673,4038
2016-10-12 10:00:00,180,205,199,584,3504
2016-10-12 10:10:00,201,215,215,631,3786
2016-10-12 10:20:00,238,241,243,722,4332
2016-10-12 10:30:00,223,249,242,714,4284
2016-10-12 10:40:00,216,241,234,691,4146
2016-10-12 10:50:00,185,229,180,594,3564
2016-10-12 11:00:00,162,250,63,475,2850
2016-10-12 11:10:00,108,121,114,343,2058
2016-10-12 11:20:00,99,116,109,324,1944
2016-10-12 11:30:00,93,130,130,353,2118
2016-10-12 11:40:00,117,137,148,402,2412
2016-10-12 11:50:00,156,174,141,471,2826
2016-10-12 12:00:00,177,193,193,563,3378
2016-10-12 12:10:00,78,194,195,467,2802
2016-10-12 12:20:00,116,208,122,446,2676
2016-10-12 12:30:00,230,173,155,558,3348
2016-10-12 12:40:00,224,195,181,600,3600
2016-10-12 12:50:00,229,251,224,704,4224
2016-10-12 13:00:00,238,260,254,752,4512
2016-10-12 13:10:00,195,216,212,623,3738
2016-10-12 13:20:00,117,148,152,417,2502
2016-10-12 13:30:00,123,126,141,390,2340
2016-10-12 13:40:00,217,262,173,652,3912
2016-10-12 13:50:00,828,861,842,2531,15186
2016-10-12 14:00:00,170,191,188,549,3294
2016-10-12 14:10:00,254,251,244,749,4494
2016-10-12 14:20:00,208,170,195,573,3438
2016-10-12 14:30:00,201,220,224,645,3870
2016-10-12 14:40:00,281,168,159,608,3648
2016-10-12 14:50:00,217,253,238,708,4248
2016-10-12 15:00:00,140,163,155,458,2748
2016-10-12 15:10:00,110,212,113,435,2610
2016-10-12 15:20:00,104,135,134,373,2238
2016-10-12 15:30:00,37,156,151,344,2064
2016-10-12 15:40:00,77,237,92,406,2436
2016-10-12 15:50:00,19,78,57,154,924
2016-10-12 16:00:00,19,68,33,120,720
2016-10-12 16:10:00,21,71,61,153,918
2016-10-12 16:20:00,12,85,65,162,972
2016-10-12 16:30:00,15,79,56,150,900
2016-10-12 16:40:00,18,61,26,105,630
2016-10-12 16:50:00,17,58,29,104,624
2016-10-12 17:00:00,14,25,9,48,288
2016-10-12 17:10:00,3,5,1,9,54
2016-10-12 17:20:00,0,0,0,0,0
2016-10-12 17:30:00,0,0,0,0,0
2016-10-12 17:40:00,0,0,0,0,0
2016-10-12 17:50:00,0,0,0,0,0
2016-10-12 18:00:00,0,0,0,0,0
2016-10-12 18:10:00,0,0,0,0,0
2016-10-12 18:20:00,0,0,0,0,0
2016-10-13 07:10:00,0,0,0,0,0
2016-10-13 07:20:00,0,0,0,0,0
2016-10-13 07:30:00,0,0,0,0,0
2016-10-13 07:40:00,0,0,0,0,0
2016-10-13 07:50:00,0,1,0,1,6
2016-10-13 08:00:00,2,3,0,5,30
2016-10-13 08:10:00,8,11,1,20,120
2016-10-13 08:20:00,7,10,2,19,114
2016-10-13 08:30:00,8,14,4,26,156
2016-10-13 08:40:00,10,23,8,41,246
2016-10-13 08:50:00,22,32,21,75,450
2016-10-13 09:00:00,50,58,45,153,918
2016-10-13 09:10:00,61,78,65,204,1224
2016-10-13 09:20:00,78,87,77,242,1452
2016-10-13 09:30:00,62,81,74,217,1302
2016-10-13 09:40:00,92,87,85,264,1584
2016-10-13 09:50:00,116,126,100,342,2052
2016-10-13 10:00:00,160,116,155,431,2586
2016-10-13 10:10:00,154,108,170,432,2592
2016-10-13 10:20:00,168,257,78,503,3018
2016-10-13 10:30:00,268,293,284,845,5070
2016-10-13 10:40:00,215,237,233,685,4110
2016-10-13 10:50:00,228,186,200,614,3684
2016-10-13 11:00:00,202,224,219,645,3870
2016-10-13 11:10:00,195,224,224,643,3858
2016-10-13 11:20:00,224,247,243,714,4284
2016-10-13 11:30:00,289,316,310,915,5490
2016-10-13 11:40:00,332,355,352,1039,6234
2016-10-13 11:50:00,302,323,317,942,5652
2016-10-13 12:00:00,295,318,312,925,5550
2016-10-13 12:10:00,285,306,301,892,5352
2016-10-13 12:20:00,248,255,213,716,4296
2016-10-13 12:30:00,547,568,566,1681,10086
2016-10-13 12:40:00,351,373,368,1092,6552
2016-10-13 12:50:00,152,188,229,569,3414
2016-10-13 13:00:00,175,173,194,542,3252
2016-10-13 13:10:00,163,186,183,532,3192
2016-10-13 13:20:00,230,180,203,613,3678
2016-10-13 13:30:00,178,289,34,501,3006
2016-10-13 13:40:00,220,253,233,706,4236
2016-10-13 13:50:00,159,153,198,510,3060
2016-10-13 14:00:00,127,92,144,363,2178
2016-10-13 14:10:00,187,199,209,595,3570
2016-10-13 14:20:00,210,176,198,584,3504
2016-10-13 14:30:00,121,154,117,392,2352
2016-10-13 14:40:00,163,159,173,495,2970
2016-10-13 14:50:00,296,314,302,912,5472
2016-10-13 15:00:00,475,492,474,1441,8646
2016-10-13 15:10:00,425,444,429,1298,7788
2016-10-13 15:20:00,316,337,326,979,5874
2016-10-13 15:30:00,259,278,267,804,4824
2016-10-13 15:40:00,160,171,168,499,2994
2016-10-13 15:50:00,70,142,133,345,2070
2016-10-13 16:00:00,89,166,103,358,2148
2016-10-13 16:10:00,168,232,80,480,2880
2016-10-13 16:20:00,81,167,97,345,2070
2016-10-13 16:30:00,1,147,141,289,1734
2016-10-13 16:40:00,62,130,103,295,1770
2016-10-13 16:50:00,53,68,37,158,948
2016-10-13 17:00:00,32,73,34,139,834
2016-10-13 17:10:00,35,67,26,128,768
2016-10-13 17:20:00,27,60,21,108,648
2016-10-13 17:30:00,27,45,11,83,498
2016-10-13 17:40:00,23,29,2,54,324
2016-10-13 17:50:00,8,11,0,19,114
2016-10-13 18:00:00,0,0,0,0,0
2016-10-13 18:10:00,0,0,0,0,0
2016-10-13 18:20:00,0,0,0,0,0
2016-10-14 07:10:00,0,0,0,0,0
2016-10-14 07:20:00,0,0,0,0,0
2016-10-14 07:30:00,0,0,0,0,0
2016-10-14 07:40:00,2,4,1,7,42
2016-10-14 07:50:00,9,15,4,28,168
2016-10-14 08:00:00,10,23,8,41,246
2016-10-14 08:10:00,14,22,6,42,252
2016-10-14 08:20:00,14,17,8,39,234
2016-10-14 08:30:00,16,21,3,40,240
2016-10-14 08:40:00,16,22,4,42,252
2016-10-14 08:50:00,23,31,9,63,378
2016-10-14 09:00:00,31,41,13,85,510
2016-10-14 09:10:00,36,57,26,119,714
2016-10-14 09:20:00,40,55,36,131,786
2016-10-14 09:30:00,43,55,36,134,804
2016-10-14 09:40:00,48,55,43,146,876
2016-10-14 09:50:00,61,84,65,210,1260
2016-10-14 10:00:00,32,58,27,117,702
2016-10-14 10:10:00,26,50,14,90,540
2016-10-14 10:20:00,43,67,47,157,942
2016-10-14 10:30:00,78,105,89,272,1632
2016-10-14 10:40:00,81,114,125,320,1920
2016-10-14 10:50:00,63,47,77,187,1122
2016-10-14 11:00:00,56,71,69,196,1176
2016-10-14 11:10:00,74,88,88,250,1500
2016-10-14 11:20:00,106,127,92,325,1950
2016-10-14 11:30:00,177,207,95,479,2874
2016-10-14 11:40:00,304,319,317,940,5640
2016-10-14 11:50:00,319,337,334,990,5940
2016-10-14 12:00:00,228,246,245,719,4314
2016-10-14 12:10:00,224,250,211,685,4110
2016-10-14 12:20:00,315,338,338,991,5946
2016-10-14 12:30:00,215,237,237,689,4134
2016-10-14 12:40:00,533,553,554,1640,9840
2016-10-14 12:50:00,432,449,447,1328,7968
2016-10-14 13:00:00,392,412,405,1209,7254
2016-10-14 13:10:00,391,411,405,1207,7242
2016-10-14 13:20:00,523,537,540,1600,9600
2016-10-14 13:30:00,461,479,486,1426,8556
2016-10-14 13:40:00,764,787,790,2341,14046
2016-10-14 13:50:00,389,409,402,1200,7200
2016-10-14 14:00:00,263,281,277,821,4926
2016-10-14 14:10:00,190,210,206,606,3636
2016-10-14 14:20:00,127,138,147,412,2472
2016-10-14 14:30:00,296,131,182,609,3654
2016-10-14 14:40:00,217,238,205,660,3960
2016-10-14 14:50:00,244,268,260,772,4632
2016-10-14 15:00:00,308,331,324,963,5778
2016-10-14 15:10:00,488,508,500,1496,8976
2016-10-14 15:20:00,145,162,126,433,2598
2016-10-14 15:30:00,62,87,74,223,1338
2016-10-14 15:40:00,45,96,77,218,1308
2016-10-14 15:50:00,81,168,114,363,2178
2016-10-14 16:00:00,90,114,109,313,1878
2016-10-14 16:10:00,52,103,145,300,1800
2016-10-14 16:20:00,57,99,88,244,1464
2016-10-14 16:30:00,44,100,82,226,1356
2016-10-14 16:40:00,25,80,56,161,966
2016-10-14 16:50:00,32,60,15,107,642
2016-10-14 17:00:00,21,32,11,64,384
2016-10-14 17:10:00,7,22,7,36,216
2016-10-14 17:20:00,6,16,5,27,162
2016-10-14 17:30:00,4,7,1,12,72
2016-10-14 17:40:00,1,4,0,5,30
2016-10-14 17:50:00,0,0,0,0,0
2016-10-14 18:00:00,0,0,0,0,0
2016-10-14 18:10:00,0,0,0,0,0
2016-10-14 18:20:00,0,0,0,0,0
2016-10-15 07:20:00,0,0,0,0,0
2016-10-15 07:30:00,0,0,0,0,0
2016-10-15 07:40:00,0,0,0,0,0
2016-10-15 07:50:00,0,0,0,0,0
2016-10-15 08:00:00,3,3,1,7,42
2016-10-15 08:10:00,7,7,1,15,90
2016-10-15 08:20:00,7,8,2,17,102
2016-10-15 08:30:00,7,16,4,27,162
2016-10-15 08:40:00,10,24,8,42,252
2016-10-15 08:50:00,14,41,19,74,444
2016-10-15 09:00:00,20,44,21,85,510
2016-10-15 09:10:00,21,43,14,78,468
2016-10-15 09:20:00,16,47,16,79,474
2016-10-15 09:30:00,16,49,26,91,546
2016-10-15 09:40:00,19,53,33,105,630
2016-10-15 09:50:00,29,63,38,130,780
2016-10-15 10:00:00,23,69,39,131,786
2016-10-15 10:10:00,7,92,83,182,1092
2016-10-15 10:20:00,31,106,91,228,1368
2016-10-15 10:30:00,58,83,86,227,1362
2016-10-15 10:40:00,21,98,87,206,1236
2016-10-15 10:50:00,23,120,117,260,1560
2016-10-15 11:00:00,29,113,102,244,1464
2016-10-15 11:10:00,10,133,131,274,1644
2016-10-15 11:20:00,31,110,106,247,1482
2016-10-15 11:30:00,19,95,75,189,1134
2016-10-15 11:40:00,19,84,64,167,1002
2016-10-15 11:50:00,42,79,75,196,1176
2016-10-15 12:00:00,65,85,77,227,1362
2016-10-15 12:10:00,60,123,114,297,1782
2016-10-15 12:20:00,63,57,79,199,1194
2016-10-15 12:30:00,31,69,71,171,1026
2016-10-15 12:40:00,17,137,136,290,1740
2016-10-15 12:50:00,24,139,137,300,1800
2016-10-15 13:00:00,30,129,136,295,1770
2016-10-15 13:10:00,65,89,86,240,1440
2016-10-15 13:20:00,92,119,81,292,1752
2016-10-15 13:30:00,109,115,141,365,2190
2016-10-15 13:40:00,76,133,144,353,2118
2016-10-15 13:50:00,132,20,136,288,1728
2016-10-15 14:00:00,45,107,102,254,1524
2016-10-15 14:10:00,51,87,73,211,1266
2016-10-15 14:20:00,56,92,77,225,1350
2016-10-15 14:30:00,52,88,54,194,1164
2016-10-15 14:40:00,40,84,69,193,1158
2016-10-15 14:50:00,17,93,80,190,1140
2016-10-15 15:00:00,38,79,43,160,960
2016-10-15 15:10:00,52,83,33,168,1008
2016-10-15 15:20:00,52,81,29,162,972
2016-10-15 15:30:00,32,66,36,134,804
2016-10-15 15:40:00,30,46,11,87,522
2016-10-15 15:50:00,20,30,3,53,318
2016-10-15 16:00:00,22,31,4,57,342
2016-10-15 16:10:00,13,22,6,41,246
2016-10-15 16:20:00,12,18,2,32,192
2016-10-15 16:30:00,8,8,1,17,102
2016-10-15 16:40:00,7,3,0,10,60
2016-10-15 16:50:00,4,6,1,11,66
2016-10-15 17:00:00,0,0,0,0,0
2016-10-15 17:10:00,0,0,0,0,0
2016-10-15 17:20:00,0,0,0,0,0
2016-10-15 17:30:00,0,0,0,0,0
2016-10-15 17:40:00,0,0,0,0,0
2016-10-15 17:50:00,0,0,0,0,0
2016-10-16 07:30:00,0,0,0,0,0
2016-10-16 07:40:00,0,0,0,0,0
2016-10-16 07:50:00,0,0,0,0,0
2016-10-16 08:00:00,0,0,0,0,0
2016-10-16 08:10:00,0,0,0,0,0
2016-10-16 08:20:00,0,0,0,0,0
2016-10-16 08:30:00,0,0,0,0,0
2016-10-16 08:40:00,0,0,0,0,0
2016-10-16 08:50:00,0,0,0,0,0
2016-10-16 09:00:00,0,0,0,0,0
2016-10-16 09:10:00,0,0,0,0,0
2016-10-16 09:20:00,0,0,0,0,0
2016-10-16 09:30:00,0,0,0,0,0
2016-10-16 09:40:00,2,5,0,7,42
2016-10-16 09:50:00,5,16,3,24,144
2016-10-16 10:00:00,12,23,7,42,252
2016-10-16 10:10:00,14,21,7,42,252
2016-10-16 10:20:00,8,19,4,31,186
2016-10-16 10:30:00,7,28,12,47,282
2016-10-16 10:40:00,5,34,17,56,336
2016-10-16 10:50:00,7,27,10,44,264
2016-10-16 11:00:00,8,18,4,30,180
2016-10-16 11:10:00,8,20,5,33,198
2016-10-16 11:20:00,16,36,11,63,378
2016-10-16 11:30:00,25,49,20,94,564
2016-10-16 11:40:00,27,49,17,93,558
2016-10-16 11:50:00,20,38,15,73,438
2016-10-16 12:00:00,17,35,9,61,366
2016-10-16 12:10:00,18,26,12,56,336
2016-10-16 12:20:00,16,34,10,60,360
2016-10-16 12:30:00,14,42,19,75,450
2016-10-16 12:40:00,11,44,25,80,480
2016-10-16 12:50:00,10,50,27,87,522
2016-10-16 13:00:00,28,48,16,92,552
2016-10-16 13:10:00,17,47,23,87,522
2016-10-16 13:20:00,9,42,22,73,438
2016-10-16 13:30:00,9,36,17,62,372
2016-10-16 13:40:00,8,30,15,53,318
2016-10-16 13:50:00,6,31,14,51,306
2016-10-16 14:00:00,9,32,11,52,312
2016-10-16 14:10:00,11,31,11,53,318
2016-10-16 14:20:00,13,27,9,49,294
2016-10-16 14:30:00,15,32,11,58,348
2016-10-16 14:40:00,10,48,30,88,528
2016-10-16 14:50:00,14,43,18,75,450
2016-10-16 15:00:00,12,42,20,74,444
2016-10-16 15:10:00,9,30,12,51,306
2016-10-16 15:20:00,7,23,7,37,222
2016-10-16 15:30:00,6,23,5,34,204
2016-10-16 15:40:00,8,17,4,29,174
2016-10-16 15:50:00,8,18,3,29,174
2016-10-16 16:00:00,5,19,3,27,162
2016-10-16 16:10:00,7,15,3,25,150
2016-10-16 16:20:00,4,16,3,23,138
2016-10-16 16:30:00,3,10,1,14,84
2016-10-16 16:40:00,1,4,0,5,30
2016-10-16 16:50:00,1,3,0,4,24
2016-10-16 17:00:00,0,1,0,1,6
2016-10-16 17:10:00,0,0,0,0,0
2016-10-16 17:20:00,0,0,0,0,0
2016-10-16 17:30:00,0,0,0,0,0
2016-10-16 17:40:00,0,0,0,0,0
2016-10-16 17:50:00,0,0,0,0,0
2016-10-16 18:00:00,0,0,0,0,0
2016-10-17 07:30:00,0,0,0,0,0
2016-10-17 07:40:00,0,0,0,0,0
2016-10-17 07:50:00,0,0,0,0,0
2016-10-17 08:00:00,0,0,0,0,0
2016-10-17 08:10:00,0,0,0,0,0
2016-10-17 08:20:00,0,0,0,0,0
2016-10-17 08:30:00,2,3,1,6,36
2016-10-17 08:40:00,3,5,4,12,72
2016-10-17 08:50:00,6,9,9,24,144
2016-10-17 09:00:00,8,13,12,33,198
2016-10-17 09:10:00,10,14,16,40,240
2016-10-17 09:20:00,13,25,19,57,342
2016-10-17 09:30:00,11,14,14,39,234
2016-10-17 09:40:00,11,22,14,47,282
2016-10-17 09:50:00,20,33,14,67,402
2016-10-17 10:00:00,21,34,13,68,408
2016-10-17 10:10:00,22,37,8,67,402
2016-10-17 10:20:00,19,34,12,65,390
2016-10-17 10:30:00,31,55,32,118,708
2016-10-17 10:40:00,27,57,35,119,714
2016-10-17 10:50:00,46,77,52,175,1050
2016-10-17 11:00:00,43,62,45,150,900
2016-10-17 11:10:00,63,61,78,202,1212
2016-10-17 11:20:00,63,73,62,198,1188
2016-10-17 11:30:00,78,100,73,251,1506
2016-10-17 11:40:00,62,79,81,222,1332
2016-10-17 11:50:00,38,83,79,200,1200
2016-10-17 12:00:00,100,116,131,347,2082
2016-10-17 12:10:00,59,87,90,236,1416
2016-10-17 12:20:00,50,58,55,163,978
2016-10-17 12:30:00,34,56,39,129,774
2016-10-17 12:40:00,48,64,58,170,1020
2016-10-17 12:50:00,47,64,46,157,942
2016-10-17 13:00:00,61,76,28,165,990
2016-10-17 13:10:00,49,62,30,141,846
2016-10-17 13:20:00,59,78,43,180,1080
2016-10-17 13:30:00,58,73,38,169,1014
2016-10-17 13:40:00,53,63,48,164,984
2016-10-17 13:50:00,54,70,40,164,984
2016-10-17 14:00:00,82,95,46,223,1338
2016-10-17 14:10:00,63,72,51,186,1116
2016-10-17 14:20:00,53,68,62,183,1098
2016-10-17 14:30:00,54,69,64,187,1122
2016-10-17 14:40:00,37,60,54,151,906
2016-10-17 14:50:00,21,58,31,110,660
2016-10-17 15:00:00,15,37,14,66,396
2016-10-17 15:10:00,18,38,14,70,420
2016-10-17 15:20:00,11,54,36,101,606
2016-10-17 15:30:00,23,66,55,144,864
2016-10-17 15:40:00,7,41,19,67,402
2016-10-17 15:50:00,15,41,16,72,432
2016-10-17 16:00:00,13,39,13,65,390
2016-10-17 16:10:00,21,68,45,134,804
2016-10-17 16:20:00,10,22,8,40,240
2016-10-17 16:30:00,15,28,12,55,330
2016-10-17 16:40:00,11,22,12,45,270
2016-10-17 16:50:00,1,2,0,3,18
2016-10-17 17:00:00,0,0,0,0,0
2016-10-17 17:10:00,0,0,0,0,0
2016-10-17 17:20:00,0,0,0,0,0
2016-10-17 17:30:00,0,0,0,0,0
2016-10-17 17:40:00,0,0,0,0,0
2016-10-17 17:50:00,0,0,0,0,0
2016-10-18 07:30:00,0,0,0,0,0
2016-10-18 07:40:00,0,0,0,0,0
2016-10-18 07:50:00,0,0,0,0,0
2016-10-18 08:00:00,0,0,0,0,0
2016-10-18 08:10:00,0,0,0,0,0
2016-10-18 08:20:00,0,0,0,0,0
2016-10-18 08:30:00,0,0,0,0,0
2016-10-18 08:40:00,2,3,0,5,30
2016-10-18 08:50:00,3,6,2,11,66
2016-10-18 09:00:00,8,13,4,25,150
2016-10-18 09:10:00,15,21,5,41,246
2016-10-18 09:20:00,28,39,10,77,462
2016-10-18 09:30:00,18,29,12,59,354
2016-10-18 09:40:00,15,24,20,59,354
2016-10-18 09:50:00,21,50,31,102,612
2016-10-18 10:00:00,18,43,22,83,498
2016-10-18 10:10:00,11,36,16,63,378
2016-10-18 10:20:00,9,43,22,74,444
2016-10-18 10:30:00,16,51,33,100,600
2016-10-18 10:40:00,31,55,46,132,792
2016-10-18 10:50:00,44,80,65,189,1134
2016-10-18 11:00:00,30,63,37,130,780
2016-10-18 11:10:00,21,45,24,90,540
2016-10-18 11:20:00,24,61,33,118,708
2016-10-18 11:30:00,33,99,106,238,1428
2016-10-18 11:40:00,86,97,109,292,1752
2016-10-18 11:50:00,114,86,133,333,1998
2016-10-18 12:00:00,89,107,95,291,1746
2016-10-18 12:10:00,42,81,49,172,1032
2016-10-18 12:20:00,37,66,37,140,840
2016-10-18 12:30:00,22,33,17,72,432
2016-10-18 12:40:00,37,48,34,119,714
2016-10-18 12:50:00,35,56,46,137,822
2016-10-18 13:00:00,30,43,34,107,642
2016-10-18 13:10:00,12,21,11,44,264
2016-10-18 13:20:00,21,48,19,88,528
2016-10-18 13:30:00,44,76,52,172,1032
2016-10-18 13:40:00,66,94,77,237,1422
2016-10-18 13:50:00,25,62,26,113,678
2016-10-18 14:00:00,33,55,16,104,624
2016-10-18 14:10:00,30,50,27,107,642
2016-10-18 14:20:00,63,78,90,231,1386
2016-10-18 14:30:00,94,61,107,262,1572
2016-10-18 14:40:00,32,52,49,133,798
2016-10-18 14:50:00,15,64,25,104,624
2016-10-18 15:00:00,27,68,43,138,828
2016-10-18 15:10:00,7,83,63,153,918
2016-10-18 15:20:00,14,106,83,203,1218
2016-10-18 15:30:00,20,72,43,135,810
2016-10-18 15:40:00,18,49,26,93,558
2016-10-18 15:50:00,23,35,31,89,534
2016-10-18 16:00:00,13,25,13,51,306
2016-10-18 16:10:00,13,22,12,47,282
2016-10-18 16:20:00,1,2,1,4,24
2016-10-18 16:30:00,3,7,3,13,78
2016-10-18 16:40:00,8,20,7,35,210
2016-10-18 16:50:00,4,11,1,16,96
2016-10-18 17:00:00,0,4,0,4,24
2016-10-18 17:10:00,2,4,0,6,36
2016-10-18 17:20:00,5,15,1,21,126
2016-10-18 17:30:00,2,8,0,10,60
2016-10-18 17:40:00,0,0,0,0,0
2016-10-18 17:50:00,0,0,0,0,0
2016-10-18 18:00:00,0,0,0,0,0
2016-10-19 07:30:00,0,0,0,0,0
2016-10-19 07:40:00,0,0,0,0,0
2016-10-19 07:50:00,0,0,0,0,0
2016-10-19 08:00:00,0,0,0,0,0
2016-10-19 08:10:00,0,0,0,0,0
2016-10-19 08:20:00,0,1,0,1,6
2016-10-19 08:30:00,4,8,0,12,72
2016-10-19 08:40:00,3,2,0,5,30
2016-10-19 08:50:00,9,22,12,43,258
2016-10-19 09:00:00,4,15,10,29,174
2016-10-19 09:10:00,2,9,5,16,96
2016-10-19 09:20:00,1,3,1,5,30
2016-10-19 09:30:00,4,6,5,15,90
2016-10-19 09:40:00,9,12,5,26,156
2016-10-19 09:50:00,11,15,6,32,192
2016-10-19 10:00:00,11,17,9,37,222
2016-10-19 10:10:00,19,39,15,73,438
2016-10-19 10:20:00,32,61,38,131,786
2016-10-19 10:30:00,24,59,31,114,684
2016-10-19 10:40:00,45,61,53,159,954
2016-10-19 10:50:00,42,94,81,217,1302
2016-10-19 11:00:00,62,104,96,262,1572
2016-10-19 11:10:00,43,79,72,194,1164
2016-10-19 11:20:00,24,61,22,107,642
2016-10-19 11:30:00,37,61,37,135,810
2016-10-19 11:40:00,37,66,42,145,870
2016-10-19 11:50:00,61,59,74,194,1164
2016-10-19 12:00:00,59,77,84,220,1320
2016-10-19 12:10:00,79,109,104,292,1752
2016-10-19 12:20:00,87,132,124,343,2058
2016-10-19 12:30:00,42,150,151,343,2058
2016-10-19 12:40:00,32,113,100,245,1470
2016-10-19 12:50:00,46,74,67,187,1122
2016-10-19 13:00:00,24,75,50,149,894
2016-10-19 13:10:00,28,85,81,194,1164
2016-10-19 13:20:00,55,84,71,210,1260
2016-10-19 13:30:00,67,117,112,296,1776
2016-10-19 13:40:00,77,97,81,255,1530
2016-10-19 13:50:00,52,77,58,187,1122
2016-10-19 14:00:00,42,66,30,138,828
2016-10-19 14:10:00,38,63,28,129,774
2016-10-19 14:20:00,63,49,56,168,1008
2016-10-19 14:30:00,49,68,33,150,900
2016-10-19 14:40:00,40,47,51,138,828
2016-10-19 14:50:00,10,29,13,52,312
2016-10-19 15:00:00,7,17,4,28,168
2016-10-19 15:10:00,13,34,15,62,372
2016-10-19 15:20:00,14,44,24,82,492
2016-10-19 15:30:00,14,46,24,84,504
2016-10-19 15:40:00,14,42,27,83,498
2016-10-19 15:50:00,12,30,20,62,372
2016-10-19 16:00:00,3,10,1,14,84
2016-10-19 16:10:00,2,5,0,7,42
2016-10-19 16:20:00,9,13,4,26,156
2016-10-19 16:30:00,9,20,7,36,216
2016-10-19 16:40:00,5,10,4,19,114
2016-10-19 16:50:00,0,1,0,1,6
2016-10-19 17:00:00,0,0,0,0,0
2016-10-19 17:10:00,0,0,0,0,0
2016-10-19 17:20:00,0,0,0,0,0
2016-10-19 17:30:00,0,0,0,0,0
2016-10-19 17:40:00,0,0,0,0,0
2016-10-19 17:50:00,0,0,0,0,0
2016-10-20 07:20:00,0,0,0,0,0
2016-10-20 07:30:00,0,0,0,0,0
2016-10-20 07:40:00,0,0,0,0,0
2016-10-20 07:50:00,1,2,0,3,18
2016-10-20 08:00:00,7,12,2,21,126
2016-10-20 08:10:00,5,22,7,34,204
2016-10-20 08:20:00,7,25,8,40,240
2016-10-20 08:30:00,9,44,22,75,450
2016-10-20 08:40:00,21,52,29,102,612
2016-10-20 08:50:00,37,74,77,188,1128
2016-10-20 09:00:00,35,58,51,144,864
2016-10-20 09:10:00,40,69,47,156,936
2016-10-20 09:20:00,68,98,79,245,1470
2016-10-20 09:30:00,60,74,63,197,1182
2016-10-20 09:40:00,87,96,54,237,1422
2016-10-20 09:50:00,133,161,148,442,2652
2016-10-20 10:00:00,212,226,212,650,3900
2016-10-20 10:10:00,470,491,484,1445,8670
2016-10-20 10:20:00,597,609,615,1821,10926
2016-10-20 10:30:00,644,656,656,1956,11736
2016-10-20 10:40:00,688,712,698,2098,12588
2016-10-20 10:50:00,706,727,709,2142,12852
2016-10-20 11:00:00,716,742,728,2186,13116
2016-10-20 11:10:00,737,755,752,2244,13464
2016-10-20 11:20:00,767,786,781,2334,14004
2016-10-20 11:30:00,786,806,800,2392,14352
2016-10-20 11:40:00,767,793,782,2342,14052
2016-10-20 11:50:00,724,750,742,2216,13296
2016-10-20 12:00:00,734,759,753,2246,13476
2016-10-20 12:10:00,775,801,795,2371,14226
2016-10-20 12:20:00,798,833,818,2449,14694
2016-10-20 12:30:00,804,830,824,2458,14748
2016-10-20 12:40:00,816,841,832,2489,14934
2016-10-20 12:50:00,838,856,858,2552,15312
2016-10-20 13:00:00,812,840,838,2490,14940
2016-10-20 13:10:00,749,775,767,2291,13746
2016-10-20 13:20:00,740,767,761,2268,13608
2016-10-20 13:30:00,822,845,846,2513,15078
2016-10-20 13:40:00,684,709,699,2092,12552
2016-10-20 13:50:00,738,765,762,2265,13590
2016-10-20 14:00:00,672,701,697,2070,12420
2016-10-20 14:10:00,627,648,641,1916,11496
2016-10-20 14:20:00,552,573,568,1693,10158
2016-10-20 14:30:00,558,576,574,1708,10248
2016-10-20 14:40:00,502,520,515,1537,9222
2016-10-20 14:50:00,440,457,445,1342,8052
2016-10-20 15:00:00,393,413,396,1202,7212
2016-10-20 15:10:00,349,366,354,1069,6414
2016-10-20 15:20:00,227,247,239,713,4278
2016-10-20 15:30:00,124,179,168,471,2826
2016-10-20 15:40:00,145,201,121,467,2802
2016-10-20 15:50:00,92,134,118,344,2064
2016-10-20 16:00:00,63,65,82,210,1260
2016-10-20 16:10:00,32,63,37,132,792
2016-10-20 16:20:00,23,71,29,123,738
2016-10-20 16:30:00,29,71,20,120,720
2016-10-20 16:40:00,18,50,31,99,594
2016-10-20 16:50:00,15,41,18,74,444
2016-10-20 17:00:00,10,30,16,56,336
2016-10-20 17:10:00,8,21,10,39,234
2016-10-20 17:20:00,8,13,3,24,144
2016-10-20 17:30:00,2,4,0,6,36
2016-10-20 17:40:00,0,0,0,0,0
2016-10-20 17:50:00,0,0,0,0,0
2016-10-20 18:00:00,0,0,0,0,0
2016-10-20 18:10:00,0,0,0,0,0
2016-10-21 07:40:00,0,0,0,0,0
2016-10-21 07:50:00,0,0,0,0,0
2016-10-21 08:00:00,0,0,0,0,0
2016-10-21 08:10:00,0,0,0,0,0
2016-10-21 08:20:00,1,1,0,2,12
2016-10-21 08:30:00,4,5,2,11,66
2016-10-21 08:40:00,7,11,4,22,132
2016-10-21 08:50:00,8,12,7,27,162
2016-10-21 09:00:00,8,13,9,30,180
2016-10-21 09:10:00,18,38,16,72,432
2016-10-21 09:20:00,22,38,9,69,414
2016-10-21 09:30:00,8,10,7,25,150
2016-10-21 09:40:00,11,21,4,36,216
2016-10-21 09:50:00,15,29,7,51,306
2016-10-21 10:00:00,25,55,18,98,588
2016-10-21 10:10:00,35,53,32,120,720
2016-10-21 10:20:00,22,31,16,69,414
2016-10-21 10:30:00,23,33,17,73,438
2016-10-21 10:40:00,20,26,16,62,372
2016-10-21 10:50:00,25,49,15,89,534
2016-10-21 11:00:00,19,35,12,66,396
2016-10-21 11:10:00,22,51,32,105,630
2016-10-21 11:20:00,20,40,22,82,492
2016-10-21 11:30:00,41,64,33,138,828
2016-10-21 11:40:00,33,46,15,94,564
2016-10-21 11:50:00,28,40,9,77,462
2016-10-21 12:00:00,45,78,30,153,918
2016-10-21 12:10:00,45,73,32,150,900
2016-10-21 12:20:00,71,97,73,241,1446
2016-10-21 12:30:00,62,80,49,191,1146
2016-10-21 12:40:00,60,50,30,140,840
2016-10-21 12:50:00,48,77,51,176,1056
2016-10-21 13:00:00,32,65,32,129,774
2016-10-21 13:10:00,50,51,48,149,894
2016-10-21 13:20:00,37,57,27,121,726
2016-10-21 13:30:00,55,65,27,147,882
2016-10-21 13:40:00,35,46,27,108,648
2016-10-21 13:50:00,56,75,31,162,972
2016-10-21 14:00:00,65,85,69,219,1314
2016-10-21 14:10:00,48,87,51,186,1116
2016-10-21 14:20:00,33,90,72,195,1170
2016-10-21 14:30:00,30,132,116,278,1668
2016-10-21 14:40:00,15,130,122,267,1602
2016-10-21 14:50:00,36,98,68,202,1212
2016-10-21 15:00:00,27,52,16,95,570
2016-10-21 15:10:00,18,38,9,65,390
2016-10-21 15:20:00,17,24,5,46,276
2016-10-21 15:30:00,18,29,5,52,312
2016-10-21 15:40:00,16,22,4,42,252
2016-10-21 15:50:00,8,14,1,23,138
2016-10-21 16:00:00,4,8,0,12,72
2016-10-21 16:10:00,1,4,1,6,36
2016-10-21 16:20:00,1,1,0,2,12
2016-10-21 16:30:00,0,0,0,0,0
2016-10-21 16:40:00,0,0,0,0,0
2016-10-21 16:50:00,0,0,0,0,0
2016-10-21 17:00:00,0,0,0,0,0
2016-10-21 17:10:00,0,0,0,0,0
2016-10-21 17:20:00,0,0,0,0,0
2016-10-21 17:30:00,0,0,0,0,0
2016-10-22 07:40:00,0,0,0,0,0
2016-10-22 07:50:00,0,0,0,0,0
2016-10-22 08:00:00,0,0,0,0,0
2016-10-22 08:10:00,0,0,0,0,0
2016-10-22 08:20:00,0,0,0,0,0
2016-10-22 08:30:00,0,0,0,0,0
2016-10-22 08:40:00,0,0,0,0,0
2016-10-22 08:50:00,0,0,0,0,0
2016-10-22 09:00:00,1,3,0,4,24
2016-10-22 09:10:00,8,13,1,22,132
2016-10-22 09:20:00,12,19,4,35,210
2016-10-22 09:30:00,37,45,7,89,534
2016-10-22 09:40:00,29,49,16,94,564
2016-10-22 09:50:00,24,32,6,62,372
2016-10-22 10:00:00,25,44,15,84,504
2016-10-22 10:10:00,29,37,2,68,408
2016-10-22 10:20:00,28,42,9,79,474
2016-10-22 10:30:00,32,62,23,117,702
2016-10-22 10:40:00,27,58,17,102,612
2016-10-22 10:50:00,26,52,20,98,588
2016-10-22 11:00:00,27,42,11,80,480
2016-10-22 11:10:00,18,78,49,145,870
2016-10-22 11:20:00,27,113,93,233,1398
2016-10-22 11:30:00,67,147,101,315,1890
2016-10-22 11:40:00,63,152,122,337,2022
2016-10-22 11:50:00,109,169,126,404,2424
2016-10-22 12:00:00,55,124,121,300,1800
2016-10-22 12:10:00,41,89,68,198,1188
2016-10-22 12:20:00,36,57,25,118,708
2016-10-22 12:30:00,35,66,21,122,732
2016-10-22 12:40:00,54,80,43,177,1062
2016-10-22 12:50:00,40,66,29,135,810
2016-10-22 13:00:00,15,46,23,84,504
2016-10-22 13:10:00,50,96,52,198,1188
2016-10-22 13:20:00,69,97,85,251,1506
2016-10-22 13:30:00,60,87,70,217,1302
2016-10-22 13:40:00,43,68,28,139,834
2016-10-22 13:50:00,43,68,19,130,780
2016-10-22 14:00:00,41,74,33,148,888
2016-10-22 14:10:00,40,65,24,129,774
2016-10-22 14:20:00,25,38,9,72,432
2016-10-22 14:30:00,13,22,7,42,252
2016-10-22 14:40:00,10,29,19,58,348
2016-10-22 14:50:00,11,29,10,50,300
2016-10-22 15:00:00,16,29,8,53,318
2016-10-22 15:10:00,10,22,7,39,234
2016-10-22 15:20:00,8,16,4,28,168
2016-10-22 15:30:00,10,22,6,38,228
2016-10-22 15:40:00,11,18,5,34,204
2016-10-22 15:50:00,9,11,1,21,126
2016-10-22 16:00:00,5,8,2,15,90
2016-10-22 16:10:00,2,4,0,6,36
2016-10-22 16:20:00,6,9,1,16,96
2016-10-22 16:30:00,7,11,1,19,114
2016-10-22 16:40:00,3,7,1,11,66
2016-10-22 16:50:00,2,5,0,7,42
2016-10-22 17:00:00,2,5,0,7,42
2016-10-22 17:10:00,1,3,0,4,24
2016-10-22 17:20:00,0,0,0,0,0
2016-10-22 17:30:00,0,0,0,0,0
2016-10-22 17:40:00,0,0,0,0,0
2016-10-23 07:40:00,0,0,0,0,0
2016-10-23 07:50:00,0,0,0,0,0
2016-10-23 08:00:00,0,0,0,0,0
2016-10-23 08:10:00,0,0,0,0,0
2016-10-23 08:20:00,0,0,0,0,0
2016-10-23 08:30:00,0,0,0,0,0
2016-10-23 08:40:00,0,2,0,2,12
2016-10-23 08:50:00,4,9,2,15,90
2016-10-23 09:00:00,7,21,6,34,204
2016-10-23 09:10:00,9,30,12,51,306
2016-10-23 09:20:00,6,35,18,59,354
2016-10-23 09:30:00,7,34,17,58,348
2016-10-23 09:40:00,12,41,21,74,444
2016-10-23 09:50:00,14,53,31,98,588
2016-10-23 10:00:00,11,46,23,80,480
2016-10-23 10:10:00,25,58,22,105,630
2016-10-23 10:20:00,21,48,21,90,540
2016-10-23 10:30:00,27,49,16,92,552
2016-10-23 10:40:00,18,48,22,88,528
2016-10-23 10:50:00,10,51,27,88,528
2016-10-23 11:00:00,15,53,32,100,600
2016-10-23 11:10:00,18,75,21,114,684
2016-10-23 11:20:00,24,76,15,115,690
2016-10-23 11:30:00,31,79,52,162,972
2016-10-23 11:40:00,29,104,88,221,1326
2016-10-23 11:50:00,15,103,93,211,1266
2016-10-23 12:00:00,57,99,87,243,1458
2016-10-23 12:10:00,63,92,88,243,1458
2016-10-23 12:20:00,48,86,53,187,1122
2016-10-23 12:30:00,26,86,62,174,1044
2016-10-23 12:40:00,16,84,23,123,738
2016-10-23 12:50:00,22,79,19,120,720
2016-10-23 13:00:00,32,70,40,142,852
2016-10-23 13:10:00,29,95,75,199,1194
2016-10-23 13:20:00,10,141,136,287,1722
2016-10-23 13:30:00,29,134,118,281,1686
2016-10-23 13:40:00,51,90,64,205,1230
2016-10-23 13:50:00,46,122,111,279,1674
2016-10-23 14:00:00,7,148,143,298,1788
2016-10-23 14:10:00,105,176,145,426,2556
2016-10-23 14:20:00,236,196,176,608,3648
2016-10-23 14:30:00,166,187,180,533,3198
2016-10-23 14:40:00,129,148,141,418,2508
2016-10-23 14:50:00,120,132,68,320,1920
2016-10-23 15:00:00,146,170,33,349,2094
2016-10-23 15:10:00,108,196,112,416,2496
2016-10-23 15:20:00,25,143,129,297,1782
2016-10-23 15:30:00,24,77,44,145,870
2016-10-23 15:40:00,21,50,14,85,510
2016-10-23 15:50:00,27,44,9,80,480
2016-10-23 16:00:00,36,80,37,153,918
2016-10-23 16:10:00,33,74,37,144,864
2016-10-23 16:20:00,27,42,9,78,468
2016-10-23 16:30:00,21,37,12,70,420
2016-10-23 16:40:00,21,34,8,63,378
2016-10-23 16:50:00,26,30,2,58,348
2016-10-23 17:00:00,7,10,0,17,102
2016-10-23 17:10:00,0,0,0,0,0
2016-10-23 17:20:00,0,0,0,0,0
2016-10-23 17:30:00,0,0,0,0,0
2016-10-23 17:40:00,0,0,0,0,0
2016-10-23 17:50:00,0,0,0,0,0
2016-10-24 07:30:00,0,0,0,0,0
2016-10-24 07:40:00,0,0,0,0,0
2016-10-24 07:50:00,0,0,0,0,0
2016-10-24 08:00:00,0,0,0,0,0
2016-10-24 08:10:00,3,6,1,10,60
2016-10-24 08:20:00,6,27,15,48,288
2016-10-24 08:30:00,16,53,30,99,594
2016-10-24 08:40:00,6,32,21,59,354
2016-10-24 08:50:00,17,35,30,82,492
2016-10-24 09:00:00,37,52,45,134,804
2016-10-24 09:10:00,69,83,86,238,1428
2016-10-24 09:20:00,95,89,114,298,1788
2016-10-24 09:30:00,82,122,106,310,1860
2016-10-24 09:40:00,76,148,114,338,2028
2016-10-24 09:50:00,225,257,248,730,4380
2016-10-24 10:00:00,185,207,200,592,3552
2016-10-24 10:10:00,178,202,194,574,3444
2016-10-24 10:20:00,125,143,142,410,2460
2016-10-24 10:30:00,110,128,130,368,2208
2016-10-24 10:40:00,106,137,134,377,2262
2016-10-24 10:50:00,79,119,113,311,1866
2016-10-24 11:00:00,158,217,250,625,3750
2016-10-24 11:10:00,290,316,305,911,5466
2016-10-24 11:20:00,496,518,507,1521,9126
2016-10-24 11:30:00,274,296,290,860,5160
2016-10-24 11:40:00,289,312,306,907,5442
2016-10-24 11:50:00,106,142,142,390,2340
2016-10-24 12:00:00,275,268,293,836,5016
2016-10-24 12:10:00,329,351,344,1024,6144
2016-10-24 12:20:00,365,387,380,1132,6792
2016-10-24 12:30:00,154,176,170,500,3000
2016-10-24 12:40:00,164,196,177,537,3222
2016-10-24 12:50:00,174,211,148,533,3198
2016-10-24 13:00:00,500,522,513,1535,9210
2016-10-24 13:10:00,451,473,464,1388,8328
2016-10-24 13:20:00,586,603,594,1783,10698
2016-10-24 13:30:00,566,587,577,1730,10380
2016-10-24 13:40:00,592,615,604,1811,10866
2016-10-24 13:50:00,531,561,546,1638,9828
2016-10-24 14:00:00,229,254,245,728,4368
2016-10-24 14:10:00,548,573,560,1681,10086
2016-10-24 14:20:00,612,636,624,1872,11232
2016-10-24 14:30:00,488,520,509,1517,9102
2016-10-24 14:40:00,220,242,233,695,4170
2016-10-24 14:50:00,129,146,139,414,2484
2016-10-24 15:00:00,163,183,174,520,3120
2016-10-24 15:10:00,183,204,193,580,3480
2016-10-24 15:20:00,206,229,216,651,3906
2016-10-24 15:30:00,85,101,97,283,1698
2016-10-24 15:40:00,29,125,113,267,1602
2016-10-24 15:50:00,26,98,76,200,1200
2016-10-24 16:00:00,20,95,81,196,1176
2016-10-24 16:10:00,44,89,66,199,1194
2016-10-24 16:20:00,20,75,38,133,798
2016-10-24 16:30:00,8,49,23,80,480
2016-10-24 16:40:00,5,34,13,52,312
2016-10-24 16:50:00,8,31,13,52,312
2016-10-24 17:00:00,9,16,4,29,174
2016-10-24 17:10:00,4,7,1,12,72
2016-10-24 17:20:00,0,0,0,0,0
2016-10-24 17:30:00,0,0,0,0,0
2016-10-24 17:40:00,0,0,0,0,0
2016-10-24 17:50:00,0,0,0,0,0
2016-10-25 07:30:00,0,0,0,0,0
2016-10-25 07:40:00,0,0,0,0,0
2016-10-25 07:50:00,0,0,0,0,0
2016-10-25 08:00:00,0,0,0,0,0
2016-10-25 08:10:00,0,0,0,0,0
2016-10-25 08:20:00,0,0,0,0,0
2016-10-25 08:30:00,0,1,0,1,6
2016-10-25 08:40:00,3,5,0,8,48
2016-10-25 08:50:00,5,9,6,20,120
2016-10-25 09:00:00,11,25,13,49,294
2016-10-25 09:10:00,19,39,23,81,486
2016-10-25 09:20:00,46,59,62,167,1002
2016-10-25 09:30:00,28,56,38,122,732
2016-10-25 09:40:00,28,51,34,113,678
2016-10-25 09:50:00,32,52,48,132,792
2016-10-25 10:00:00,56,77,75,208,1248
2016-10-25 10:10:00,331,359,351,1041,6246
2016-10-25 10:20:00,105,147,131,383,2298
2016-10-25 10:30:00,43,92,84,219,1314
2016-10-25 10:40:00,161,189,173,523,3138
2016-10-25 10:50:00,90,158,156,404,2424
2016-10-25 11:00:00,10,117,114,241,1446
2016-10-25 11:10:00,275,323,311,909,5454
2016-10-25 11:20:00,531,554,547,1632,9792
2016-10-25 11:30:00,118,141,136,395,2370
2016-10-25 11:40:00,44,119,118,281,1686
2016-10-25 11:50:00,150,187,175,512,3072
2016-10-25 12:00:00,577,604,594,1775,10650
2016-10-25 12:10:00,283,307,299,889,5334
2016-10-25 12:20:00,122,174,173,469,2814
2016-10-25 12:30:00,107,190,129,426,2556
2016-10-25 12:40:00,236,299,228,763,4578
2016-10-25 12:50:00,199,219,214,632,3792
2016-10-25 13:00:00,167,190,185,542,3252
2016-10-25 13:10:00,291,315,309,915,5490
2016-10-25 13:20:00,560,587,579,1726,10356
2016-10-25 13:30:00,260,294,284,838,5028
2016-10-25 13:40:00,131,179,187,497,2982
2016-10-25 13:50:00,148,232,134,514,3084
2016-10-25 14:00:00,63,150,154,367,2202
2016-10-25 14:10:00,97,121,119,337,2022
2016-10-25 14:20:00,104,170,145,419,2514
2016-10-25 14:30:00,76,125,152,353,2118
2016-10-25 14:40:00,96,126,141,363,2178
2016-10-25 14:50:00,49,198,148,395,2370
2016-10-25 15:00:00,15,98,86,199,1194
2016-10-25 15:10:00,26,75,38,139,834
2016-10-25 15:20:00,30,73,28,131,786
2016-10-25 15:30:00,28,73,44,145,870
2016-10-25 15:40:00,31,69,25,125,750
2016-10-25 15:50:00,24,50,28,102,612
2016-10-25 16:00:00,15,46,24,85,510
2016-10-25 16:10:00,12,43,22,77,462
2016-10-25 16:20:00,13,34,11,58,348
2016-10-25 16:30:00,9,19,8,36,216
2016-10-25 16:40:00,5,9,3,17,102
2016-10-25 16:50:00,3,5,1,9,54
2016-10-25 17:00:00,1,2,0,3,18
2016-10-25 17:10:00,0,0,0,0,0
2016-10-25 17:20:00,0,0,0,0,0
2016-10-25 17:30:00,0,0,0,0,0
2016-10-25 17:40:00,0,0,0,0,0
2016-10-25 17:50:00,0,0,0,0,0
2016-10-26 07:30:00,0,0,0,0,0
2016-10-26 07:40:00,0,0,0,0,0
2016-10-26 07:50:00,0,0,0,0,0
2016-10-26 08:00:00,0,0,0,0,0
2016-10-26 08:10:00,1,2,0,3,18
2016-10-26 08:20:00,5,7,0,12,72
2016-10-26 08:30:00,5,9,1,15,90
2016-10-26 08:40:00,14,32,13,59,354
2016-10-26 08:50:00,17,25,22,64,384
2016-10-26 09:00:00,24,47,24,95,570
2016-10-26 09:10:00,66,87,78,231,1386
2016-10-26 09:20:00,87,148,129,364,2184
2016-10-26 09:30:00,201,198,192,591,3546
2016-10-26 09:40:00,152,172,169,493,2958
2016-10-26 09:50:00,90,110,103,303,1818
2016-10-26 10:00:00,68,128,113,309,1854
2016-10-26 10:10:00,62,150,146,358,2148
2016-10-26 10:20:00,71,129,110,310,1860
2016-10-26 10:30:00,83,119,99,301,1806
2016-10-26 10:40:00,70,156,126,352,2112
2016-10-26 10:50:00,112,135,158,405,2430
2016-10-26 11:00:00,161,311,0,472,2832
2016-10-26 11:10:00,126,319,34,479,2874
2016-10-26 11:20:00,143,287,12,442,2652
2016-10-26 11:30:00,125,142,171,438,2628
2016-10-26 11:40:00,114,166,233,513,3078
2016-10-26 11:50:00,206,197,174,577,3462
2016-10-26 12:00:00,195,231,193,619,3714
2016-10-26 12:10:00,235,254,248,737,4422
2016-10-26 12:20:00,228,247,243,718,4308
2016-10-26 12:30:00,267,287,283,837,5022
2016-10-26 12:40:00,249,270,265,784,4704
2016-10-26 12:50:00,123,145,140,408,2448
2016-10-26 13:00:00,87,133,123,343,2058
2016-10-26 13:10:00,85,133,104,322,1932
2016-10-26 13:20:00,101,127,117,345,2070
2016-10-26 13:30:00,159,154,130,443,2658
2016-10-26 13:40:00,36,208,259,503,3018
2016-10-26 13:50:00,159,238,103,500,3000
2016-10-26 14:00:00,135,270,51,456,2736
2016-10-26 14:10:00,93,130,117,340,2040
2016-10-26 14:20:00,75,92,74,241,1446
2016-10-26 14:30:00,48,60,55,163,978
2016-10-26 14:40:00,30,63,38,131,786
2016-10-26 14:50:00,15,46,23,84,504
2016-10-26 15:00:00,18,50,26,94,564
2016-10-26 15:10:00,23,63,27,113,678
2016-10-26 15:20:00,18,54,23,95,570
2016-10-26 15:30:00,9,36,16,61,366
2016-10-26 15:40:00,8,19,3,30,180
2016-10-26 15:50:00,6,24,9,39,234
2016-10-26 16:00:00,14,25,7,46,276
2016-10-26 16:10:00,8,19,6,33,198
2016-10-26 16:20:00,8,12,2,22,132
2016-10-26 16:30:00,8,13,2,23,138
2016-10-26 16:40:00,4,8,0,12,72
2016-10-26 16:50:00,6,8,1,15,90
2016-10-26 17:00:00,3,5,0,8,48
2016-10-26 17:10:00,1,3,0,4,24
2016-10-26 17:20:00,0,0,0,0,0
2016-10-26 17:30:00,0,0,0,0,0
2016-10-26 17:40:00,0,0,0,0,0
2016-10-26 17:50:00,0,0,0,0,0
2016-10-27 07:40:00,0,0,0,0,0
2016-10-27 07:50:00,0,0,0,0,0
2016-10-27 08:00:00,0,0,0,0,0
2016-10-27 08:10:00,0,0,0,0,0
2016-10-27 08:20:00,3,7,1,11,66
2016-10-27 08:30:00,7,34,15,56,336
2016-10-27 08:40:00,12,20,6,38,228
2016-10-27 08:50:00,19,32,21,72,432
2016-10-27 09:00:00,46,59,54,159,954
2016-10-27 09:10:00,37,60,43,140,840
2016-10-27 09:20:00,41,61,48,150,900
2016-10-27 09:30:00,71,99,133,303,1818
2016-10-27 09:40:00,110,139,125,374,2244
2016-10-27 09:50:00,321,343,337,1001,6006
2016-10-27 10:00:00,402,428,421,1251,7506
2016-10-27 10:10:00,469,492,486,1447,8682
2016-10-27 10:20:00,526,547,543,1616,9696
2016-10-27 10:30:00,566,587,584,1737,10422
2016-10-27 10:40:00,619,642,639,1900,11400
2016-10-27 10:50:00,655,679,676,2010,12060
2016-10-27 11:00:00,683,702,693,2078,12468
2016-10-27 11:10:00,675,699,690,2064,12384
2016-10-27 11:20:00,661,687,682,2030,12180
2016-10-27 11:30:00,640,664,662,1966,11796
2016-10-27 11:40:00,599,625,618,1842,11052
2016-10-27 11:50:00,618,639,629,1886,11316
2016-10-27 12:00:00,573,589,586,1748,10488
2016-10-27 12:10:00,536,553,550,1639,9834
2016-10-27 12:20:00,540,559,551,1650,9900
2016-10-27 12:30:00,548,571,561,1680,10080
2016-10-27 12:40:00,551,575,569,1695,10170
2016-10-27 12:50:00,494,516,513,1523,9138
2016-10-27 13:00:00,409,431,428,1268,7608
2016-10-27 13:10:00,171,224,187,582,3492
2016-10-27 13:20:00,649,673,667,1989,11934
2016-10-27 13:30:00,721,749,741,2211,13266
2016-10-27 13:40:00,628,652,645,1925,11550
2016-10-27 13:50:00,645,668,661,1974,11844
2016-10-27 14:00:00,304,322,316,942,5652
2016-10-27 14:10:00,138,159,156,453,2718
2016-10-27 14:20:00,229,252,248,729,4374
2016-10-27 14:30:00,269,297,290,856,5136
2016-10-27 14:40:00,306,329,320,955,5730
2016-10-27 14:50:00,428,450,432,1310,7860
2016-10-27 15:00:00,123,195,179,497,2982
2016-10-27 15:10:00,5,133,130,268,1608
2016-10-27 15:20:00,3,134,130,267,1602
2016-10-27 15:30:00,60,69,72,201,1206
2016-10-27 15:40:00,23,64,28,115,690
2016-10-27 15:50:00,12,19,6,37,222
2016-10-27 16:00:00,16,37,14,67,402
2016-10-27 16:10:00,23,59,34,116,696
2016-10-27 16:20:00,32,36,39,107,642
2016-10-27 16:30:00,15,30,12,57,342
2016-10-27 16:40:00,10,28,12,50,300
2016-10-27 16:50:00,3,6,1,10,60
2016-10-27 17:00:00,5,9,1,15,90
2016-10-27 17:10:00,3,6,1,10,60
2016-10-27 17:20:00,0,0,0,0,0
2016-10-27 17:30:00,0,0,0,0,0
2016-10-27 17:40:00,0,0,0,0,0
2016-10-28 07:50:00,0,0,0,0,0
2016-10-28 08:00:00,0,0,0,0,0
2016-10-28 08:10:00,0,0,0,0,0
2016-10-28 08:20:00,0,0,0,0,0
2016-10-28 08:30:00,0,0,0,0,0
2016-10-28 08:40:00,0,0,0,0,0
2016-10-28 08:50:00,0,0,0,0,0
2016-10-28 09:00:00,2,2,2,6,36
2016-10-28 09:10:00,16,31,15,62,372
2016-10-28 09:20:00,44,72,70,186,1116
2016-10-28 09:30:00,44,63,55,162,972
2016-10-28 09:40:00,58,77,57,192,1152
2016-10-28 09:50:00,137,132,81,350,2100
2016-10-28 10:00:00,43,65,36,144,864
2016-10-28 10:10:00,348,368,365,1081,6486
2016-10-28 10:20:00,82,99,96,277,1662
2016-10-28 10:30:00,63,74,74,211,1266
2016-10-28 10:40:00,167,154,176,497,2982
2016-10-28 10:50:00,258,255,266,779,4674
2016-10-28 11:00:00,263,285,283,831,4986
2016-10-28 11:10:00,85,144,208,437,2622
2016-10-28 11:20:00,137,159,175,471,2826
2016-10-28 11:30:00,637,657,661,1955,11730
2016-10-28 11:40:00,508,529,529,1566,9396
2016-10-28 11:50:00,623,642,644,1909,11454
2016-10-28 12:00:00,416,438,437,1291,7746
2016-10-28 12:10:00,523,545,544,1612,9672
2016-10-28 12:20:00,531,558,556,1645,9870
2016-10-28 12:30:00,595,620,621,1836,11016
2016-10-28 12:40:00,567,594,592,1753,10518
2016-10-28 12:50:00,496,519,519,1534,9204
2016-10-28 13:00:00,248,270,268,786,4716
2016-10-28 13:10:00,661,682,682,2025,12150
2016-10-28 13:20:00,777,799,797,2373,14238
2016-10-28 13:30:00,696,718,717,2131,12786
2016-10-28 13:40:00,625,647,642,1914,11484
2016-10-28 13:50:00,527,547,539,1613,9678
2016-10-28 14:00:00,374,395,386,1155,6930
2016-10-28 14:10:00,411,442,429,1282,7692
2016-10-28 14:20:00,506,534,521,1561,9366
2016-10-28 14:30:00,200,225,222,647,3882
2016-10-28 14:40:00,126,117,141,384,2304
2016-10-28 14:50:00,311,332,322,965,5790
2016-10-28 15:00:00,160,177,172,509,3054
2016-10-28 15:10:00,257,276,268,801,4806
2016-10-28 15:20:00,210,230,224,664,3984
2016-10-28 15:30:00,90,122,101,313,1878
2016-10-28 15:40:00,36,69,31,136,816
2016-10-28 15:50:00,25,46,13,84,504
2016-10-28 16:00:00,56,55,50,161,966
2016-10-28 16:10:00,27,75,50,152,912
2016-10-28 16:20:00,36,54,47,137,822
2016-10-28 16:30:00,14,58,23,95,570
2016-10-28 16:40:00,24,46,22,92,552
2016-10-28 16:50:00,6,19,5,30,180
2016-10-28 17:00:00,6,17,4,27,162
2016-10-28 17:10:00,0,0,0,0,0
2016-10-28 17:20:00,0,0,0,0,0
2016-10-28 17:30:00,0,0,0,0,0
2016-10-28 17:40:00,0,0,0,0,0
2016-10-29 07:30:00,0,0,0,0,0
2016-10-29 07:40:00,0,0,0,0,0
2016-10-29 07:50:00,0,0,0,0,0
2016-10-29 08:00:00,0,0,0,0,0
2016-10-29 08:10:00,4,9,1,14,84
2016-10-29 08:20:00,9,25,8,42,252
2016-10-29 08:30:00,9,42,22,73,438
2016-10-29 08:40:00,22,50,24,96,576
2016-10-29 08:50:00,19,73,27,119,714
2016-10-29 09:00:00,22,76,39,137,822
2016-10-29 09:10:00,27,75,44,146,876
2016-10-29 09:20:00,22,90,67,179,1074
2016-10-29 09:30:00,50,90,64,204,1224
2016-10-29 09:40:00,222,213,143,578,3468
2016-10-29 09:50:00,283,306,292,881,5286
2016-10-29 10:00:00,366,390,380,1136,6816
2016-10-29 10:10:00,365,385,377,1127,6762
2016-10-29 10:20:00,480,503,490,1473,8838
2016-10-29 10:30:00,501,527,507,1535,9210
2016-10-29 10:40:00,529,553,535,1617,9702
2016-10-29 10:50:00,603,629,610,1842,11052
2016-10-29 11:00:00,627,647,632,1906,11436
2016-10-29 11:10:00,613,637,619,1869,11214
2016-10-29 11:20:00,608,629,606,1843,11058
2016-10-29 11:30:00,585,611,590,1786,10716
2016-10-29 11:40:00,631,649,629,1909,11454
2016-10-29 11:50:00,599,622,612,1833,10998
2016-10-29 12:00:00,563,587,585,1735,10410
2016-10-29 12:10:00,531,557,550,1638,9828
2016-10-29 12:20:00,528,554,542,1624,9744
2016-10-29 12:30:00,529,554,546,1629,9774
2016-10-29 12:40:00,517,541,535,1593,9558
2016-10-29 12:50:00,602,625,616,1843,11058
2016-10-29 13:00:00,423,446,440,1309,7854
2016-10-29 13:10:00,702,735,717,2154,12924
2016-10-29 13:20:00,757,789,767,2313,13878
2016-10-29 13:30:00,473,500,487,1460,8760
2016-10-29 13:40:00,629,658,645,1932,11592
2016-10-29 13:50:00,609,635,623,1867,11202
2016-10-29 14:00:00,559,584,572,1715,10290
2016-10-29 14:10:00,537,559,549,1645,9870
2016-10-29 14:20:00,493,514,506,1513,9078
2016-10-29 14:30:00,454,475,468,1397,8382
2016-10-29 14:40:00,406,427,419,1252,7512
2016-10-29 14:50:00,335,358,348,1041,6246
2016-10-29 15:00:00,177,222,209,608,3648
2016-10-29 15:10:00,152,185,167,504,3024
2016-10-29 15:20:00,103,201,116,420,2520
2016-10-29 15:30:00,51,158,127,336,2016
2016-10-29 15:40:00,26,84,67,177,1062
2016-10-29 15:50:00,18,82,57,157,942
2016-10-29 16:00:00,19,77,50,146,876
2016-10-29 16:10:00,23,70,52,145,870
2016-10-29 16:20:00,24,69,39,132,792
2016-10-29 16:30:00,20,47,19,86,516
2016-10-29 16:40:00,18,40,20,78,468
2016-10-29 16:50:00,9,35,15,59,354
2016-10-29 17:00:00,6,25,7,38,228
2016-10-29 17:10:00,1,3,0,4,24
2016-10-29 17:20:00,0,0,0,0,0
2016-10-29 17:30:00,0,0,0,0,0
2016-10-29 17:40:00,0,0,0,0,0
2016-10-29 17:50:00,0,0,0,0,0
2016-10-30 06:40:00,0,0,0,0,0
2016-10-30 06:50:00,0,0,0,0,0
2016-10-30 07:00:00,0,0,0,0,0
2016-10-30 07:10:00,0,1,0,1,6
2016-10-30 07:20:00,7,14,3,24,144
2016-10-30 07:30:00,6,30,12,48,288
2016-10-30 07:40:00,12,42,24,78,468
2016-10-30 07:50:00,36,61,36,133,798
2016-10-30 08:00:00,4,90,79,173,1038
2016-10-30 08:10:00,10,108,95,213,1278
2016-10-30 08:20:00,29,151,144,324,1944
2016-10-30 08:30:00,83,185,123,391,2346
2016-10-30 08:40:00,189,194,147,530,3180
2016-10-30 08:50:00,173,193,183,549,3294
2016-10-30 09:00:00,349,373,356,1078,6468
2016-10-30 09:10:00,476,502,480,1458,8748
2016-10-30 09:20:00,532,569,546,1647,9882
2016-10-30 09:30:00,599,638,610,1847,11082
2016-10-30 09:40:00,583,626,598,1807,10842
2016-10-30 09:50:00,139,242,202,583,3498
2016-10-30 10:00:00,369,435,363,1167,7002
2016-10-30 10:10:00,640,665,640,1945,11670
2016-10-30 10:20:00,640,669,641,1950,11700
2016-10-30 10:30:00,425,451,433,1309,7854
2016-10-30 10:40:00,315,340,323,978,5868
2016-10-30 10:50:00,482,511,495,1488,8928
2016-10-30 11:00:00,278,303,291,872,5232
2016-10-30 11:10:00,312,339,323,974,5844
2016-10-30 11:20:00,247,270,258,775,4650
2016-10-30 11:30:00,183,208,198,589,3534
2016-10-30 11:40:00,168,311,14,493,2958
2016-10-30 11:50:00,133,238,74,445,2670
2016-10-30 12:00:00,119,188,157,464,2784
2016-10-30 12:10:00,134,183,178,495,2970
2016-10-30 12:20:00,79,170,162,411,2466
2016-10-30 12:30:00,27,199,165,391,2346
2016-10-30 12:40:00,26,208,159,393,2358
2016-10-30 12:50:00,65,182,161,408,2448
2016-10-30 13:00:00,31,193,160,384,2304
2016-10-30 13:10:00,40,179,162,381,2286
2016-10-30 13:20:00,38,156,146,340,2040
2016-10-30 13:30:00,1,154,157,312,1872
2016-10-30 13:40:00,5,158,155,318,1908
2016-10-30 13:50:00,6,177,163,346,2076
2016-10-30 14:00:00,0,176,164,340,2040
2016-10-30 14:10:00,8,137,133,278,1668
2016-10-30 14:20:00,39,103,71,213,1278
2016-10-30 14:30:00,22,81,53,156,936
2016-10-30 14:40:00,16,91,22,129,774
2016-10-30 14:50:00,19,57,28,104,624
2016-10-30 15:00:00,10,49,17,76,456
2016-10-30 15:10:00,8,20,5,33,198
2016-10-30 15:20:00,5,15,1,21,126
2016-10-30 15:30:00,8,16,4,28,168
2016-10-30 15:40:00,7,12,2,21,126
2016-10-30 15:50:00,1,2,0,3,18
2016-10-30 16:00:00,0,0,0,0,0
2016-10-30 16:10:00,0,0,0,0,0
2016-10-30 16:20:00,0,0,0,0,0
2016-10-30 16:30:00,0,0,0,0,0
2016-10-31 06:50:00,0,0,0,0,0
2016-10-31 07:00:00,0,0,0,0,0
2016-10-31 07:10:00,0,0,0,0,0
2016-10-31 07:20:00,0,0,0,0,0
2016-10-31 07:30:00,0,0,0,0,0
2016-10-31 07:40:00,1,4,1,6,36
2016-10-31 07:50:00,4,7,10,21,126
2016-10-31 08:00:00,10,15,12,37,222
2016-10-31 08:10:00,7,13,8,28,168
2016-10-31 08:20:00,2,4,1,7,42
2016-10-31 08:30:00,12,28,8,48,288
2016-10-31 08:40:00,12,33,21,66,396
2016-10-31 08:50:00,9,32,14,55,330
2016-10-31 09:00:00,13,28,22,63,378
2016-10-31 09:10:00,18,48,35,101,606
2016-10-31 09:20:00,28,91,75,194,1164
2016-10-31 09:30:00,25,90,70,185,1110
2016-10-31 09:40:00,23,60,31,114,684
2016-10-31 09:50:00,22,46,24,92,552
2016-10-31 10:00:00,21,49,26,96,576
2016-10-31 10:10:00,24,62,45,131,786
2016-10-31 10:20:00,26,62,58,146,876
2016-10-31 10:30:00,17,82,68,167,1002
2016-10-31 10:40:00,27,73,58,158,948
2016-10-31 10:50:00,38,81,64,183,1098
2016-10-31 11:00:00,24,88,66,178,1068
2016-10-31 11:10:00,19,83,60,162,972
2016-10-31 11:20:00,35,72,71,178,1068
2016-10-31 11:30:00,62,104,107,273,1638
2016-10-31 11:40:00,57,128,132,317,1902
2016-10-31 11:50:00,71,150,154,375,2250
2016-10-31 12:00:00,77,73,94,244,1464
2016-10-31 12:10:00,81,86,101,268,1608
2016-10-31 12:20:00,97,117,113,327,1962
2016-10-31 12:30:00,174,208,196,578,3468
2016-10-31 12:40:00,147,164,162,473,2838
2016-10-31 12:50:00,66,84,81,231,1386
2016-10-31 13:00:00,40,83,75,198,1188
2016-10-31 13:10:00,102,134,140,376,2256
2016-10-31 13:20:00,112,138,152,402,2412
2016-10-31 13:30:00,82,117,94,293,1758
2016-10-31 13:40:00,161,290,16,467,2802
2016-10-31 13:50:00,138,192,86,416,2496
2016-10-31 14:00:00,37,99,82,218,1308
2016-10-31 14:10:00,8,116,108,232,1392
2016-10-31 14:20:00,65,174,134,373,2238
2016-10-31 14:30:00,21,129,113,263,1578
2016-10-31 14:40:00,17,55,27,99,594
2016-10-31 14:50:00,50,86,66,202,1212
2016-10-31 15:00:00,39,87,49,175,1050
2016-10-31 15:10:00,29,75,30,134,804
2016-10-31 15:20:00,13,40,19,72,432
2016-10-31 15:30:00,8,25,7,40,240
2016-10-31 15:40:00,8,13,3,24,144
2016-10-31 15:50:00,2,3,0,5,30
2016-10-31 16:00:00,0,1,0,1,6
2016-10-31 16:10:00,0,0,0,0,0
2016-10-31 16:20:00,0,0,0,0,0
2016-10-31 16:30:00,0,0,0,0,0
2016-11-01 07:00:00,0,0,0,0,0
2016-11-01 07:10:00,0,0,0,0,0
2016-11-01 07:20:00,0,0,0,0,0
2016-11-01 07:30:00,0,0,0,0,0
2016-11-01 07:40:00,0,1,0,1,6
2016-11-01 07:50:00,1,3,2,6,36
2016-11-01 08:00:00,7,11,14,32,192
2016-11-01 08:10:00,6,17,9,32,192
2016-11-01 08:20:00,10,21,9,40,240
2016-11-01 08:30:00,7,7,8,22,132
2016-11-01 08:40:00,22,28,22,72,432
2016-11-01 08:50:00,24,35,11,70,420
2016-11-01 09:00:00,28,45,10,83,498
2016-11-01 09:10:00,35,46,8,89,534
2016-11-01 09:20:00,37,96,88,221,1326
2016-11-01 09:30:00,46,158,147,351,2106
2016-11-01 09:40:00,54,121,105,280,1680
2016-11-01 09:50:00,50,105,85,240,1440
2016-11-01 10:00:00,225,132,160,517,3102
2016-11-01 10:10:00,122,151,123,396,2376
2016-11-01 10:20:00,71,136,130,337,2022
2016-11-01 10:30:00,207,229,213,649,3894
2016-11-01 10:40:00,226,146,173,545,3270
2016-11-01 10:50:00,192,210,177,579,3474
2016-11-01 11:00:00,311,330,327,968,5808
2016-11-01 11:10:00,464,484,482,1430,8580
2016-11-01 11:20:00,403,422,421,1246,7476
2016-11-01 11:30:00,321,338,335,994,5964
2016-11-01 11:40:00,474,491,484,1449,8694
2016-11-01 11:50:00,619,636,629,1884,11304
2016-11-01 12:00:00,537,554,551,1642,9852
2016-11-01 12:10:00,340,341,341,1022,6132
2016-11-01 12:20:00,314,332,331,977,5862
2016-11-01 12:30:00,240,262,258,760,4560
2016-11-01 12:40:00,444,464,461,1369,8214
2016-11-01 12:50:00,485,503,498,1486,8916
2016-11-01 13:00:00,623,643,636,1902,11412
2016-11-01 13:10:00,467,488,485,1440,8640
2016-11-01 13:20:00,421,441,438,1300,7800
2016-11-01 13:30:00,406,425,423,1254,7524
2016-11-01 13:40:00,312,332,328,972,5832
2016-11-01 13:50:00,145,182,164,491,2946
2016-11-01 14:00:00,218,252,244,714,4284
2016-11-01 14:10:00,161,189,166,516,3096
2016-11-01 14:20:00,34,92,61,187,1122
2016-11-01 14:30:00,24,68,35,127,762
2016-11-01 14:40:00,63,76,71,210,1260
2016-11-01 14:50:00,35,81,55,171,1026
2016-11-01 15:00:00,28,89,48,165,990
2016-11-01 15:10:00,27,57,21,105,630
2016-11-01 15:20:00,40,38,13,91,546
2016-11-01 15:30:00,22,58,25,105,630
2016-11-01 15:40:00,20,36,9,65,390
2016-11-01 15:50:00,17,10,2,29,174
2016-11-01 16:00:00,6,10,1,17,102
2016-11-01 16:10:00,1,1,0,2,12
2016-11-01 16:20:00,0,0,0,0,0
2016-11-01 16:30:00,0,0,0,0,0
2016-11-01 16:40:00,0,0,0,0,0
2016-11-02 06:50:00,0,0,0,0,0
2016-11-02 07:00:00,0,0,0,0,0
2016-11-02 07:10:00,0,0,0,0,0
2016-11-02 07:20:00,0,0,0,0,0
2016-11-02 07:30:00,0,0,0,0,0
2016-11-02 07:40:00,3,4,1,8,48
2016-11-02 07:50:00,12,21,17,50,300
2016-11-02 08:00:00,39,40,31,110,660
2016-11-02 08:10:00,31,70,69,170,1020
2016-11-02 08:20:00,65,102,95,262,1572
2016-11-02 08:30:00,40,81,58,179,1074
2016-11-02 08:40:00,36,68,52,156,936
2016-11-02 08:50:00,24,58,23,105,630
2016-11-02 09:00:00,35,56,35,126,756
2016-11-02 09:10:00,37,85,65,187,1122
2016-11-02 09:20:00,22,45,26,93,558
2016-11-02 09:30:00,151,181,181,513,3078
2016-11-02 09:40:00,56,112,93,261,1566
2016-11-02 09:50:00,141,171,156,468,2808
2016-11-02 10:00:00,46,81,53,180,1080
2016-11-02 10:10:00,44,82,65,191,1146
2016-11-02 10:20:00,184,202,169,555,3330
2016-11-02 10:30:00,257,275,272,804,4824
2016-11-02 10:40:00,305,138,183,626,3756
2016-11-02 10:50:00,314,335,330,979,5874
2016-11-02 11:00:00,103,124,120,347,2082
2016-11-02 11:10:00,71,111,104,286,1716
2016-11-02 11:20:00,87,124,93,304,1824
2016-11-02 11:30:00,141,170,142,453,2718
2016-11-02 11:40:00,431,449,443,1323,7938
2016-11-02 11:50:00,271,288,286,845,5070
2016-11-02 12:00:00,320,338,333,991,5946
2016-11-02 12:10:00,340,363,356,1059,6354
2016-11-02 12:20:00,438,452,454,1344,8064
2016-11-02 12:30:00,269,322,317,908,5448
2016-11-02 12:40:00,483,502,494,1479,8874
2016-11-02 12:50:00,156,176,169,501,3006
2016-11-02 13:00:00,432,451,445,1328,7968
2016-11-02 13:10:00,379,399,394,1172,7032
2016-11-02 13:20:00,188,207,204,599,3594
2016-11-02 13:30:00,371,388,386,1145,6870
2016-11-02 13:40:00,204,223,220,647,3882
2016-11-02 13:50:00,97,128,116,341,2046
2016-11-02 14:00:00,54,77,61,192,1152
2016-11-02 14:10:00,36,80,55,171,1026
2016-11-02 14:20:00,40,93,56,189,1134
2016-11-02 14:30:00,50,58,21,129,774
2016-11-02 14:40:00,26,68,16,110,660
2016-11-02 14:50:00,29,62,30,121,726
2016-11-02 15:00:00,49,82,60,191,1146
2016-11-02 15:10:00,11,26,4,41,246
2016-11-02 15:20:00,8,9,0,17,102
2016-11-02 15:30:00,6,10,0,16,96
2016-11-02 15:40:00,6,8,0,14,84
2016-11-02 15:50:00,4,0,0,4,24
2016-11-02 16:00:00,0,0,0,0,0
2016-11-02 16:10:00,0,0,0,0,0
2016-11-02 16:20:00,0,0,0,0,0
2016-11-02 16:30:00,0,0,0,0,0
2016-11-03 06:40:00,0,0,0,0,0
2016-11-03 06:50:00,0,0,0,0,0
2016-11-03 07:00:00,0,0,0,0,0
2016-11-03 07:10:00,0,0,0,0,0
2016-11-03 07:20:00,0,1,0,1,6
2016-11-03 07:30:00,4,8,0,12,72
2016-11-03 07:40:00,8,16,3,27,162
2016-11-03 07:50:00,7,24,10,41,246
2016-11-03 08:00:00,7,35,14,56,336
2016-11-03 08:10:00,12,40,18,70,420
2016-11-03 08:20:00,17,43,28,88,528
2016-11-03 08:30:00,29,49,27,105,630
2016-11-03 08:40:00,234,305,207,746,4476
2016-11-03 08:50:00,351,369,364,1084,6504
2016-11-03 09:00:00,422,439,433,1294,7764
2016-11-03 09:10:00,483,509,499,1491,8946
2016-11-03 09:20:00,552,574,564,1690,10140
2016-11-03 09:30:00,606,625,620,1851,11106
2016-11-03 09:40:00,568,587,585,1740,10440
2016-11-03 09:50:00,568,587,583,1738,10428
2016-11-03 10:00:00,527,548,540,1615,9690
2016-11-03 10:10:00,496,515,509,1520,9120
2016-11-03 10:20:00,558,576,570,1704,10224
2016-11-03 10:30:00,422,440,433,1295,7770
2016-11-03 10:40:00,454,473,467,1394,8364
2016-11-03 10:50:00,415,434,429,1278,7668
2016-11-03 11:00:00,445,463,460,1368,8208
2016-11-03 11:10:00,359,378,372,1109,6654
2016-11-03 11:20:00,297,315,311,923,5538
2016-11-03 11:30:00,205,225,222,652,3912
2016-11-03 11:40:00,177,199,195,571,3426
2016-11-03 11:50:00,160,179,176,515,3090
2016-11-03 12:00:00,128,148,145,421,2526
2016-11-03 12:10:00,128,151,139,418,2508
2016-11-03 12:20:00,83,154,147,384,2304
2016-11-03 12:30:00,135,129,165,429,2574
2016-11-03 12:40:00,83,133,136,352,2112
2016-11-03 12:50:00,72,138,140,350,2100
2016-11-03 13:00:00,145,232,71,448,2688
2016-11-03 13:10:00,203,231,198,632,3792
2016-11-03 13:20:00,143,162,156,461,2766
2016-11-03 13:30:00,94,112,108,314,1884
2016-11-03 13:40:00,82,156,108,346,2076
2016-11-03 13:50:00,27,129,114,270,1620
2016-11-03 14:00:00,15,140,122,277,1662
2016-11-03 14:10:00,25,181,159,365,2190
2016-11-03 14:20:00,39,151,148,338,2028
2016-11-03 14:30:00,32,84,85,201,1206
2016-11-03 14:40:00,18,46,26,90,540
2016-11-03 14:50:00,37,28,14,79,474
2016-11-03 15:00:00,16,41,16,73,438
2016-11-03 15:10:00,11,38,15,64,384
2016-11-03 15:20:00,4,33,14,51,306
2016-11-03 15:30:00,6,33,13,52,312
2016-11-03 15:40:00,7,20,5,32,192
2016-11-03 15:50:00,3,6,0,9,54
2016-11-03 16:00:00,0,0,0,0,0
2016-11-03 16:10:00,0,0,0,0,0
2016-11-03 16:20:00,0,0,0,0,0
2016-11-04 07:00:00,0,0,0,0,0
2016-11-04 07:10:00,0,0,0,0,0
2016-11-04 07:20:00,0,0,0,0,0
2016-11-04 07:30:00,0,0,0,0,0
2016-11-04 07:40:00,0,0,0,0,0
2016-11-04 07:50:00,0,0,0,0,0
2016-11-04 08:00:00,2,5,5,12,72
2016-11-04 08:10:00,4,9,7,20,120
2016-11-04 08:20:00,1,2,3,6,36
2016-11-04 08:30:00,3,9,5,17,102
2016-11-04 08:40:00,3,7,5,15,90
2016-11-04 08:50:00,4,8,6,18,108
2016-11-04 09:00:00,24,45,28,97,582
2016-11-04 09:10:00,35,47,40,122,732
2016-11-04 09:20:00,9,12,16,37,222
2016-11-04 09:30:00,22,40,27,89,534
2016-11-04 09:40:00,38,56,48,142,852
2016-11-04 09:50:00,44,53,52,149,894
2016-11-04 10:00:00,44,61,63,168,1008
2016-11-04 10:10:00,52,73,73,198,1188
2016-11-04 10:20:00,58,77,74,209,1254
2016-11-04 10:30:00,56,81,64,201,1206
2016-11-04 10:40:00,55,101,93,249,1494
2016-11-04 10:50:00,62,132,108,302,1812
2016-11-04 11:00:00,113,124,136,373,2238
2016-11-04 11:10:00,133,148,110,391,2346
2016-11-04 11:20:00,201,145,160,506,3036
2016-11-04 11:30:00,199,225,128,552,3312
2016-11-04 11:40:00,130,155,111,396,2376
2016-11-04 11:50:00,102,135,120,357,2142
2016-11-04 12:00:00,98,105,108,311,1866
2016-11-04 12:10:00,50,58,64,172,1032
2016-11-04 12:20:00,24,39,24,87,522
2016-11-04 12:30:00,8,18,10,36,216
2016-11-04 12:40:00,19,39,12,70,420
2016-11-04 12:50:00,16,39,14,69,414
2016-11-04 13:00:00,20,55,21,96,576
2016-11-04 13:10:00,18,61,27,106,636
2016-11-04 13:20:00,16,49,27,92,552
2016-11-04 13:30:00,24,96,81,201,1206
2016-11-04 13:40:00,41,94,81,216,1296
2016-11-04 13:50:00,36,87,71,194,1164
2016-11-04 14:00:00,25,57,22,104,624
2016-11-04 14:10:00,29,64,28,121,726
2016-11-04 14:20:00,20,62,37,119,714
2016-11-04 14:30:00,24,65,37,126,756
2016-11-04 14:40:00,23,73,44,140,840
2016-11-04 14:50:00,15,76,48,139,834
2016-11-04 15:00:00,16,45,17,78,468
2016-11-04 15:10:00,13,38,13,64,384
2016-11-04 15:20:00,7,26,9,42,252
2016-11-04 15:30:00,10,36,17,63,378
2016-11-04 15:40:00,9,18,5,32,192
2016-11-04 15:50:00,3,7,0,10,60
2016-11-04 16:00:00,0,0,0,0,0
2016-11-04 16:10:00,0,0,0,0,0
2016-11-04 16:20:00,0,0,0,0,0
2016-11-04 16:30:00,0,0,0,0,0
2016-11-05 07:00:00,0,0,0,0,0
2016-11-05 07:10:00,0,0,0,0,0
2016-11-05 07:20:00,0,0,0,0,0
2016-11-05 07:30:00,0,0,0,0,0
2016-11-05 07:40:00,0,0,0,0,0
2016-11-05 07:50:00,1,2,0,3,18
2016-11-05 08:00:00,1,2,0,3,18
2016-11-05 08:10:00,3,5,0,8,48
2016-11-05 08:20:00,3,8,0,11,66
2016-11-05 08:30:00,9,19,5,33,198
2016-11-05 08:40:00,9,19,5,33,198
2016-11-05 08:50:00,11,36,15,62,372
2016-11-05 09:00:00,10,35,15,60,360
2016-11-05 09:10:00,13,39,17,69,414
2016-11-05 09:20:00,14,43,20,77,462
2016-11-05 09:30:00,16,34,9,59,354
2016-11-05 09:40:00,25,38,7,70,420
2016-11-05 09:50:00,7,31,14,52,312
2016-11-05 10:00:00,11,45,18,74,444
2016-11-05 10:10:00,10,41,21,72,432
2016-11-05 10:20:00,21,46,20,87,522
2016-11-05 10:30:00,24,51,23,98,588
2016-11-05 10:40:00,12,38,17,67,402
2016-11-05 10:50:00,8,31,14,53,318
2016-11-05 11:00:00,15,33,10,58,348
2016-11-05 11:10:00,37,57,15,109,654
2016-11-05 11:20:00,38,48,5,91,546
2016-11-05 11:30:00,16,28,9,53,318
2016-11-05 11:40:00,4,6,4,14,84
2016-11-05 11:50:00,10,17,4,31,186
2016-11-05 12:00:00,25,43,14,82,492
2016-11-05 12:10:00,29,43,20,92,552
2016-11-05 12:20:00,28,32,18,78,468
2016-11-05 12:30:00,13,11,8,32,192
2016-11-05 12:40:00,12,15,5,32,192
2016-11-05 12:50:00,14,27,9,50,300
2016-11-05 13:00:00,9,19,10,38,228
2016-11-05 13:10:00,10,13,7,30,180
2016-11-05 13:20:00,10,18,7,35,210
2016-11-05 13:30:00,2,1,1,4,24
2016-11-05 13:40:00,3,4,1,8,48
2016-11-05 13:50:00,6,10,2,18,108
2016-11-05 14:00:00,5,10,0,15,90
2016-11-05 14:10:00,0,1,0,1,6
2016-11-05 14:20:00,0,0,0,0,0
2016-11-05 14:30:00,0,0,0,0,0
2016-11-05 14:40:00,0,1,0,1,6
2016-11-05 14:50:00,1,3,0,4,24
2016-11-05 15:00:00,2,3,0,5,30
2016-11-05 15:10:00,23,64,23,110,660
2016-11-05 15:20:00,13,36,9,58,348
2016-11-05 15:30:00,0,1,0,1,6
2016-11-05 15:40:00,0,0,0,0,0
2016-11-05 15:50:00,0,0,0,0,0
2016-11-05 16:00:00,0,0,0,0,0
2016-11-06 07:00:00,0,0,0,0,0
2016-11-06 07:10:00,0,0,0,0,0
2016-11-06 07:20:00,0,0,0,0,0
2016-11-06 07:30:00,0,0,0,0,0
2016-11-06 07:40:00,0,0,0,0,0
2016-11-06 07:50:00,0,0,0,0,0
2016-11-06 08:00:00,0,0,0,0,0
2016-11-06 08:10:00,0,0,0,0,0
2016-11-06 08:20:00,2,3,0,5,30
2016-11-06 08:30:00,6,11,1,18,108
2016-11-06 08:40:00,7,24,8,39,234
2016-11-06 08:50:00,4,26,3,33,198
2016-11-06 09:00:00,6,23,5,34,204
2016-11-06 09:10:00,13,20,3,36,216
2016-11-06 09:20:00,13,34,17,64,384
2016-11-06 09:30:00,18,42,13,73,438
2016-11-06 09:40:00,13,44,21,78,468
2016-11-06 09:50:00,19,62,26,107,642
2016-11-06 10:00:00,13,35,18,66,396
2016-11-06 10:10:00,7,30,10,47,282
2016-11-06 10:20:00,8,38,22,68,408
2016-11-06 10:30:00,21,59,38,118,708
2016-11-06 10:40:00,24,80,65,169,1014
2016-11-06 10:50:00,26,56,37,119,714
2016-11-06 11:00:00,25,66,25,116,696
2016-11-06 11:10:00,25,74,37,136,816
2016-11-06 11:20:00,29,75,56,160,960
2016-11-06 11:30:00,22,71,28,121,726
2016-11-06 11:40:00,32,73,43,148,888
2016-11-06 11:50:00,38,67,50,155,930
2016-11-06 12:00:00,21,64,20,105,630
2016-11-06 12:10:00,19,36,16,71,426
2016-11-06 12:20:00,16,44,22,82,492
2016-11-06 12:30:00,22,51,31,104,624
2016-11-06 12:40:00,23,54,35,112,672
2016-11-06 12:50:00,32,59,32,123,738
2016-11-06 13:00:00,15,48,32,95,570
2016-11-06 13:10:00,17,40,25,82,492
2016-11-06 13:20:00,20,37,12,69,414
2016-11-06 13:30:00,30,62,23,115,690
2016-11-06 13:40:00,20,56,27,103,618
2016-11-06 13:50:00,22,32,6,60,360
2016-11-06 14:00:00,22,25,0,47,282
2016-11-06 14:10:00,23,28,0,51,306
2016-11-06 14:20:00,29,34,1,64,384
2016-11-06 14:30:00,13,18,0,31,186
2016-11-06 14:40:00,12,16,0,28,168
2016-11-06 14:50:00,7,9,0,16,96
2016-11-06 15:00:00,4,6,0,10,60
2016-11-06 15:10:00,1,2,0,3,18
2016-11-06 15:20:00,0,0,0,0,0
2016-11-06 15:30:00,0,0,0,0,0
2016-11-06 15:40:00,0,0,0,0,0
2016-11-06 15:50:00,0,0,0,0,0
2016-11-06 16:00:00,0,0,0,0,0
2016-11-06 16:10:00,0,0,0,0,0
2016-11-06 16:20:00,0,0,0,0,0
2016-11-07 07:00:00,0,0,0,0,0
2016-11-07 07:10:00,0,0,0,0,0
2016-11-07 07:20:00,0,0,0,0,0
2016-11-07 07:30:00,0,0,0,0,0
2016-11-07 07:40:00,0,0,0,0,0
2016-11-07 07:50:00,0,0,0,0,0
2016-11-07 08:00:00,0,0,0,0,0
2016-11-07 08:10:00,3,8,3,14,84
2016-11-07 08:20:00,6,15,7,28,168
2016-11-07 08:30:00,7,12,5,24,144
2016-11-07 08:40:00,9,13,9,31,186
2016-11-07 08:50:00,10,25,15,50,300
2016-11-07 09:00:00,18,37,23,78,468
2016-11-07 09:10:00,24,42,19,85,510
2016-11-07 09:20:00,21,35,11,67,402
2016-11-07 09:30:00,20,39,30,89,534
2016-11-07 09:40:00,15,24,21,60,360
2016-11-07 09:50:00,23,49,24,96,576
2016-11-07 10:00:00,46,118,113,277,1662
2016-11-07 10:10:00,52,82,53,187,1122
2016-11-07 10:20:00,45,82,56,183,1098
2016-11-07 10:30:00,55,94,87,236,1416
2016-11-07 10:40:00,50,76,54,180,1080
2016-11-07 10:50:00,51,67,45,163,978
2016-11-07 11:00:00,58,81,61,200,1200
2016-11-07 11:10:00,45,72,40,157,942
2016-11-07 11:20:00,30,55,36,121,726
2016-11-07 11:30:00,26,75,65,166,996
2016-11-07 11:40:00,60,83,62,205,1230
2016-11-07 11:50:00,61,83,78,222,1332
2016-11-07 12:00:00,53,91,82,226,1356
2016-11-07 12:10:00,6,124,133,263,1578
2016-11-07 12:20:00,38,123,115,276,1656
2016-11-07 12:30:00,16,133,130,279,1674
2016-11-07 12:40:00,8,161,147,316,1896
2016-11-07 12:50:00,15,158,144,317,1902
2016-11-07 13:00:00,76,138,121,335,2010
2016-11-07 13:10:00,69,137,124,330,1980
2016-11-07 13:20:00,55,86,68,209,1254
2016-11-07 13:30:00,33,57,25,115,690
2016-11-07 13:40:00,20,30,7,57,342
2016-11-07 13:50:00,18,30,8,56,336
2016-11-07 14:00:00,15,38,18,71,426
2016-11-07 14:10:00,13,30,11,54,324
2016-11-07 14:20:00,6,31,13,50,300
2016-11-07 14:30:00,7,30,10,47,282
2016-11-07 14:40:00,9,33,12,54,324
2016-11-07 14:50:00,9,24,7,40,240
2016-11-07 15:00:00,7,12,2,21,126
2016-11-07 15:10:00,2,3,0,5,30
2016-11-07 15:20:00,0,1,0,1,6
2016-11-07 15:30:00,0,0,0,0,0
2016-11-07 15:40:00,0,0,0,0,0
2016-11-07 15:50:00,0,0,0,0,0
2016-11-07 16:00:00,0,0,0,0,0
2016-11-07 16:10:00,0,0,0,0,0
2016-11-07 16:20:00,0,0,0,0,0
2016-11-08 07:10:00,0,0,0,0,0
2016-11-08 07:20:00,0,0,0,0,0
2016-11-08 07:30:00,0,0,0,0,0
2016-11-08 07:40:00,0,0,0,0,0
2016-11-08 07:50:00,0,0,0,0,0
2016-11-08 08:00:00,0,0,0,0,0
2016-11-08 08:10:00,1,2,1,4,24
2016-11-08 08:20:00,4,14,7,25,150
2016-11-08 08:30:00,4,24,10,38,228
2016-11-08 08:40:00,10,26,8,44,264
2016-11-08 08:50:00,17,31,11,59,354
2016-11-08 09:00:00,24,34,20,78,468
2016-11-08 09:10:00,17,42,17,76,456
2016-11-08 09:20:00,19,37,26,82,492
2016-11-08 09:30:00,21,48,35,104,624
2016-11-08 09:40:00,18,52,32,102,612
2016-11-08 09:50:00,13,96,20,129,774
2016-11-08 10:00:00,24,79,40,143,858
2016-11-08 10:10:00,11,94,14,119,714
2016-11-08 10:20:00,13,46,19,78,468
2016-11-08 10:30:00,24,63,34,121,726
2016-11-08 10:40:00,13,38,17,68,408
2016-11-08 10:50:00,11,26,11,48,288
2016-11-08 11:00:00,14,41,22,77,462
2016-11-08 11:10:00,14,49,31,94,564
2016-11-08 11:20:00,32,66,43,141,846
2016-11-08 11:30:00,24,55,28,107,642
2016-11-08 11:40:00,23,52,31,106,636
2016-11-08 11:50:00,20,50,36,106,636
2016-11-08 12:00:00,17,51,26,94,564
2016-11-08 12:10:00,33,65,39,137,822
2016-11-08 12:20:00,35,62,51,148,888
2016-11-08 12:30:00,41,68,58,167,1002
2016-11-08 12:40:00,66,82,45,193,1158
2016-11-08 12:50:00,38,84,81,203,1218
2016-11-08 13:00:00,30,89,88,207,1242
2016-11-08 13:10:00,13,103,91,207,1242
2016-11-08 13:20:00,54,95,83,232,1392
2016-11-08 13:30:00,28,90,68,186,1116
2016-11-08 13:40:00,27,79,54,160,960
2016-11-08 13:50:00,20,72,33,125,750
2016-11-08 14:00:00,24,53,24,101,606
2016-11-08 14:10:00,43,42,23,108,648
2016-11-08 14:20:00,34,61,22,117,702
2016-11-08 14:30:00,34,66,24,124,744
2016-11-08 14:40:00,25,58,20,103,618
2016-11-08 14:50:00,16,26,8,50,300
2016-11-08 15:00:00,8,18,3,29,174
2016-11-08 15:10:00,3,6,0,9,54
2016-11-08 15:20:00,0,0,0,0,0
2016-11-08 15:30:00,0,0,0,0,0
2016-11-08 15:40:00,0,0,0,0,0
2016-11-08 15:50:00,0,0,0,0,0
2016-11-08 16:00:00,0,0,0,0,0
2016-11-08 16:10:00,0,0,0,0,0
2016-11-08 16:20:00,0,0,0,0,0
2016-11-09 07:20:00,0,0,0,0,0
2016-11-09 07:30:00,0,0,0,0,0
2016-11-09 07:40:00,0,0,0,0,0
2016-11-09 07:50:00,0,0,0,0,0
2016-11-09 08:00:00,0,0,0,0,0
2016-11-09 08:10:00,0,0,0,0,0
2016-11-09 08:20:00,0,0,0,0,0
2016-11-09 08:30:00,0,0,0,0,0
2016-11-09 08:40:00,0,0,0,0,0
2016-11-09 08:50:00,2,1,3,6,36
2016-11-09 09:00:00,0,1,1,2,12
2016-11-09 09:10:00,1,4,2,7,42
2016-11-09 09:20:00,2,11,7,20,120
2016-11-09 09:30:00,3,7,6,16,96
2016-11-09 09:40:00,1,5,4,10,60
2016-11-09 09:50:00,3,11,5,19,114
2016-11-09 10:00:00,6,19,10,35,210
2016-11-09 10:10:00,12,39,19,70,420
2016-11-09 10:20:00,9,33,13,55,330
2016-11-09 10:30:00,14,37,24,75,450
2016-11-09 10:40:00,14,40,28,82,492
2016-11-09 10:50:00,10,48,32,90,540
2016-11-09 11:00:00,21,33,27,81,486
2016-11-09 11:10:00,27,52,33,112,672
2016-11-09 11:20:00,21,50,23,94,564
2016-11-09 11:30:00,22,52,28,102,612
2016-11-09 11:40:00,62,87,46,195,1170
2016-11-09 11:50:00,61,93,68,222,1332
2016-11-09 12:00:00,33,73,42,148,888
2016-11-09 12:10:00,25,71,39,135,810
2016-11-09 12:20:00,32,64,37,133,798
2016-11-09 12:30:00,97,140,92,329,1974
2016-11-09 12:40:00,59,121,108,288,1728
2016-11-09 12:50:00,42,90,78,210,1260
2016-11-09 13:00:00,68,104,89,261,1566
2016-11-09 13:10:00,27,73,49,149,894
2016-11-09 13:20:00,18,92,83,193,1158
2016-11-09 13:30:00,96,172,125,393,2358
2016-11-09 13:40:00,48,107,78,233,1398
2016-11-09 13:50:00,62,60,44,166,996
2016-11-09 14:00:00,44,36,17,97,582
2016-11-09 14:10:00,39,82,55,176,1056
2016-11-09 14:20:00,33,73,43,149,894
2016-11-09 14:30:00,23,43,14,80,480
2016-11-09 14:40:00,30,51,14,95,570
2016-11-09 14:50:00,8,25,10,43,258
2016-11-09 15:00:00,13,23,1,37,222
2016-11-09 15:10:00,0,0,0,0,0
2016-11-09 15:20:00,0,0,0,0,0
2016-11-09 15:30:00,0,0,0,0,0
2016-11-09 15:40:00,0,0,0,0,0
2016-11-09 15:50:00,0,0,0,0,0
2016-11-09 16:00:00,0,0,0,0,0
2016-11-09 16:10:00,0,0,0,0,0
2016-11-10 07:00:00,0,0,0,0,0
2016-11-10 07:10:00,0,0,0,0,0
2016-11-10 07:20:00,0,0,0,0,0
2016-11-10 07:30:00,0,0,0,0,0
2016-11-10 07:40:00,1,4,0,5,30
2016-11-10 07:50:00,6,19,9,34,204
2016-11-10 08:00:00,11,33,21,65,390
2016-11-10 08:10:00,30,60,44,134,804
2016-11-10 08:20:00,37,53,55,145,870
2016-11-10 08:30:00,34,56,51,141,846
2016-11-10 08:40:00,105,175,118,398,2388
2016-11-10 08:50:00,237,259,252,748,4488
2016-11-10 09:00:00,294,315,309,918,5508
2016-11-10 09:10:00,307,326,320,953,5718
2016-11-10 09:20:00,424,448,440,1312,7872
2016-11-10 09:30:00,453,475,465,1393,8358
2016-11-10 09:40:00,516,537,524,1577,9462
2016-11-10 09:50:00,552,575,568,1695,10170
2016-11-10 10:00:00,533,557,551,1641,9846
2016-11-10 10:10:00,343,367,358,1068,6408
2016-11-10 10:20:00,379,399,388,1166,6996
2016-11-10 10:30:00,350,371,365,1086,6516
2016-11-10 10:40:00,325,345,339,1009,6054
2016-11-10 10:50:00,313,333,327,973,5838
2016-11-10 11:00:00,307,329,321,957,5742
2016-11-10 11:10:00,297,318,310,925,5550
2016-11-10 11:20:00,328,349,340,1017,6102
2016-11-10 11:30:00,333,357,347,1037,6222
2016-11-10 11:40:00,328,354,344,1026,6156
2016-11-10 11:50:00,360,383,373,1116,6696
2016-11-10 12:00:00,442,471,456,1369,8214
2016-11-10 12:10:00,555,584,573,1712,10272
2016-11-10 12:20:00,625,652,640,1917,11502
2016-11-10 12:30:00,573,595,584,1752,10512
2016-11-10 12:40:00,519,545,532,1596,9576
2016-11-10 12:50:00,508,535,522,1565,9390
2016-11-10 13:00:00,498,523,511,1532,9192
2016-11-10 13:10:00,415,436,428,1279,7674
2016-11-10 13:20:00,274,296,287,857,5142
2016-11-10 13:30:00,208,228,223,659,3954
2016-11-10 13:40:00,200,220,214,634,3804
2016-11-10 13:50:00,110,123,121,354,2124
2016-11-10 14:00:00,159,173,167,499,2994
2016-11-10 14:10:00,140,160,151,451,2706
2016-11-10 14:20:00,62,112,107,281,1686
2016-11-10 14:30:00,41,100,75,216,1296
2016-11-10 14:40:00,25,88,62,175,1050
2016-11-10 14:50:00,27,76,46,149,894
2016-11-10 15:00:00,18,80,56,154,924
2016-11-10 15:10:00,7,27,10,44,264
2016-11-10 15:20:00,7,32,14,53,318
2016-11-10 15:30:00,4,10,1,15,90
2016-11-10 15:40:00,0,2,0,2,12
2016-11-10 15:50:00,0,0,0,0,0
2016-11-10 16:00:00,0,0,0,0,0
2016-11-10 16:10:00,0,0,0,0,0
2016-11-10 16:20:00,0,0,0,0,0
2016-11-11 07:00:00,0,0,0,0,0
2016-11-11 07:10:00,0,0,0,0,0
2016-11-11 07:20:00,0,0,0,0,0
2016-11-11 07:30:00,0,0,0,0,0
2016-11-11 07:40:00,2,5,0,7,42
2016-11-11 07:50:00,5,10,3,18,108
2016-11-11 08:00:00,6,17,8,31,186
2016-11-11 08:10:00,8,26,12,46,276
2016-11-11 08:20:00,15,33,15,63,378
2016-11-11 08:30:00,24,35,22,81,486
2016-11-11 08:40:00,151,119,101,371,2226
2016-11-11 08:50:00,297,289,295,881,5286
2016-11-11 09:00:00,360,384,376,1120,6720
2016-11-11 09:10:00,419,443,435,1297,7782
2016-11-11 09:20:00,470,488,486,1444,8664
2016-11-11 09:30:00,522,541,534,1597,9582
2016-11-11 09:40:00,568,588,578,1734,10404
2016-11-11 09:50:00,596,617,609,1822,10932
2016-11-11 10:00:00,595,620,608,1823,10938
2016-11-11 10:10:00,216,237,230,683,4098
2016-11-11 10:20:00,207,227,221,655,3930
2016-11-11 10:30:00,323,343,338,1004,6024
2016-11-11 10:40:00,329,349,340,1018,6108
2016-11-11 10:50:00,421,441,432,1294,7764
2016-11-11 11:00:00,215,237,231,683,4098
2016-11-11 11:10:00,107,165,153,425,2550
2016-11-11 11:20:00,156,177,173,506,3036
2016-11-11 11:30:00,247,268,263,778,4668
2016-11-11 11:40:00,294,314,308,916,5496
2016-11-11 11:50:00,239,257,252,748,4488
2016-11-11 12:00:00,296,313,309,918,5508
2016-11-11 12:10:00,329,346,337,1012,6072
2016-11-11 12:20:00,607,623,617,1847,11082
2016-11-11 12:30:00,666,683,676,2025,12150
2016-11-11 12:40:00,664,679,670,2013,12078
2016-11-11 12:50:00,599,611,594,1804,10824
2016-11-11 13:00:00,549,562,548,1659,9954
2016-11-11 13:10:00,505,521,504,1530,9180
2016-11-11 13:20:00,474,495,484,1453,8718
2016-11-11 13:30:00,231,253,243,727,4362
2016-11-11 13:40:00,151,180,166,497,2982
2016-11-11 13:50:00,238,262,249,749,4494
2016-11-11 14:00:00,120,140,133,393,2358
2016-11-11 14:10:00,36,78,62,176,1056
2016-11-11 14:20:00,15,53,31,99,594
2016-11-11 14:30:00,11,68,24,103,618
2016-11-11 14:40:00,13,56,31,100,600
2016-11-11 14:50:00,7,50,25,82,492
2016-11-11 15:00:00,7,40,21,68,408
2016-11-11 15:10:00,5,35,14,54,324
2016-11-11 15:20:00,8,25,9,42,252
2016-11-11 15:30:00,5,20,4,29,174
2016-11-11 15:40:00,2,13,0,15,90
2016-11-11 15:50:00,1,1,0,2,12
2016-11-11 16:00:00,0,0,0,0,0
2016-11-11 16:10:00,0,0,0,0,0
2016-11-11 16:20:00,0,0,0,0,0
2016-11-12 07:00:00,0,0,0,0,0
2016-11-12 07:10:00,0,0,0,0,0
2016-11-12 07:20:00,0,0,0,0,0
2016-11-12 07:30:00,0,0,0,0,0
2016-11-12 07:40:00,1,1,0,2,12
2016-11-12 07:50:00,4,7,0,11,66
2016-11-12 08:00:00,5,18,2,25,150
2016-11-12 08:10:00,4,31,7,42,252
2016-11-12 08:20:00,8,36,14,58,348
2016-11-12 08:30:00,10,45,21,76,456
2016-11-12 08:40:00,52,168,72,292,1752
2016-11-12 08:50:00,256,264,231,751,4506
2016-11-12 09:00:00,321,343,326,990,5940
2016-11-12 09:10:00,387,410,393,1190,7140
2016-11-12 09:20:00,464,485,466,1415,8490
2016-11-12 09:30:00,498,516,501,1515,9090
2016-11-12 09:40:00,562,574,563,1699,10194
2016-11-12 09:50:00,593,612,598,1803,10818
2016-11-12 10:00:00,595,613,594,1802,10812
2016-11-12 10:10:00,504,525,504,1533,9198
2016-11-12 10:20:00,386,403,393,1182,7092
2016-11-12 10:30:00,349,366,355,1070,6420
2016-11-12 10:40:00,317,333,329,979,5874
2016-11-12 10:50:00,292,307,306,905,5430
2016-11-12 11:00:00,279,295,294,868,5208
2016-11-12 11:10:00,265,282,278,825,4950
2016-11-12 11:20:00,294,313,306,913,5478
2016-11-12 11:30:00,300,323,314,937,5622
2016-11-12 11:40:00,305,327,319,951,5706
2016-11-12 11:50:00,324,343,334,1001,6006
2016-11-12 12:00:00,412,432,418,1262,7572
2016-11-12 12:10:00,502,517,507,1526,9156
2016-11-12 12:20:00,649,670,650,1969,11814
2016-11-12 12:30:00,650,670,646,1966,11796
2016-11-12 12:40:00,597,613,596,1806,10836
2016-11-12 12:50:00,573,589,573,1735,10410
2016-11-12 13:00:00,522,544,531,1597,9582
2016-11-12 13:10:00,470,486,476,1432,8592
2016-11-12 13:20:00,404,422,412,1238,7428
2016-11-12 13:30:00,274,295,285,854,5124
2016-11-12 13:40:00,271,289,278,838,5028
2016-11-12 13:50:00,224,242,231,697,4182
2016-11-12 14:00:00,124,141,136,401,2406
2016-11-12 14:10:00,43,63,38,144,864
2016-11-12 14:20:00,27,69,22,118,708
2016-11-12 14:30:00,10,103,9,122,732
2016-11-12 14:40:00,25,67,33,125,750
2016-11-12 14:50:00,36,61,18,115,690
2016-11-12 15:00:00,21,36,9,66,396
2016-11-12 15:10:00,8,14,2,24,144
2016-11-12 15:20:00,5,9,0,14,84
2016-11-12 15:30:00,2,4,0,6,36
2016-11-12 15:40:00,0,0,0,0,0
2016-11-12 15:50:00,0,0,0,0,0
2016-11-12 16:00:00,0,0,0,0,0
2016-11-12 16:10:00,0,0,0,0,0
2016-11-13 07:10:00,0,0,0,0,0
2016-11-13 07:20:00,0,0,0,0,0
2016-11-13 07:30:00,0,0,0,0,0
2016-11-13 07:40:00,0,0,0,0,0
2016-11-13 07:50:00,2,4,0,6,36
2016-11-13 08:00:00,8,16,2,26,156
2016-11-13 08:10:00,9,28,9,46,276
2016-11-13 08:20:00,10,37,17,64,384
2016-11-13 08:30:00,9,49,22,80,480
2016-11-13 08:40:00,16,66,25,107,642
2016-11-13 08:50:00,44,82,41,167,1002
2016-11-13 09:00:00,38,142,121,301,1806
2016-11-13 09:10:00,169,257,88,514,3084
2016-11-13 09:20:00,129,227,119,475,2850
2016-11-13 09:30:00,170,307,35,512,3072
2016-11-13 09:40:00,173,276,100,549,3294
2016-11-13 09:50:00,210,170,239,619,3714
2016-11-13 10:00:00,223,244,234,701,4206
2016-11-13 10:10:00,221,261,218,700,4200
2016-11-13 10:20:00,335,359,343,1037,6222
2016-11-13 10:30:00,243,264,254,761,4566
2016-11-13 10:40:00,253,272,264,789,4734
2016-11-13 10:50:00,217,240,233,690,4140
2016-11-13 11:00:00,188,212,205,605,3630
2016-11-13 11:10:00,168,233,140,541,3246
2016-11-13 11:20:00,113,225,92,430,2580
2016-11-13 11:30:00,73,156,162,391,2346
2016-11-13 11:40:00,95,133,149,377,2262
2016-11-13 11:50:00,90,149,146,385,2310
2016-11-13 12:00:00,152,96,151,399,2394
2016-11-13 12:10:00,178,88,154,420,2520
2016-11-13 12:20:00,209,125,90,424,2544
2016-11-13 12:30:00,150,288,0,438,2628
2016-11-13 12:40:00,154,304,0,458,2748
2016-11-13 12:50:00,173,290,5,468,2808
2016-11-13 13:00:00,174,334,9,517,3102
2016-11-13 13:10:00,230,244,227,701,4206
2016-11-13 13:20:00,395,411,399,1205,7230
2016-11-13 13:30:00,402,422,410,1234,7404
2016-11-13 13:40:00,301,318,308,927,5562
2016-11-13 13:50:00,220,236,226,682,4092
2016-11-13 14:00:00,122,137,132,391,2346
2016-11-13 14:10:00,86,101,98,285,1710
2016-11-13 14:20:00,76,92,86,254,1524
2016-11-13 14:30:00,38,74,44,156,936
2016-11-13 14:40:00,25,52,36,113,678
2016-11-13 14:50:00,26,52,21,99,594
2016-11-13 15:00:00,13,44,23,80,480
2016-11-13 15:10:00,8,36,19,63,378
2016-11-13 15:20:00,6,29,9,44,264
2016-11-13 15:30:00,6,18,3,27,162
2016-11-13 15:40:00,2,8,0,10,60
2016-11-13 15:50:00,0,0,0,0,0
2016-11-13 16:00:00,0,0,0,0,0
2016-11-13 16:10:00,0,0,0,0,0
2016-11-13 16:20:00,0,0,0,0,0
2016-11-14 07:10:00,0,0,0,0,0
2016-11-14 07:20:00,0,0,0,0,0
2016-11-14 07:30:00,0,0,0,0,0
2016-11-14 07:40:00,0,0,0,0,0
2016-11-14 07:50:00,3,7,6,16,96
2016-11-14 08:00:00,8,21,14,43,258
2016-11-14 08:10:00,17,29,27,73,438
2016-11-14 08:20:00,29,37,35,101,606
2016-11-14 08:30:00,26,70,28,124,744
2016-11-14 08:40:00,38,63,55,156,936
2016-11-14 08:50:00,110,123,101,334,2004
2016-11-14 09:00:00,266,237,235,738,4428
2016-11-14 09:10:00,307,328,322,957,5742
2016-11-14 09:20:00,351,370,364,1085,6510
2016-11-14 09:30:00,402,417,415,1234,7404
2016-11-14 09:40:00,390,409,402,1201,7206
2016-11-14 09:50:00,452,488,478,1418,8508
2016-11-14 10:00:00,502,530,522,1554,9324
2016-11-14 10:10:00,458,482,473,1413,8478
2016-11-14 10:20:00,218,214,232,664,3984
2016-11-14 10:30:00,148,183,130,461,2766
2016-11-14 10:40:00,218,226,234,678,4068
2016-11-14 10:50:00,186,201,150,537,3222
2016-11-14 11:00:00,217,131,195,543,3258
2016-11-14 11:10:00,86,105,93,284,1704
2016-11-14 11:20:00,91,115,107,313,1878
2016-11-14 11:30:00,66,157,116,339,2034
2016-11-14 11:40:00,76,77,117,270,1620
2016-11-14 11:50:00,90,70,94,254,1524
2016-11-14 12:00:00,55,77,73,205,1230
2016-11-14 12:10:00,25,75,73,173,1038
2016-11-14 12:20:00,32,71,59,162,972
2016-11-14 12:30:00,31,69,39,139,834
2016-11-14 12:40:00,39,78,47,164,984
2016-11-14 12:50:00,34,68,39,141,846
2016-11-14 13:00:00,34,69,64,167,1002
2016-11-14 13:10:00,27,82,68,177,1062
2016-11-14 13:20:00,24,74,37,135,810
2016-11-14 13:30:00,28,59,25,112,672
2016-11-14 13:40:00,39,53,16,108,648
2016-11-14 13:50:00,26,44,14,84,504
2016-11-14 14:00:00,19,43,15,77,462
2016-11-14 14:10:00,14,41,17,72,432
2016-11-14 14:20:00,6,30,13,49,294
2016-11-14 14:30:00,4,21,3,28,168
2016-11-14 14:40:00,1,8,0,9,54
2016-11-14 14:50:00,0,1,0,1,6
2016-11-14 15:00:00,0,0,0,0,0
2016-11-14 15:10:00,0,0,0,0,0
2016-11-14 15:20:00,0,0,0,0,0
2016-11-14 15:30:00,0,0,0,0,0
2016-11-14 15:40:00,0,0,0,0,0
2016-11-14 15:50:00,0,0,0,0,0
2016-11-15 07:20:00,0,0,0,0,0
2016-11-15 07:30:00,0,0,0,0,0
2016-11-15 07:40:00,0,0,0,0,0
2016-11-15 07:50:00,0,0,0,0,0
2016-11-15 08:00:00,1,1,0,2,12
2016-11-15 08:10:00,3,5,3,11,66
2016-11-15 08:20:00,5,10,6,21,126
2016-11-15 08:30:00,4,6,3,13,78
2016-11-15 08:40:00,2,3,2,7,42
2016-11-15 08:50:00,1,2,1,4,24
2016-11-15 09:00:00,6,9,7,22,132
2016-11-15 09:10:00,6,8,7,21,126
2016-11-15 09:20:00,14,22,13,49,294
2016-11-15 09:30:00,14,31,23,68,408
2016-11-15 09:40:00,24,61,19,104,624
2016-11-15 09:50:00,21,40,26,87,522
2016-11-15 10:00:00,11,19,9,39,234
2016-11-15 10:10:00,12,16,10,38,228
2016-11-15 10:20:00,15,19,15,49,294
2016-11-15 10:30:00,20,29,20,69,414
2016-11-15 10:40:00,16,28,15,59,354
2016-11-15 10:50:00,17,34,13,64,384
2016-11-15 11:00:00,20,32,19,71,426
2016-11-15 11:10:00,30,66,36,132,792
2016-11-15 11:20:00,46,70,26,142,852
2016-11-15 11:30:00,27,66,27,120,720
2016-11-15 11:40:00,52,124,90,266,1596
2016-11-15 11:50:00,79,101,53,233,1398
2016-11-15 12:00:00,46,76,32,154,924
2016-11-15 12:10:00,49,70,55,174,1044
2016-11-15 12:20:00,31,74,61,166,996
2016-11-15 12:30:00,36,66,47,149,894
2016-11-15 12:40:00,27,56,33,116,696
2016-11-15 12:50:00,26,55,32,113,678
2016-11-15 13:00:00,21,51,21,93,558
2016-11-15 13:10:00,19,29,19,67,402
2016-11-15 13:20:00,16,22,10,48,288
2016-11-15 13:30:00,15,24,16,55,330
2016-11-15 13:40:00,12,19,11,42,252
2016-11-15 13:50:00,30,69,40,139,834
2016-11-15 14:00:00,23,66,22,111,666
2016-11-15 14:10:00,31,115,101,247,1482
2016-11-15 14:20:00,29,52,21,102,612
2016-11-15 14:30:00,14,28,9,51,306
2016-11-15 14:40:00,6,8,1,15,90
2016-11-15 14:50:00,1,2,0,3,18
2016-11-15 15:00:00,0,0,0,0,0
2016-11-15 15:10:00,0,0,0,0,0
2016-11-15 15:20:00,0,0,0,0,0
2016-11-15 15:30:00,0,0,0,0,0
2016-11-15 15:40:00,0,0,0,0,0
2016-11-15 15:50:00,0,0,0,0,0
2016-11-15 16:00:00,0,0,0,0,0
2016-11-15 16:10:00,0,0,0,0,0
2016-11-16 07:10:00,0,0,0,0,0
2016-11-16 07:20:00,0,0,0,0,0
2016-11-16 07:30:00,0,0,0,0,0
2016-11-16 07:40:00,0,0,0,0,0
2016-11-16 07:50:00,0,1,1,2,12
2016-11-16 08:00:00,3,8,5,16,96
2016-11-16 08:10:00,6,13,9,28,168
2016-11-16 08:20:00,17,23,23,63,378
2016-11-16 08:30:00,23,44,29,96,576
2016-11-16 08:40:00,25,55,31,111,666
2016-11-16 08:50:00,26,52,24,102,612
2016-11-16 09:00:00,20,77,43,140,840
2016-11-16 09:10:00,38,83,49,170,1020
2016-11-16 09:20:00,39,62,44,145,870
2016-11-16 09:30:00,36,65,44,145,870
2016-11-16 09:40:00,82,94,83,259,1554
2016-11-16 09:50:00,71,91,66,228,1368
2016-11-16 10:00:00,62,88,75,225,1350
2016-11-16 10:10:00,58,85,65,208,1248
2016-11-16 10:20:00,30,68,77,175,1050
2016-11-16 10:30:00,50,68,73,191,1146
2016-11-16 10:40:00,77,105,98,280,1680
2016-11-16 10:50:00,63,81,65,209,1254
2016-11-16 11:00:00,40,68,56,164,984
2016-11-16 11:10:00,21,81,20,122,732
2016-11-16 11:20:00,26,59,27,112,672
2016-11-16 11:30:00,26,44,27,97,582
2016-11-16 11:40:00,24,49,23,96,576
2016-11-16 11:50:00,22,38,42,102,612
2016-11-16 12:00:00,33,55,20,108,648
2016-11-16 12:10:00,44,73,34,151,906
2016-11-16 12:20:00,43,64,25,132,792
2016-11-16 12:30:00,39,72,35,146,876
2016-11-16 12:40:00,36,66,34,136,816
2016-11-16 12:50:00,50,69,53,172,1032
2016-11-16 13:00:00,24,36,24,84,504
2016-11-16 13:10:00,27,48,15,90,540
2016-11-16 13:20:00,23,62,17,102,612
2016-11-16 13:30:00,11,19,7,37,222
2016-11-16 13:40:00,4,6,2,12,72
2016-11-16 13:50:00,9,17,5,31,186
2016-11-16 14:00:00,16,31,10,57,342
2016-11-16 14:10:00,28,61,32,121,726
2016-11-16 14:20:00,15,27,8,50,300
2016-11-16 14:30:00,5,8,0,13,78
2016-11-16 14:40:00,8,12,2,22,132
2016-11-16 14:50:00,5,10,2,17,102
2016-11-16 15:00:00,0,0,0,0,0
2016-11-16 15:10:00,1,3,0,4,24
2016-11-16 15:20:00,0,0,0,0,0
2016-11-16 15:30:00,0,0,0,0,0
2016-11-16 15:40:00,0,0,0,0,0
2016-11-16 15:50:00,0,0,0,0,0
2016-11-16 16:00:00,0,0,0,0,0
2016-11-16 16:10:00,0,0,0,0,0
2016-11-17 07:10:00,0,0,0,0,0
2016-11-17 07:20:00,0,0,0,0,0
2016-11-17 07:30:00,0,0,0,0,0
2016-11-17 07:40:00,0,0,0,0,0
2016-11-17 07:50:00,5,8,9,22,132
2016-11-17 08:00:00,12,23,15,50,300
2016-11-17 08:10:00,16,22,19,57,342
2016-11-17 08:20:00,24,46,29,99,594
2016-11-17 08:30:00,34,57,35,126,756
2016-11-17 08:40:00,49,56,51,156,936
2016-11-17 08:50:00,76,104,102,282,1692
2016-11-17 09:00:00,208,193,214,615,3690
2016-11-17 09:10:00,268,289,286,843,5058
2016-11-17 09:20:00,35,86,84,205,1230
2016-11-17 09:30:00,216,235,231,682,4092
2016-11-17 09:40:00,286,308,302,896,5376
2016-11-17 09:50:00,443,463,455,1361,8166
2016-11-17 10:00:00,478,499,494,1471,8826
2016-11-17 10:10:00,276,297,294,867,5202
2016-11-17 10:20:00,394,417,412,1223,7338
2016-11-17 10:30:00,406,429,424,1259,7554
2016-11-17 10:40:00,311,332,326,969,5814
2016-11-17 10:50:00,310,329,323,962,5772
2016-11-17 11:00:00,356,380,373,1109,6654
2016-11-17 11:10:00,314,337,331,982,5892
2016-11-17 11:20:00,235,260,255,750,4500
2016-11-17 11:30:00,282,302,296,880,5280
2016-11-17 11:40:00,229,249,242,720,4320
2016-11-17 11:50:00,163,182,169,514,3084
2016-11-17 12:00:00,268,287,281,836,5016
2016-11-17 12:10:00,283,303,299,885,5310
2016-11-17 12:20:00,376,394,386,1156,6936
2016-11-17 12:30:00,455,471,464,1390,8340
2016-11-17 12:40:00,102,124,119,345,2070
2016-11-17 12:50:00,36,61,39,136,816
2016-11-17 13:00:00,42,68,64,174,1044
2016-11-17 13:10:00,37,62,49,148,888
2016-11-17 13:20:00,61,80,72,213,1278
2016-11-17 13:30:00,49,106,104,259,1554
2016-11-17 13:40:00,31,74,66,171,1026
2016-11-17 13:50:00,22,103,84,209,1254
2016-11-17 14:00:00,17,41,16,74,444
2016-11-17 14:10:00,10,19,6,35,210
2016-11-17 14:20:00,9,13,1,23,138
2016-11-17 14:30:00,29,43,11,83,498
2016-11-17 14:40:00,29,45,11,85,510
2016-11-17 14:50:00,34,47,16,97,582
2016-11-17 15:00:00,27,40,18,85,510
2016-11-17 15:10:00,13,35,15,63,378
2016-11-17 15:20:00,8,26,10,44,264
2016-11-17 15:30:00,4,5,2,11,66
2016-11-17 15:40:00,0,0,0,0,0
2016-11-17 15:50:00,0,0,0,0,0
2016-11-17 16:00:00,0,0,0,0,0
2016-11-17 16:10:00,0,0,0,0,0
2016-11-18 07:30:00,0,0,0,0,0
2016-11-18 07:40:00,0,0,0,0,0
2016-11-18 07:50:00,0,0,0,0,0
2016-11-18 08:00:00,0,0,0,0,0
2016-11-18 08:10:00,0,0,0,0,0
2016-11-18 08:20:00,0,0,0,0,0
2016-11-18 08:30:00,1,2,0,3,18
2016-11-18 08:40:00,3,6,3,12,72
2016-11-18 08:50:00,2,3,2,7,42
2016-11-18 09:00:00,19,34,12,65,390
2016-11-18 09:10:00,36,57,32,125,750
2016-11-18 09:20:00,22,28,27,77,462
2016-11-18 09:30:00,52,52,57,161,966
2016-11-18 09:40:00,93,97,101,291,1746
2016-11-18 09:50:00,150,168,168,486,2916
2016-11-18 10:00:00,75,82,89,246,1476
2016-11-18 10:10:00,42,49,38,129,774
2016-11-18 10:20:00,58,75,55,188,1128
2016-11-18 10:30:00,51,76,57,184,1104
2016-11-18 10:40:00,44,69,47,160,960
2016-11-18 10:50:00,15,22,10,47,282
2016-11-18 11:00:00,18,28,16,62,372
2016-11-18 11:10:00,18,48,34,100,600
2016-11-18 11:20:00,56,51,66,173,1038
2016-11-18 11:30:00,28,33,31,92,552
2016-11-18 11:40:00,32,32,35,99,594
2016-11-18 11:50:00,40,45,29,114,684
2016-11-18 12:00:00,66,84,63,213,1278
2016-11-18 12:10:00,55,64,48,167,1002
2016-11-18 12:20:00,132,109,106,347,2082
2016-11-18 12:30:00,86,78,91,255,1530
2016-11-18 12:40:00,94,101,99,294,1764
2016-11-18 12:50:00,293,288,269,850,5100
2016-11-18 13:00:00,508,523,519,1550,9300
2016-11-18 13:10:00,315,333,330,978,5868
2016-11-18 13:20:00,298,319,312,929,5574
2016-11-18 13:30:00,234,252,248,734,4404
2016-11-18 13:40:00,225,247,243,715,4290
2016-11-18 13:50:00,181,235,142,558,3348
2016-11-18 14:00:00,67,131,84,282,1692
2016-11-18 14:10:00,33,83,73,189,1134
2016-11-18 14:20:00,36,67,43,146,876
2016-11-18 14:30:00,19,50,24,93,558
2016-11-18 14:40:00,19,45,17,81,486
2016-11-18 14:50:00,17,41,11,69,414
2016-11-18 15:00:00,7,34,16,57,342
2016-11-18 15:10:00,8,28,11,47,282
2016-11-18 15:20:00,7,18,5,30,180
2016-11-18 15:30:00,0,2,0,2,12
2016-11-18 15:40:00,0,0,0,0,0
2016-11-18 15:50:00,0,0,0,0,0
2016-11-18 16:00:00,0,0,0,0,0
2016-11-18 16:10:00,0,0,0,0,0
2016-11-19 07:20:00,0,0,0,0,0
2016-11-19 07:30:00,0,0,0,0,0
2016-11-19 07:40:00,0,0,0,0,0
2016-11-19 07:50:00,0,0,0,0,0
2016-11-19 08:00:00,0,1,0,1,6
2016-11-19 08:10:00,8,21,6,35,210
2016-11-19 08:20:00,23,42,29,94,564
2016-11-19 08:30:00,28,58,52,138,828
2016-11-19 08:40:00,22,110,99,231,1386
2016-11-19 08:50:00,8,143,138,289,1734
2016-11-19 09:00:00,172,251,160,583,3498
2016-11-19 09:10:00,284,305,293,882,5292
2016-11-19 09:20:00,348,368,356,1072,6432
2016-11-19 09:30:00,189,214,200,603,3618
2016-11-19 09:40:00,34,75,47,156,936
2016-11-19 09:50:00,76,143,91,310,1860
2016-11-19 10:00:00,44,109,82,235,1410
2016-11-19 10:10:00,154,174,157,485,2910
2016-11-19 10:20:00,93,137,118,348,2088
2016-11-19 10:30:00,27,119,100,246,1476
2016-11-19 10:40:00,306,323,307,936,5616
2016-11-19 10:50:00,142,165,155,462,2772
2016-11-19 11:00:00,118,137,134,389,2334
2016-11-19 11:10:00,76,99,89,264,1584
2016-11-19 11:20:00,28,64,39,131,786
2016-11-19 11:30:00,39,66,39,144,864
2016-11-19 11:40:00,20,42,15,77,462
2016-11-19 11:50:00,17,42,23,82,492
2016-11-19 12:00:00,37,63,54,154,924
2016-11-19 12:10:00,35,58,48,141,846
2016-11-19 12:20:00,35,82,51,168,1008
2016-11-19 12:30:00,52,120,110,282,1692
2016-11-19 12:40:00,142,165,153,460,2760
2016-11-19 12:50:00,289,308,302,899,5394
2016-11-19 13:00:00,363,383,375,1121,6726
2016-11-19 13:10:00,419,434,427,1280,7680
2016-11-19 13:20:00,368,382,376,1126,6756
2016-11-19 13:30:00,167,188,170,525,3150
2016-11-19 13:40:00,114,124,127,365,2190
2016-11-19 13:50:00,106,123,85,314,1884
2016-11-19 14:00:00,47,100,77,224,1344
2016-11-19 14:10:00,40,91,63,194,1164
2016-11-19 14:20:00,70,50,23,143,858
2016-11-19 14:30:00,24,38,18,80,480
2016-11-19 14:40:00,19,35,9,63,378
2016-11-19 14:50:00,6,16,4,26,156
2016-11-19 15:00:00,6,11,2,19,114
2016-11-19 15:10:00,3,6,0,9,54
2016-11-19 15:20:00,1,0,0,1,6
2016-11-19 15:30:00,0,0,0,0,0
2016-11-19 15:40:00,0,0,0,0,0
2016-11-19 15:50:00,0,0,0,0,0
2016-11-20 07:20:00,0,0,0,0,0
2016-11-20 07:30:00,0,0,0,0,0
2016-11-20 07:40:00,0,0,0,0,0
2016-11-20 07:50:00,0,0,0,0,0
2016-11-20 08:00:00,0,0,0,0,0
2016-11-20 08:10:00,4,8,1,13,78
2016-11-20 08:20:00,12,20,9,41,246
2016-11-20 08:30:00,16,42,29,87,522
2016-11-20 08:40:00,28,70,40,138,828
2016-11-20 08:50:00,48,89,53,190,1140
2016-11-20 09:00:00,29,117,99,245,1470
2016-11-20 09:10:00,67,156,118,341,2046
2016-11-20 09:20:00,220,216,215,651,3906
2016-11-20 09:30:00,90,111,103,304,1824
2016-11-20 09:40:00,5,131,130,266,1596
2016-11-20 09:50:00,115,198,182,495,2970
2016-11-20 10:00:00,260,280,271,811,4866
2016-11-20 10:10:00,234,253,245,732,4392
2016-11-20 10:20:00,254,272,263,789,4734
2016-11-20 10:30:00,210,228,221,659,3954
2016-11-20 10:40:00,267,285,277,829,4974
2016-11-20 10:50:00,124,143,138,405,2430
2016-11-20 11:00:00,53,129,120,302,1812
2016-11-20 11:10:00,8,132,143,283,1698
2016-11-20 11:20:00,40,139,132,311,1866
2016-11-20 11:30:00,48,117,109,274,1644
2016-11-20 11:40:00,39,100,86,225,1350
2016-11-20 11:50:00,19,101,84,204,1224
2016-11-20 12:00:00,37,71,35,143,858
2016-11-20 12:10:00,30,68,24,122,732
2016-11-20 12:20:00,48,66,23,137,822
2016-11-20 12:30:00,24,126,105,255,1530
2016-11-20 12:40:00,18,112,107,237,1422
2016-11-20 12:50:00,24,74,46,144,864
2016-11-20 13:00:00,15,39,16,70,420
2016-11-20 13:10:00,13,33,11,57,342
2016-11-20 13:20:00,16,33,9,58,348
2016-11-20 13:30:00,15,21,2,38,228
2016-11-20 13:40:00,6,9,1,16,96
2016-11-20 13:50:00,3,4,0,7,42
2016-11-20 14:00:00,3,5,0,8,48
2016-11-20 14:10:00,12,21,5,38,228
2016-11-20 14:20:00,10,19,3,32,192
2016-11-20 14:30:00,16,22,3,41,246
2016-11-20 14:40:00,3,4,0,7,42
2016-11-20 14:50:00,0,0,0,0,0
2016-11-20 15:00:00,0,0,0,0,0
2016-11-20 15:10:00,0,0,0,0,0
2016-11-20 15:20:00,0,0,0,0,0
2016-11-20 15:30:00,0,0,0,0,0
2016-11-20 15:40:00,0,0,0,0,0
2016-11-20 15:50:00,0,0,0,0,0
2016-11-21 07:30:00,0,0,0,0,0
2016-11-21 07:40:00,0,0,0,0,0
2016-11-21 07:50:00,0,0,0,0,0
2016-11-21 08:00:00,0,0,0,0,0
2016-11-21 08:10:00,0,0,0,0,0
2016-11-21 08:20:00,1,3,2,6,36
2016-11-21 08:30:00,3,7,6,16,96
2016-11-21 08:40:00,1,4,2,7,42
2016-11-21 08:50:00,0,4,1,5,30
2016-11-21 09:00:00,3,12,5,20,120
2016-11-21 09:10:00,3,14,6,23,138
2016-11-21 09:20:00,8,21,15,44,264
2016-11-21 09:30:00,18,29,22,69,414
2016-11-21 09:40:00,11,21,12,44,264
2016-11-21 09:50:00,14,30,18,62,372
2016-11-21 10:00:00,11,40,18,69,414
2016-11-21 10:10:00,14,32,20,66,396
2016-11-21 10:20:00,9,19,6,34,204
2016-11-21 10:30:00,7,15,5,27,162
2016-11-21 10:40:00,13,25,6,44,264
2016-11-21 10:50:00,10,31,13,54,324
2016-11-21 11:00:00,26,61,29,116,696
2016-11-21 11:10:00,45,75,51,171,1026
2016-11-21 11:20:00,63,102,95,260,1560
2016-11-21 11:30:00,57,85,66,208,1248
2016-11-21 11:40:00,45,66,50,161,966
2016-11-21 11:50:00,25,64,34,123,738
2016-11-21 12:00:00,20,74,57,151,906
2016-11-21 12:10:00,19,47,19,85,510
2016-11-21 12:20:00,29,66,25,120,720
2016-11-21 12:30:00,45,94,71,210,1260
2016-11-21 12:40:00,46,93,60,199,1194
2016-11-21 12:50:00,31,67,28,126,756
2016-11-21 13:00:00,57,88,79,224,1344
2016-11-21 13:10:00,40,66,51,157,942
2016-11-21 13:20:00,57,81,71,209,1254
2016-11-21 13:30:00,54,74,51,179,1074
2016-11-21 13:40:00,27,51,34,112,672
2016-11-21 13:50:00,27,39,7,73,438
2016-11-21 14:00:00,41,68,22,131,786
2016-11-21 14:10:00,19,27,5,51,306
2016-11-21 14:20:00,5,8,0,13,78
2016-11-21 14:30:00,3,6,0,9,54
2016-11-21 14:40:00,1,1,0,2,12
2016-11-21 14:50:00,0,0,0,0,0
2016-11-21 15:00:00,1,2,1,4,24
2016-11-21 15:10:00,0,0,0,0,0
2016-11-21 15:20:00,0,0,0,0,0
2016-11-21 15:30:00,0,0,0,0,0
2016-11-21 15:40:00,0,0,0,0,0
2016-11-22 07:30:00,0,0,0,0,0
2016-11-22 07:40:00,0,0,0,0,0
2016-11-22 07:50:00,0,0,0,0,0
2016-11-22 08:00:00,0,0,0,0,0
2016-11-22 08:10:00,4,6,3,13,78
2016-11-22 08:20:00,8,16,7,31,186
2016-11-22 08:30:00,13,37,14,64,384
2016-11-22 08:40:00,16,52,26,94,564
2016-11-22 08:50:00,28,73,35,136,816
2016-11-22 09:00:00,54,80,58,192,1152
2016-11-22 09:10:00,55,83,68,206,1236
2016-11-22 09:20:00,28,54,20,102,612
2016-11-22 09:30:00,21,74,27,122,732
2016-11-22 09:40:00,36,59,52,147,882
2016-11-22 09:50:00,62,85,71,218,1308
2016-11-22 10:00:00,134,176,151,461,2766
2016-11-22 10:10:00,169,161,144,474,2844
2016-11-22 10:20:00,77,209,187,473,2838
2016-11-22 10:30:00,36,157,226,419,2514
2016-11-22 10:40:00,64,179,167,410,2460
2016-11-22 10:50:00,164,102,163,429,2574
2016-11-22 11:00:00,119,127,159,405,2430
2016-11-22 11:10:00,116,126,152,394,2364
2016-11-22 11:20:00,71,242,89,402,2412
2016-11-22 11:30:00,114,163,137,414,2484
2016-11-22 11:40:00,138,177,130,445,2670
2016-11-22 11:50:00,196,209,139,544,3264
2016-11-22 12:00:00,253,176,133,562,3372
2016-11-22 12:10:00,248,227,138,613,3678
2016-11-22 12:20:00,239,261,254,754,4524
2016-11-22 12:30:00,245,266,260,771,4626
2016-11-22 12:40:00,198,217,211,626,3756
2016-11-22 12:50:00,154,174,169,497,2982
2016-11-22 13:00:00,134,152,149,435,2610
2016-11-22 13:10:00,100,146,153,399,2394
2016-11-22 13:20:00,101,135,132,368,2208
2016-11-22 13:30:00,101,124,108,333,1998
2016-11-22 13:40:00,64,130,113,307,1842
2016-11-22 13:50:00,0,153,154,307,1842
2016-11-22 14:00:00,12,126,123,261,1566
2016-11-22 14:10:00,0,137,136,273,1638
2016-11-22 14:20:00,37,103,82,222,1332
2016-11-22 14:30:00,37,72,30,139,834
2016-11-22 14:40:00,41,41,13,95,570
2016-11-22 14:50:00,17,34,17,68,408
2016-11-22 15:00:00,12,31,12,55,330
2016-11-22 15:10:00,9,18,7,34,204
2016-11-22 15:20:00,3,5,2,10,60
2016-11-22 15:30:00,0,0,0,0,0
2016-11-22 15:40:00,0,0,0,0,0
2016-11-22 15:50:00,0,0,0,0,0
2016-11-22 16:00:00,0,0,0,0,0
2016-11-23 07:30:00,0,0,0,0,0
2016-11-23 07:40:00,0,0,0,0,0
2016-11-23 07:50:00,0,0,0,0,0
2016-11-23 08:00:00,0,0,0,0,0
2016-11-23 08:10:00,1,4,4,9,54
2016-11-23 08:20:00,4,17,8,29,174
2016-11-23 08:30:00,5,28,14,47,282
2016-11-23 08:40:00,14,39,15,68,408
2016-11-23 08:50:00,24,43,28,95,570
2016-11-23 09:00:00,41,61,38,140,840
2016-11-23 09:10:00,52,74,73,199,1194
2016-11-23 09:20:00,85,108,63,256,1536
2016-11-23 09:30:00,89,126,109,324,1944
2016-11-23 09:40:00,158,139,129,426,2556
2016-11-23 09:50:00,227,255,223,705,4230
2016-11-23 10:00:00,301,323,317,941,5646
2016-11-23 10:10:00,310,330,322,962,5772
2016-11-23 10:20:00,304,325,319,948,5688
2016-11-23 10:30:00,253,277,271,801,4806
2016-11-23 10:40:00,192,213,210,615,3690
2016-11-23 10:50:00,222,244,237,703,4218
2016-11-23 11:00:00,230,250,245,725,4350
2016-11-23 11:10:00,250,271,267,788,4728
2016-11-23 11:20:00,229,251,246,726,4356
2016-11-23 11:30:00,225,247,241,713,4278
2016-11-23 11:40:00,239,260,253,752,4512
2016-11-23 11:50:00,265,289,281,835,5010
2016-11-23 12:00:00,233,254,248,735,4410
2016-11-23 12:10:00,217,238,232,687,4122
2016-11-23 12:20:00,97,117,114,328,1968
2016-11-23 12:30:00,99,118,115,332,1992
2016-11-23 12:40:00,131,153,148,432,2592
2016-11-23 12:50:00,134,175,157,466,2796
2016-11-23 13:00:00,133,85,145,363,2178
2016-11-23 13:10:00,177,198,194,569,3414
2016-11-23 13:20:00,176,196,192,564,3384
2016-11-23 13:30:00,52,81,79,212,1272
2016-11-23 13:40:00,35,63,51,149,894
2016-11-23 13:50:00,22,79,30,131,786
2016-11-23 14:00:00,22,55,31,108,648
2016-11-23 14:10:00,19,49,25,93,558
2016-11-23 14:20:00,12,41,20,73,438
2016-11-23 14:30:00,9,33,13,55,330
2016-11-23 14:40:00,6,27,13,46,276
2016-11-23 14:50:00,4,24,6,34,204
2016-11-23 15:00:00,3,15,1,19,114
2016-11-23 15:10:00,1,11,0,12,72
2016-11-23 15:20:00,0,5,0,5,30
2016-11-23 15:30:00,0,1,0,1,6
2016-11-23 15:40:00,0,0,0,0,0
2016-11-23 15:50:00,0,0,0,0,0
2016-11-23 16:00:00,0,0,0,0,0
2016-11-24 07:30:00,0,0,0,0,0
2016-11-24 07:40:00,0,0,0,0,0
2016-11-24 07:50:00,0,0,0,0,0
2016-11-24 08:00:00,0,2,0,2,12
2016-11-24 08:10:00,7,4,5,16,96
2016-11-24 08:20:00,7,17,6,30,180
2016-11-24 08:30:00,6,26,11,43,258
2016-11-24 08:40:00,9,34,13,56,336
2016-11-24 08:50:00,15,36,13,64,384
2016-11-24 09:00:00,44,66,36,146,876
2016-11-24 09:10:00,211,206,199,616,3696
2016-11-24 09:20:00,352,375,366,1093,6558
2016-11-24 09:30:00,424,447,437,1308,7848
2016-11-24 09:40:00,472,498,485,1455,8730
2016-11-24 09:50:00,514,539,523,1576,9456
2016-11-24 10:00:00,515,541,527,1583,9498
2016-11-24 10:10:00,465,491,478,1434,8604
2016-11-24 10:20:00,378,402,394,1174,7044
2016-11-24 10:30:00,302,326,320,948,5688
2016-11-24 10:40:00,247,270,263,780,4680
2016-11-24 10:50:00,226,246,243,715,4290
2016-11-24 11:00:00,187,211,206,604,3624
2016-11-24 11:10:00,186,207,204,597,3582
2016-11-24 11:20:00,205,226,222,653,3918
2016-11-24 11:30:00,233,254,250,737,4422
2016-11-24 11:40:00,253,273,270,796,4776
2016-11-24 11:50:00,251,274,268,793,4758
2016-11-24 12:00:00,354,381,371,1106,6636
2016-11-24 12:10:00,492,515,505,1512,9072
2016-11-24 12:20:00,563,586,576,1725,10350
2016-11-24 12:30:00,581,598,597,1776,10656
2016-11-24 12:40:00,566,582,586,1734,10404
2016-11-24 12:50:00,536,556,553,1645,9870
2016-11-24 13:00:00,501,526,519,1546,9276
2016-11-24 13:10:00,456,486,477,1419,8514
2016-11-24 13:20:00,278,304,298,880,5280
2016-11-24 13:30:00,250,272,266,788,4728
2016-11-24 13:40:00,148,167,162,477,2862
2016-11-24 13:50:00,86,104,99,289,1734
2016-11-24 14:00:00,77,93,90,260,1560
2016-11-24 14:10:00,28,90,66,184,1104
2016-11-24 14:20:00,27,72,45,144,864
2016-11-24 14:30:00,28,62,39,129,774
2016-11-24 14:40:00,36,50,10,96,576
2016-11-24 14:50:00,27,44,11,82,492
2016-11-24 15:00:00,13,32,12,57,342
2016-11-24 15:10:00,9,29,12,50,300
2016-11-24 15:20:00,7,13,3,23,138
2016-11-24 15:30:00,0,1,0,1,6
2016-11-24 15:40:00,0,0,0,0,0
2016-11-24 15:50:00,0,0,0,0,0
2016-11-24 16:00:00,0,0,0,0,0
2016-11-25 07:20:00,0,0,0,0,0
2016-11-25 07:30:00,0,0,0,0,0
2016-11-25 07:40:00,0,0,0,0,0
2016-11-25 07:50:00,0,0,0,0,0
2016-11-25 08:00:00,0,0,0,0,0
2016-11-25 08:10:00,2,4,4,10,60
2016-11-25 08:20:00,4,9,6,19,114
2016-11-25 08:30:00,5,22,11,38,228
2016-11-25 08:40:00,13,31,16,60,360
2016-11-25 08:50:00,26,41,22,89,534
2016-11-25 09:00:00,35,63,39,137,822
2016-11-25 09:10:00,31,66,69,166,996
2016-11-25 09:20:00,60,92,80,232,1392
2016-11-25 09:30:00,94,148,118,360,2160
2016-11-25 09:40:00,39,59,55,153,918
2016-11-25 09:50:00,34,69,68,171,1026
2016-11-25 10:00:00,127,151,148,426,2556
2016-11-25 10:10:00,331,352,347,1030,6180
2016-11-25 10:20:00,308,330,323,961,5766
2016-11-25 10:30:00,268,291,285,844,5064
2016-11-25 10:40:00,252,274,270,796,4776
2016-11-25 10:50:00,227,250,245,722,4332
2016-11-25 11:00:00,231,251,246,728,4368
2016-11-25 11:10:00,256,280,273,809,4854
2016-11-25 11:20:00,249,272,267,788,4728
2016-11-25 11:30:00,185,208,204,597,3582
2016-11-25 11:40:00,105,125,122,352,2112
2016-11-25 11:50:00,162,183,180,525,3150
2016-11-25 12:00:00,327,347,342,1016,6096
2016-11-25 12:10:00,427,450,442,1319,7914
2016-11-25 12:20:00,504,527,518,1549,9294
2016-11-25 12:30:00,564,584,578,1726,10356
2016-11-25 12:40:00,527,548,539,1614,9684
2016-11-25 12:50:00,481,501,492,1474,8844
2016-11-25 13:00:00,446,466,456,1368,8208
2016-11-25 13:10:00,406,426,415,1247,7482
2016-11-25 13:20:00,367,384,375,1126,6756
2016-11-25 13:30:00,233,254,246,733,4398
2016-11-25 13:40:00,138,160,156,454,2724
2016-11-25 13:50:00,107,129,123,359,2154
2016-11-25 14:00:00,72,98,89,259,1554
2016-11-25 14:10:00,40,62,40,142,852
2016-11-25 14:20:00,22,64,32,118,708
2016-11-25 14:30:00,9,38,20,67,402
2016-11-25 14:40:00,6,27,11,44,264
2016-11-25 14:50:00,5,30,9,44,264
2016-11-25 15:00:00,8,24,6,38,228
2016-11-25 15:10:00,6,14,2,22,132
2016-11-25 15:20:00,2,3,0,5,30
2016-11-25 15:30:00,0,0,0,0,0
2016-11-25 15:40:00,0,0,0,0,0
2016-11-25 15:50:00,0,0,0,0,0
2016-11-25 16:00:00,0,0,0,0,0
2016-11-26 07:30:00,0,0,0,0,0
2016-11-26 07:40:00,0,0,0,0,0
2016-11-26 07:50:00,0,0,0,0,0
2016-11-26 08:00:00,0,0,0,0,0
2016-11-26 08:10:00,0,0,0,0,0
2016-11-26 08:20:00,0,0,0,0,0
2016-11-26 08:30:00,2,3,0,5,30
2016-11-26 08:40:00,7,10,2,19,114
2016-11-26 08:50:00,9,23,7,39,234
2016-11-26 09:00:00,20,27,2,49,294
2016-11-26 09:10:00,21,32,7,60,360
2016-11-26 09:20:00,26,41,10,77,462
2016-11-26 09:30:00,13,34,12,59,354
2016-11-26 09:40:00,17,33,9,59,354
2016-11-26 09:50:00,26,45,12,83,498
2016-11-26 10:00:00,25,59,21,105,630
2016-11-26 10:10:00,23,67,35,125,750
2016-11-26 10:20:00,43,91,54,188,1128
2016-11-26 10:30:00,41,101,88,230,1380
2016-11-26 10:40:00,38,145,136,319,1914
2016-11-26 10:50:00,94,131,96,321,1926
2016-11-26 11:00:00,86,119,95,300,1800
2016-11-26 11:10:00,63,83,65,211,1266
2016-11-26 11:20:00,67,88,78,233,1398
2016-11-26 11:30:00,51,74,56,181,1086
2016-11-26 11:40:00,46,78,52,176,1056
2016-11-26 11:50:00,48,77,42,167,1002
2016-11-26 12:00:00,27,61,24,112,672
2016-11-26 12:10:00,26,49,57,132,792
2016-11-26 12:20:00,62,84,27,173,1038
2016-11-26 12:30:00,44,82,45,171,1026
2016-11-26 12:40:00,48,78,47,173,1038
2016-11-26 12:50:00,29,65,30,124,744
2016-11-26 13:00:00,29,67,24,120,720
2016-11-26 13:10:00,30,57,28,115,690
2016-11-26 13:20:00,40,71,37,148,888
2016-11-26 13:30:00,58,81,30,169,1014
2016-11-26 13:40:00,67,88,50,205,1230
2016-11-26 13:50:00,61,97,57,215,1290
2016-11-26 14:00:00,65,93,39,197,1182
2016-11-26 14:10:00,59,90,27,176,1056
2016-11-26 14:20:00,67,89,18,174,1044
2016-11-26 14:30:00,39,68,42,149,894
2016-11-26 14:40:00,45,48,17,110,660
2016-11-26 14:50:00,34,48,10,92,552
2016-11-26 15:00:00,20,37,6,63,378
2016-11-26 15:10:00,13,20,2,35,210
2016-11-26 15:20:00,4,5,1,10,60
2016-11-26 15:30:00,0,0,0,0,0
2016-11-26 15:40:00,0,0,0,0,0
2016-11-26 15:50:00,0,0,0,0,0
2016-11-26 16:00:00,0,0,0,0,0
2016-11-27 07:30:00,0,0,0,0,0
2016-11-27 07:40:00,0,0,0,0,0
2016-11-27 07:50:00,0,0,0,0,0
2016-11-27 08:00:00,0,0,0,0,0
2016-11-27 08:10:00,1,5,0,6,36
2016-11-27 08:20:00,4,12,4,20,120
2016-11-27 08:30:00,7,20,5,32,192
2016-11-27 08:40:00,7,31,12,50,300
2016-11-27 08:50:00,9,45,21,75,450
2016-11-27 09:00:00,19,51,24,94,564
2016-11-27 09:10:00,56,142,102,300,1800
2016-11-27 09:20:00,245,277,224,746,4476
2016-11-27 09:30:00,380,392,376,1148,6888
2016-11-27 09:40:00,442,454,439,1335,8010
2016-11-27 09:50:00,486,504,483,1473,8838
2016-11-27 10:00:00,490,509,488,1487,8922
2016-11-27 10:10:00,432,455,436,1323,7938
2016-11-27 10:20:00,367,391,373,1131,6786
2016-11-27 10:30:00,288,307,293,888,5328
2016-11-27 10:40:00,261,278,264,803,4818
2016-11-27 10:50:00,239,257,249,745,4470
2016-11-27 11:00:00,205,224,217,646,3876
2016-11-27 11:10:00,201,199,193,593,3558
2016-11-27 11:20:00,193,211,202,606,3636
2016-11-27 11:30:00,217,234,225,676,4056
2016-11-27 11:40:00,239,259,249,747,4482
2016-11-27 11:50:00,240,268,258,766,4596
2016-11-27 12:00:00,324,351,339,1014,6084
2016-11-27 12:10:00,431,462,448,1341,8046
2016-11-27 12:20:00,538,558,541,1637,9822
2016-11-27 12:30:00,560,581,567,1708,10248
2016-11-27 12:40:00,531,555,543,1629,9774
2016-11-27 12:50:00,489,513,500,1502,9012
2016-11-27 13:00:00,441,464,448,1353,8118
2016-11-27 13:10:00,379,399,386,1164,6984
2016-11-27 13:20:00,318,336,326,980,5880
2016-11-27 13:30:00,263,279,272,814,4884
2016-11-27 13:40:00,185,202,196,583,3498
2016-11-27 13:50:00,110,127,121,358,2148
2016-11-27 14:00:00,44,69,52,165,990
2016-11-27 14:10:00,20,50,24,94,564
2016-11-27 14:20:00,16,45,22,83,498
2016-11-27 14:30:00,15,41,15,71,426
2016-11-27 14:40:00,11,34,13,58,348
2016-11-27 14:50:00,10,26,9,45,270
2016-11-27 15:00:00,9,17,4,30,180
2016-11-27 15:10:00,7,9,2,18,108
2016-11-27 15:20:00,3,4,0,7,42
2016-11-27 15:30:00,0,0,0,0,0
2016-11-27 15:40:00,0,0,0,0,0
2016-11-27 15:50:00,0,0,0,0,0
2016-11-27 16:00:00,0,0,0,0,0
2016-11-28 07:30:00,0,0,0,0,0
2016-11-28 07:40:00,0,0,0,0,0
2016-11-28 07:50:00,0,0,0,0,0
2016-11-28 08:00:00,0,0,0,0,0
2016-11-28 08:10:00,1,2,3,6,36
2016-11-28 08:20:00,6,6,7,19,114
2016-11-28 08:30:00,8,20,9,37,222
2016-11-28 08:40:00,9,32,12,53,318
2016-11-28 08:50:00,13,38,22,73,438
2016-11-28 09:00:00,26,45,23,94,564
2016-11-28 09:10:00,67,101,80,248,1488
2016-11-28 09:20:00,213,202,242,657,3942
2016-11-28 09:30:00,355,373,366,1094,6564
2016-11-28 09:40:00,435,452,445,1332,7992
2016-11-28 09:50:00,475,492,486,1453,8718
2016-11-28 10:00:00,498,514,506,1518,9108
2016-11-28 10:10:00,439,457,451,1347,8082
2016-11-28 10:20:00,364,382,376,1122,6732
2016-11-28 10:30:00,297,314,308,919,5514
2016-11-28 10:40:00,271,284,277,832,4992
2016-11-28 10:50:00,232,250,245,727,4362
2016-11-28 11:00:00,206,223,219,648,3888
2016-11-28 11:10:00,192,209,208,609,3654
2016-11-28 11:20:00,188,204,203,595,3570
2016-11-28 11:30:00,210,229,224,663,3978
2016-11-28 11:40:00,232,250,245,727,4362
2016-11-28 11:50:00,240,257,253,750,4500
2016-11-28 12:00:00,329,347,341,1017,6102
2016-11-28 12:10:00,454,475,466,1395,8370
2016-11-28 12:20:00,542,561,550,1653,9918
2016-11-28 12:30:00,586,602,594,1782,10692
2016-11-28 12:40:00,546,560,552,1658,9948
2016-11-28 12:50:00,500,513,503,1516,9096
2016-11-28 13:00:00,408,425,418,1251,7506
2016-11-28 13:10:00,364,383,376,1123,6738
2016-11-28 13:20:00,316,333,328,977,5862
2016-11-28 13:30:00,255,272,268,795,4770
2016-11-28 13:40:00,174,190,186,550,3300
2016-11-28 13:50:00,125,133,130,388,2328
2016-11-28 14:00:00,70,85,60,215,1290
2016-11-28 14:10:00,34,96,61,191,1146
2016-11-28 14:20:00,40,67,27,134,804
2016-11-28 14:30:00,28,40,7,75,450
2016-11-28 14:40:00,23,47,19,89,534
2016-11-28 14:50:00,22,33,4,59,354
2016-11-28 15:00:00,12,26,5,43,258
2016-11-28 15:10:00,15,28,6,49,294
2016-11-28 15:20:00,7,14,3,24,144
2016-11-28 15:30:00,3,7,0,10,60
2016-11-28 15:40:00,0,1,0,1,6
2016-11-28 15:50:00,0,0,0,0,0
2016-11-28 16:00:00,0,0,0,0,0
2016-11-29 07:30:00,0,0,0,0,0
2016-11-29 07:40:00,0,0,0,0,0
2016-11-29 07:50:00,0,0,0,0,0
2016-11-29 08:00:00,0,0,0,0,0
2016-11-29 08:10:00,0,0,0,0,0
2016-11-29 08:20:00,2,2,1,5,30
2016-11-29 08:30:00,3,6,9,18,108
2016-11-29 08:40:00,9,27,8,44,264
2016-11-29 08:50:00,21,38,20,79,474
2016-11-29 09:00:00,32,50,25,107,642
2016-11-29 09:10:00,40,83,39,162,972
2016-11-29 09:20:00,119,175,201,495,2970
2016-11-29 09:30:00,297,318,312,927,5562
2016-11-29 09:40:00,372,391,388,1151,6906
2016-11-29 09:50:00,401,419,417,1237,7422
2016-11-29 10:00:00,51,85,57,193,1158
2016-11-29 10:10:00,34,65,35,134,804
2016-11-29 10:20:00,46,71,63,180,1080
2016-11-29 10:30:00,34,71,47,152,912
2016-11-29 10:40:00,33,96,84,213,1278
2016-11-29 10:50:00,59,79,69,207,1242
2016-11-29 11:00:00,185,211,121,517,3102
2016-11-29 11:10:00,228,233,132,593,3558
2016-11-29 11:20:00,152,217,91,460,2760
2016-11-29 11:30:00,200,237,180,617,3702
2016-11-29 11:40:00,138,160,159,457,2742
2016-11-29 11:50:00,118,152,119,389,2334
2016-11-29 12:00:00,128,154,135,417,2502
2016-11-29 12:10:00,182,240,241,663,3978
2016-11-29 12:20:00,352,376,371,1099,6594
2016-11-29 12:30:00,221,242,239,702,4212
2016-11-29 12:40:00,199,219,217,635,3810
2016-11-29 12:50:00,128,148,145,421,2526
2016-11-29 13:00:00,119,125,69,313,1878
2016-11-29 13:10:00,134,12,129,275,1650
2016-11-29 13:20:00,88,55,98,241,1446
2016-11-29 13:30:00,68,87,78,233,1398
2016-11-29 13:40:00,36,78,72,186,1116
2016-11-29 13:50:00,25,66,28,119,714
2016-11-29 14:00:00,33,51,20,104,624
2016-11-29 14:10:00,40,55,11,106,636
2016-11-29 14:20:00,38,49,10,97,582
2016-11-29 14:30:00,26,32,6,64,384
2016-11-29 14:40:00,23,37,13,73,438
2016-11-29 14:50:00,15,20,2,37,222
2016-11-29 15:00:00,3,6,0,9,54
2016-11-29 15:10:00,3,4,1,8,48
2016-11-29 15:20:00,0,0,0,0,0
2016-11-29 15:30:00,0,0,0,0,0
2016-11-29 15:40:00,0,0,0,0,0
2016-11-29 15:50:00,0,0,0,0,0
2016-11-29 16:00:00,0,0,0,0,0
2016-11-30 07:40:00,0,0,0,0,0
2016-11-30 07:50:00,0,0,0,0,0
2016-11-30 08:00:00,0,0,0,0,0
2016-11-30 08:10:00,0,0,0,0,0
2016-11-30 08:20:00,0,0,0,0,0
2016-11-30 08:30:00,1,1,1,3,18
2016-11-30 08:40:00,3,4,5,12,72
2016-11-30 08:50:00,4,7,16,27,162
2016-11-30 09:00:00,11,24,8,43,258
2016-11-30 09:10:00,19,26,11,56,336
2016-11-30 09:20:00,20,30,14,64,384
2016-11-30 09:30:00,27,32,31,90,540
2016-11-30 09:40:00,23,38,23,84,504
2016-11-30 09:50:00,18,27,21,66,396
2016-11-30 10:00:00,21,27,23,71,426
2016-11-30 10:10:00,53,96,90,239,1434
2016-11-30 10:20:00,45,81,60,186,1116
2016-11-30 10:30:00,20,78,28,126,756
2016-11-30 10:40:00,18,85,18,121,726
2016-11-30 10:50:00,36,68,39,143,858
2016-11-30 11:00:00,29,61,30,120,720
2016-11-30 11:10:00,18,33,19,70,420
2016-11-30 11:20:00,32,41,7,80,480
2016-11-30 11:30:00,42,49,16,107,642
2016-11-30 11:40:00,18,24,8,50,300
2016-11-30 11:50:00,14,24,9,47,282
2016-11-30 12:00:00,12,25,9,46,276
2016-11-30 12:10:00,13,23,10,46,276
2016-11-30 12:20:00,12,25,12,49,294
2016-11-30 12:30:00,20,38,9,67,402
2016-11-30 12:40:00,14,24,8,46,276
2016-11-30 12:50:00,11,18,6,35,210
2016-11-30 13:00:00,11,20,5,36,216
2016-11-30 13:10:00,20,34,8,62,372
2016-11-30 13:20:00,17,32,9,58,348
2016-11-30 13:30:00,3,6,3,12,72
2016-11-30 13:40:00,25,34,9,68,408
2016-11-30 13:50:00,23,33,5,61,366
2016-11-30 14:00:00,15,31,8,54,324
2016-11-30 14:10:00,14,20,5,39,234
2016-11-30 14:20:00,10,16,5,31,186
2016-11-30 14:30:00,2,3,1,6,36
2016-11-30 14:40:00,0,0,0,0,0
2016-11-30 14:50:00,0,0,0,0,0
2016-11-30 15:00:00,0,0,0,0,0
2016-11-30 15:10:00,0,0,0,0,0
2016-11-30 15:20:00,0,0,0,0,0
2016-11-30 15:30:00,0,0,0,0,0
2016-11-30 15:40:00,0,0,0,0,0
2016-12-01 07:50:00,0,0,0,0,0
2016-12-01 08:00:00,0,0,0,0,0
2016-12-01 08:10:00,0,0,0,0,0
2016-12-01 08:20:00,0,0,0,0,0
2016-12-01 08:30:00,0,0,0,0,0
2016-12-01 08:40:00,1,2,1,4,24
2016-12-01 08:50:00,0,1,1,2,12
2016-12-01 09:00:00,3,3,3,9,54
2016-12-01 09:10:00,8,9,8,25,150
2016-12-01 09:20:00,9,8,11,28,168
2016-12-01 09:30:00,10,12,8,30,180
2016-12-01 09:40:00,15,23,6,44,264
2016-12-01 09:50:00,12,15,8,35,210
2016-12-01 10:00:00,17,37,12,66,396
2016-12-01 10:10:00,20,29,19,68,408
2016-12-01 10:20:00,27,44,21,92,552
2016-12-01 10:30:00,35,30,7,72,432
2016-12-01 10:40:00,19,31,20,70,420
2016-12-01 10:50:00,21,25,28,74,444
2016-12-01 11:00:00,16,25,21,62,372
2016-12-01 11:10:00,28,54,27,109,654
2016-12-01 11:20:00,23,41,23,87,522
2016-12-01 11:30:00,21,40,24,85,510
2016-12-01 11:40:00,33,48,40,121,726
2016-12-01 11:50:00,18,30,10,58,348
2016-12-01 12:00:00,32,61,27,120,720
2016-12-01 12:10:00,39,25,15,79,474
2016-12-01 12:20:00,21,38,16,75,450
2016-12-01 12:30:00,16,23,11,50,300
2016-12-01 12:40:00,22,32,11,65,390
2016-12-01 12:50:00,25,36,5,66,396
2016-12-01 13:00:00,25,37,8,70,420
2016-12-01 13:10:00,31,69,23,123,738
2016-12-01 13:20:00,29,50,16,95,570
2016-12-01 13:30:00,44,64,30,138,828
2016-12-01 13:40:00,40,54,21,115,690
2016-12-01 13:50:00,32,42,10,84,504
2016-12-01 14:00:00,23,30,6,59,354
2016-12-01 14:10:00,18,38,13,69,414
2016-12-01 14:20:00,10,19,4,33,198
2016-12-01 14:30:00,10,15,3,28,168
2016-12-01 14:40:00,8,14,2,24,144
2016-12-01 14:50:00,4,6,0,10,60
2016-12-01 15:00:00,0,0,0,0,0
2016-12-01 15:10:00,0,0,0,0,0
2016-12-01 15:20:00,0,0,0,0,0
2016-12-01 15:30:00,0,0,0,0,0
2016-12-01 15:40:00,0,0,0,0,0
2016-12-02 07:30:00,0,0,0,0,0
2016-12-02 07:40:00,0,0,0,0,0
2016-12-02 07:50:00,0,0,0,0,0
2016-12-02 08:00:00,0,0,0,0,0
2016-12-02 08:10:00,0,0,0,0,0
2016-12-02 08:20:00,2,3,2,7,42
2016-12-02 08:30:00,5,6,6,17,102
2016-12-02 08:40:00,8,14,7,29,174
2016-12-02 08:50:00,11,26,9,46,276
2016-12-02 09:00:00,22,34,6,62,372
2016-12-02 09:10:00,33,46,18,97,582
2016-12-02 09:20:00,122,163,61,346,2076
2016-12-02 09:30:00,293,230,244,767,4602
2016-12-02 09:40:00,376,387,383,1146,6876
2016-12-02 09:50:00,459,481,472,1412,8472
2016-12-02 10:00:00,470,489,479,1438,8628
2016-12-02 10:10:00,431,450,444,1325,7950
2016-12-02 10:20:00,366,385,379,1130,6780
2016-12-02 10:30:00,305,323,318,946,5676
2016-12-02 10:40:00,263,278,271,812,4872
2016-12-02 10:50:00,229,249,243,721,4326
2016-12-02 11:00:00,198,218,211,627,3762
2016-12-02 11:10:00,180,202,196,578,3468
2016-12-02 11:20:00,171,193,189,553,3318
2016-12-02 11:30:00,189,208,207,604,3624
2016-12-02 11:40:00,213,230,227,670,4020
2016-12-02 11:50:00,222,241,239,702,4212
2016-12-02 12:00:00,298,317,313,928,5568
2016-12-02 12:10:00,430,449,445,1324,7944
2016-12-02 12:20:00,513,534,527,1574,9444
2016-12-02 12:30:00,555,581,572,1708,10248
2016-12-02 12:40:00,529,554,543,1626,9756
2016-12-02 12:50:00,487,506,493,1486,8916
2016-12-02 13:00:00,431,452,442,1325,7950
2016-12-02 13:10:00,366,388,378,1132,6792
2016-12-02 13:20:00,302,324,315,941,5646
2016-12-02 13:30:00,239,259,252,750,4500
2016-12-02 13:40:00,177,195,188,560,3360
2016-12-02 13:50:00,104,121,116,341,2046
2016-12-02 14:00:00,40,70,53,163,978
2016-12-02 14:10:00,18,40,16,74,444
2016-12-02 14:20:00,22,35,5,62,372
2016-12-02 14:30:00,18,36,9,63,378
2016-12-02 14:40:00,17,27,6,50,300
2016-12-02 14:50:00,16,18,2,36,216
2016-12-02 15:00:00,9,13,1,23,138
2016-12-02 15:10:00,3,6,3,12,72
2016-12-02 15:20:00,0,2,1,3,18
2016-12-02 15:30:00,0,0,0,0,0
2016-12-02 15:40:00,0,0,0,0,0
2016-12-02 15:50:00,0,0,0,0,0
2016-12-02 16:00:00,0,0,0,0,0
2016-12-03 07:40:00,0,0,0,0,0
2016-12-03 07:50:00,0,0,0,0,0
2016-12-03 08:00:00,0,0,0,0,0
2016-12-03 08:10:00,0,0,0,0,0
2016-12-03 08:20:00,3,6,0,9,54
2016-12-03 08:30:00,8,16,4,28,168
2016-12-03 08:40:00,13,31,9,53,318
2016-12-03 08:50:00,29,46,11,86,516
2016-12-03 09:00:00,30,58,20,108,648
2016-12-03 09:10:00,33,84,38,155,930
2016-12-03 09:20:00,28,127,104,259,1554
2016-12-03 09:30:00,93,233,135,461,2766
2016-12-03 09:40:00,214,268,201,683,4098
2016-12-03 09:50:00,314,328,312,954,5724
2016-12-03 10:00:00,410,429,409,1248,7488
2016-12-03 10:10:00,340,357,338,1035,6210
2016-12-03 10:20:00,234,255,243,732,4392
2016-12-03 10:30:00,179,199,188,566,3396
2016-12-03 10:40:00,185,204,194,583,3498
2016-12-03 10:50:00,203,222,213,638,3828
2016-12-03 11:00:00,211,238,228,677,4062
2016-12-03 11:10:00,220,282,215,717,4302
2016-12-03 11:20:00,247,268,260,775,4650
2016-12-03 11:30:00,244,267,259,770,4620
2016-12-03 11:40:00,254,274,266,794,4764
2016-12-03 11:50:00,227,245,239,711,4266
2016-12-03 12:00:00,241,260,251,752,4512
2016-12-03 12:10:00,340,364,349,1053,6318
2016-12-03 12:20:00,475,497,480,1452,8712
2016-12-03 12:30:00,527,554,536,1617,9702
2016-12-03 12:40:00,507,529,515,1551,9306
2016-12-03 12:50:00,466,487,473,1426,8556
2016-12-03 13:00:00,419,440,428,1287,7722
2016-12-03 13:10:00,365,385,375,1125,6750
2016-12-03 13:20:00,292,313,303,908,5448
2016-12-03 13:30:00,234,250,245,729,4374
2016-12-03 13:40:00,170,185,182,537,3222
2016-12-03 13:50:00,108,124,119,351,2106
2016-12-03 14:00:00,54,78,67,199,1194
2016-12-03 14:10:00,30,77,25,132,792
2016-12-03 14:20:00,41,60,32,133,798
2016-12-03 14:30:00,30,72,14,116,696
2016-12-03 14:40:00,6,112,4,122,732
2016-12-03 14:50:00,28,75,8,111,666
2016-12-03 15:00:00,22,45,11,78,468
2016-12-03 15:10:00,18,26,5,49,294
2016-12-03 15:20:00,7,12,2,21,126
2016-12-03 15:30:00,1,3,0,4,24
2016-12-03 15:40:00,0,0,0,0,0
2016-12-03 15:50:00,0,0,0,0,0
2016-12-03 16:00:00,0,0,0,0,0
2016-12-04 07:40:00,0,0,0,0,0
2016-12-04 07:50:00,0,0,0,0,0
2016-12-04 08:00:00,0,0,0,0,0
2016-12-04 08:10:00,0,0,0,0,0
2016-12-04 08:20:00,3,3,1,7,42
2016-12-04 08:30:00,10,15,4,29,174
2016-12-04 08:40:00,11,36,14,61,366
2016-12-04 08:50:00,21,53,26,100,600
2016-12-04 09:00:00,36,68,22,126,756
2016-12-04 09:10:00,59,77,12,148,888
2016-12-04 09:20:00,81,93,15,189,1134
2016-12-04 09:30:00,13,137,125,275,1650
2016-12-04 09:40:00,60,192,110,362,2172
2016-12-04 09:50:00,168,261,129,558,3348
2016-12-04 10:00:00,269,284,271,824,4944
2016-12-04 10:10:00,301,321,303,925,5550
2016-12-04 10:20:00,377,395,376,1148,6888
2016-12-04 10:30:00,254,270,260,784,4704
2016-12-04 10:40:00,162,179,171,512,3072
2016-12-04 10:50:00,197,213,206,616,3696
2016-12-04 11:00:00,161,177,171,509,3054
2016-12-04 11:10:00,186,210,202,598,3588
2016-12-04 11:20:00,181,201,196,578,3468
2016-12-04 11:30:00,207,226,218,651,3906
2016-12-04 11:40:00,232,249,239,720,4320
2016-12-04 11:50:00,220,240,228,688,4128
2016-12-04 12:00:00,234,254,245,733,4398
2016-12-04 12:10:00,319,339,331,989,5934
2016-12-04 12:20:00,413,427,413,1253,7518
2016-12-04 12:30:00,419,436,423,1278,7668
2016-12-04 12:40:00,303,319,306,928,5568
2016-12-04 12:50:00,302,318,305,925,5550
2016-12-04 13:00:00,260,280,269,809,4854
2016-12-04 13:10:00,229,246,238,713,4278
2016-12-04 13:20:00,170,187,181,538,3228
2016-12-04 13:30:00,109,127,123,359,2154
2016-12-04 13:40:00,114,130,125,369,2214
2016-12-04 13:50:00,92,110,104,306,1836
2016-12-04 14:00:00,63,80,76,219,1314
2016-12-04 14:10:00,38,104,95,237,1422
2016-12-04 14:20:00,27,97,75,199,1194
2016-12-04 14:30:00,11,86,72,169,1014
2016-12-04 14:40:00,24,58,29,111,666
2016-12-04 14:50:00,21,49,22,92,552
2016-12-04 15:00:00,14,33,13,60,360
2016-12-04 15:10:00,9,13,0,22,132
2016-12-04 15:20:00,2,4,0,6,36
2016-12-04 15:30:00,1,2,0,3,18
2016-12-04 15:40:00,0,0,0,0,0
2016-12-04 15:50:00,0,0,0,0,0
2016-12-04 16:00:00,0,0,0,0,0
2016-12-05 07:50:00,0,0,0,0,0
2016-12-05 08:00:00,0,0,0,0,0
2016-12-05 08:10:00,0,0,0,0,0
2016-12-05 08:20:00,0,0,0,0,0
2016-12-05 08:30:00,0,0,0,0,0
2016-12-05 08:40:00,1,2,1,4,24
2016-12-05 08:50:00,4,6,4,14,84
2016-12-05 09:00:00,9,11,5,25,150
2016-12-05 09:10:00,24,30,12,66,396
2016-12-05 09:20:00,20,28,18,66,396
2016-12-05 09:30:00,26,61,41,128,768
2016-12-05 09:40:00,43,81,60,184,1104
2016-12-05 09:50:00,58,83,60,201,1206
2016-12-05 10:00:00,30,51,18,99,594
2016-12-05 10:10:00,40,69,36,145,870
2016-12-05 10:20:00,57,77,59,193,1158
2016-12-05 10:30:00,82,112,85,279,1674
2016-12-05 10:40:00,131,167,158,456,2736
2016-12-05 10:50:00,118,146,135,399,2394
2016-12-05 11:00:00,85,118,96,299,1794
2016-12-05 11:10:00,191,204,209,604,3624
2016-12-05 11:20:00,121,143,137,401,2406
2016-12-05 11:30:00,60,78,62,200,1200
2016-12-05 11:40:00,60,77,70,207,1242
2016-12-05 11:50:00,63,83,60,206,1236
2016-12-05 12:00:00,38,58,36,132,792
2016-12-05 12:10:00,30,49,36,115,690
2016-12-05 12:20:00,17,71,23,111,666
2016-12-05 12:30:00,22,36,32,90,540
2016-12-05 12:40:00,49,41,56,146,876
2016-12-05 12:50:00,63,69,80,212,1272
2016-12-05 13:00:00,74,81,80,235,1410
2016-12-05 13:10:00,43,57,48,148,888
2016-12-05 13:20:00,23,53,23,99,594
2016-12-05 13:30:00,37,62,47,146,876
2016-12-05 13:40:00,41,96,88,225,1350
2016-12-05 13:50:00,48,165,128,341,2046
2016-12-05 14:00:00,38,99,86,223,1338
2016-12-05 14:10:00,29,61,29,119,714
2016-12-05 14:20:00,13,39,22,74,444
2016-12-05 14:30:00,11,25,9,45,270
2016-12-05 14:40:00,11,19,6,36,216
2016-12-05 14:50:00,5,7,0,12,72
2016-12-05 15:00:00,2,4,0,6,36
2016-12-05 15:10:00,1,2,0,3,18
2016-12-05 15:20:00,0,0,0,0,0
2016-12-05 15:30:00,0,0,0,0,0
2016-12-05 15:40:00,0,0,0,0,0
2016-12-05 15:50:00,0,0,0,0,0
2016-12-06 07:40:00,0,0,0,0,0
2016-12-06 07:50:00,0,0,0,0,0
2016-12-06 08:00:00,0,0,0,0,0
2016-12-06 08:10:00,0,0,0,0,0
2016-12-06 08:20:00,2,4,3,9,54
2016-12-06 08:30:00,6,14,8,28,168
2016-12-06 08:40:00,15,28,9,52,312
2016-12-06 08:50:00,22,47,13,82,492
2016-12-06 09:00:00,32,51,30,113,678
2016-12-06 09:10:00,25,66,52,143,858
2016-12-06 09:20:00,43,85,72,200,1200
2016-12-06 09:30:00,193,168,113,474,2844
2016-12-06 09:40:00,229,245,241,715,4290
2016-12-06 09:50:00,240,220,224,684,4104
2016-12-06 10:00:00,301,319,316,936,5616
2016-12-06 10:10:00,272,293,290,855,5130
2016-12-06 10:20:00,267,288,282,837,5022
2016-12-06 10:30:00,316,336,327,979,5874
2016-12-06 10:40:00,241,260,256,757,4542
2016-12-06 10:50:00,210,229,223,662,3972
2016-12-06 11:00:00,193,213,211,617,3702
2016-12-06 11:10:00,190,208,204,602,3612
2016-12-06 11:20:00,179,198,191,568,3408
2016-12-06 11:30:00,180,199,194,573,3438
2016-12-06 11:40:00,197,214,212,623,3738
2016-12-06 11:50:00,210,226,225,661,3966
2016-12-06 12:00:00,239,259,255,753,4518
2016-12-06 12:10:00,377,395,392,1164,6984
2016-12-06 12:20:00,459,471,466,1396,8376
2016-12-06 12:30:00,393,410,406,1209,7254
2016-12-06 12:40:00,471,482,479,1432,8592
2016-12-06 12:50:00,409,423,422,1254,7524
2016-12-06 13:00:00,417,435,425,1277,7662
2016-12-06 13:10:00,351,368,364,1083,6498
2016-12-06 13:20:00,281,298,294,873,5238
2016-12-06 13:30:00,220,244,239,703,4218
2016-12-06 13:40:00,156,176,172,504,3024
2016-12-06 13:50:00,62,120,113,295,1770
2016-12-06 14:00:00,35,77,48,160,960
2016-12-06 14:10:00,21,49,15,85,510
2016-12-06 14:20:00,19,34,8,61,366
2016-12-06 14:30:00,21,33,6,60,360
2016-12-06 14:40:00,21,25,2,48,288
2016-12-06 14:50:00,19,26,2,47,282
2016-12-06 15:00:00,11,16,1,28,168
2016-12-06 15:10:00,2,4,0,6,36
2016-12-06 15:20:00,0,0,0,0,0
2016-12-06 15:30:00,0,0,0,0,0
2016-12-06 15:40:00,0,0,0,0,0
2016-12-06 15:50:00,0,0,0,0,0
2016-12-07 07:50:00,0,0,0,0,0
2016-12-07 08:00:00,0,0,0,0,0
2016-12-07 08:10:00,0,0,0,0,0
2016-12-07 08:20:00,0,0,0,0,0
2016-12-07 08:30:00,0,0,0,0,0
2016-12-07 08:40:00,0,0,0,0,0
2016-12-07 08:50:00,0,0,0,0,0
2016-12-07 09:00:00,6,9,6,21,126
2016-12-07 09:10:00,12,21,10,43,258
2016-12-07 09:20:00,23,42,11,76,456
2016-12-07 09:30:00,24,44,24,92,552
2016-12-07 09:40:00,18,38,19,75,450
2016-12-07 09:50:00,20,28,26,74,444
2016-12-07 10:00:00,24,39,33,96,576
2016-12-07 10:10:00,22,35,28,85,510
2016-12-07 10:20:00,19,37,22,78,468
2016-12-07 10:30:00,16,32,16,64,384
2016-12-07 10:40:00,19,24,16,59,354
2016-12-07 10:50:00,14,19,15,48,288
2016-12-07 11:00:00,16,33,18,67,402
2016-12-07 11:10:00,31,64,33,128,768
2016-12-07 11:20:00,14,91,13,118,708
2016-12-07 11:30:00,20,44,15,79,474
2016-12-07 11:40:00,17,29,7,53,318
2016-12-07 11:50:00,26,42,12,80,480
2016-12-07 12:00:00,19,39,22,80,480
2016-12-07 12:10:00,20,38,22,80,480
2016-12-07 12:20:00,17,30,13,60,360
2016-12-07 12:30:00,13,25,11,49,294
2016-12-07 12:40:00,13,19,9,41,246
2016-12-07 12:50:00,17,29,8,54,324
2016-12-07 13:00:00,13,21,7,41,246
2016-12-07 13:10:00,9,16,6,31,186
2016-12-07 13:20:00,9,15,5,29,174
2016-12-07 13:30:00,4,4,3,11,66
2016-12-07 13:40:00,4,6,3,13,78
2016-12-07 13:50:00,4,6,1,11,66
2016-12-07 14:00:00,3,5,0,8,48
2016-12-07 14:10:00,1,2,0,3,18
2016-12-07 14:20:00,0,0,0,0,0
2016-12-07 14:30:00,0,0,0,0,0
2016-12-07 14:40:00,0,0,0,0,0
2016-12-07 14:50:00,0,0,0,0,0
2016-12-07 15:00:00,0,0,0,0,0
2016-12-07 15:10:00,0,0,0,0,0
2016-12-07 15:20:00,0,0,0,0,0
2016-12-07 15:30:00,0,0,0,0,0
2016-12-08 08:00:00,0,0,0,0,0
2016-12-08 08:10:00,0,0,0,0,0
2016-12-08 08:20:00,0,0,0,0,0
2016-12-08 08:30:00,0,0,0,0,0
2016-12-08 08:40:00,0,0,0,0,0
2016-12-08 08:50:00,0,0,0,0,0
2016-12-08 09:00:00,1,1,1,3,18
2016-12-08 09:10:00,6,6,6,18,108
2016-12-08 09:20:00,9,11,8,28,168
2016-12-08 09:30:00,14,19,16,49,294
2016-12-08 09:40:00,19,21,23,63,378
2016-12-08 09:50:00,32,54,37,123,738
2016-12-08 10:00:00,66,70,75,211,1266
2016-12-08 10:10:00,121,137,137,395,2370
2016-12-08 10:20:00,129,170,151,450,2700
2016-12-08 10:30:00,66,92,71,229,1374
2016-12-08 10:40:00,65,75,68,208,1248
2016-12-08 10:50:00,57,62,64,183,1098
2016-12-08 11:00:00,72,74,83,229,1374
2016-12-08 11:10:00,79,92,77,248,1488
2016-12-08 11:20:00,98,97,112,307,1842
2016-12-08 11:30:00,121,116,117,354,2124
2016-12-08 11:40:00,125,152,175,452,2712
2016-12-08 11:50:00,155,174,172,501,3006
2016-12-08 12:00:00,233,254,250,737,4422
2016-12-08 12:10:00,283,306,302,891,5346
2016-12-08 12:20:00,367,390,387,1144,6864
2016-12-08 12:30:00,350,375,368,1093,6558
2016-12-08 12:40:00,303,324,321,948,5688
2016-12-08 12:50:00,191,211,209,611,3666
2016-12-08 13:00:00,101,122,118,341,2046
2016-12-08 13:10:00,82,78,90,250,1500
2016-12-08 13:20:00,91,106,62,259,1554
2016-12-08 13:30:00,63,82,73,218,1308
2016-12-08 13:40:00,36,75,71,182,1092
2016-12-08 13:50:00,35,74,42,151,906
2016-12-08 14:00:00,19,76,33,128,768
2016-12-08 14:10:00,25,52,23,100,600
2016-12-08 14:20:00,17,39,14,70,420
2016-12-08 14:30:00,15,23,6,44,264
2016-12-08 14:40:00,7,12,2,21,126
2016-12-08 14:50:00,2,4,0,6,36
2016-12-08 15:00:00,0,0,0,0,0
2016-12-08 15:10:00,0,0,0,0,0
2016-12-08 15:20:00,0,0,0,0,0
2016-12-08 15:30:00,0,0,0,0,0
2016-12-08 15:40:00,0,0,0,0,0
2016-12-09 08:00:00,0,0,0,0,0
2016-12-09 08:10:00,0,0,0,0,0
2016-12-09 08:20:00,0,0,0,0,0
2016-12-09 08:30:00,0,0,0,0,0
2016-12-09 08:40:00,3,5,2,10,60
2016-12-09 08:50:00,8,11,7,26,156
2016-12-09 09:00:00,18,26,19,63,378
2016-12-09 09:10:00,50,67,57,174,1044
2016-12-09 09:20:00,76,94,95,265,1590
2016-12-09 09:30:00,101,127,102,330,1980
2016-12-09 09:40:00,184,211,190,585,3510
2016-12-09 09:50:00,218,246,237,701,4206
2016-12-09 10:00:00,228,250,243,721,4326
2016-12-09 10:10:00,127,148,144,419,2514
2016-12-09 10:20:00,101,132,130,363,2178
2016-12-09 10:30:00,198,226,208,632,3792
2016-12-09 10:40:00,187,209,207,603,3618
2016-12-09 10:50:00,145,148,156,449,2694
2016-12-09 11:00:00,169,150,148,467,2802
2016-12-09 11:10:00,171,193,191,555,3330
2016-12-09 11:20:00,87,79,95,261,1566
2016-12-09 11:30:00,56,60,59,175,1050
2016-12-09 11:40:00,53,62,56,171,1026
2016-12-09 11:50:00,62,76,73,211,1266
2016-12-09 12:00:00,102,95,125,322,1932
2016-12-09 12:10:00,100,65,114,279,1674
2016-12-09 12:20:00,61,89,74,224,1344
2016-12-09 12:30:00,61,72,52,185,1110
2016-12-09 12:40:00,43,67,35,145,870
2016-12-09 12:50:00,17,79,24,120,720
2016-12-09 13:00:00,25,59,21,105,630
2016-12-09 13:10:00,27,48,25,100,600
2016-12-09 13:20:00,29,53,25,107,642
2016-12-09 13:30:00,20,47,18,85,510
2016-12-09 13:40:00,17,36,11,64,384
2016-12-09 13:50:00,12,37,15,64,384
2016-12-09 14:00:00,16,25,7,48,288
2016-12-09 14:10:00,10,14,2,26,156
2016-12-09 14:20:00,8,10,1,19,114
2016-12-09 14:30:00,5,8,1,14,84
2016-12-09 14:40:00,0,0,0,0,0
2016-12-09 14:50:00,0,0,0,0,0
2016-12-09 15:00:00,0,0,0,0,0
2016-12-09 15:10:00,0,0,0,0,0
2016-12-09 15:20:00,0,0,0,0,0
2016-12-09 15:30:00,0,0,0,0,0
2016-12-10 08:10:00,0,0,0,0,0
2016-12-10 08:20:00,0,0,0,0,0
2016-12-10 08:30:00,0,0,0,0,0
2016-12-10 08:40:00,0,0,0,0,0
2016-12-10 08:50:00,0,1,0,1,6
2016-12-10 09:00:00,5,8,0,13,78
2016-12-10 09:10:00,4,6,0,10,60
2016-12-10 09:20:00,7,9,1,17,102
2016-12-10 09:30:00,10,14,2,26,156
2016-12-10 09:40:00,8,9,4,21,126
2016-12-10 09:50:00,8,12,3,23,138
2016-12-10 10:00:00,17,23,4,44,264
2016-12-10 10:10:00,13,29,9,51,306
2016-12-10 10:20:00,13,26,9,48,288
2016-12-10 10:30:00,38,59,27,124,744
2016-12-10 10:40:00,35,70,23,128,768
2016-12-10 10:50:00,22,58,28,108,648
2016-12-10 11:00:00,34,67,50,151,906
2016-12-10 11:10:00,50,92,75,217,1302
2016-12-10 11:20:00,54,154,152,360,2160
2016-12-10 11:30:00,45,73,67,185,1110
2016-12-10 11:40:00,36,125,120,281,1686
2016-12-10 11:50:00,45,95,105,245,1470
2016-12-10 12:00:00,25,83,81,189,1134
2016-12-10 12:10:00,51,87,70,208,1248
2016-12-10 12:20:00,70,146,139,355,2130
2016-12-10 12:30:00,56,128,101,285,1710
2016-12-10 12:40:00,24,73,36,133,798
2016-12-10 12:50:00,27,54,31,112,672
2016-12-10 13:00:00,23,71,31,125,750
2016-12-10 13:10:00,31,58,48,137,822
2016-12-10 13:20:00,12,42,28,82,492
2016-12-10 13:30:00,14,36,27,77,462
2016-12-10 13:40:00,13,27,17,57,342
2016-12-10 13:50:00,8,27,12,47,282
2016-12-10 14:00:00,15,45,23,83,498
2016-12-10 14:10:00,19,34,9,62,372
2016-12-10 14:20:00,21,38,9,68,408
2016-12-10 14:30:00,12,17,4,33,198
2016-12-10 14:40:00,14,20,4,38,228
2016-12-10 14:50:00,7,9,1,17,102
2016-12-10 15:00:00,0,1,0,1,6
2016-12-10 15:10:00,0,0,0,0,0
2016-12-10 15:20:00,0,0,0,0,0
2016-12-10 15:30:00,0,0,0,0,0
2016-12-10 15:40:00,0,0,0,0,0
2016-12-11 07:50:00,0,0,0,0,0
2016-12-11 08:00:00,0,0,0,0,0
2016-12-11 08:10:00,0,0,0,0,0
2016-12-11 08:20:00,0,0,0,0,0
2016-12-11 08:30:00,0,0,0,0,0
2016-12-11 08:40:00,0,1,0,1,6
2016-12-11 08:50:00,5,14,1,20,120
2016-12-11 09:00:00,7,24,9,40,240
2016-12-11 09:10:00,14,41,21,76,456
2016-12-11 09:20:00,12,24,7,43,258
2016-12-11 09:30:00,30,66,43,139,834
2016-12-11 09:40:00,24,73,45,142,852
2016-12-11 09:50:00,19,54,31,104,624
2016-12-11 10:00:00,19,70,46,135,810
2016-12-11 10:10:00,31,106,80,217,1302
2016-12-11 10:20:00,6,99,88,193,1158
2016-12-11 10:30:00,21,73,43,137,822
2016-12-11 10:40:00,26,77,65,168,1008
2016-12-11 10:50:00,35,71,66,172,1032
2016-12-11 11:00:00,80,74,90,244,1464
2016-12-11 11:10:00,40,68,67,175,1050
2016-12-11 11:20:00,17,51,41,109,654
2016-12-11 11:30:00,10,22,10,42,252
2016-12-11 11:40:00,45,95,88,228,1368
2016-12-11 11:50:00,226,243,242,711,4266
2016-12-11 12:00:00,262,281,276,819,4914
2016-12-11 12:10:00,339,353,348,1040,6240
2016-12-11 12:20:00,246,261,264,771,4626
2016-12-11 12:30:00,267,289,282,838,5028
2016-12-11 12:40:00,73,169,157,399,2394
2016-12-11 12:50:00,58,84,61,203,1218
2016-12-11 13:00:00,65,108,72,245,1470
2016-12-11 13:10:00,22,74,34,130,780
2016-12-11 13:20:00,64,126,69,259,1554
2016-12-11 13:30:00,254,201,123,578,3468
2016-12-11 13:40:00,103,178,141,422,2532
2016-12-11 13:50:00,10,146,139,295,1770
2016-12-11 14:00:00,22,107,92,221,1326
2016-12-11 14:10:00,21,64,39,124,744
2016-12-11 14:20:00,13,40,18,71,426
2016-12-11 14:30:00,8,25,8,41,246
2016-12-11 14:40:00,11,32,14,57,342
2016-12-11 14:50:00,11,20,6,37,222
2016-12-11 15:00:00,4,5,0,9,54
2016-12-11 15:10:00,0,1,0,1,6
2016-12-11 15:20:00,0,0,0,0,0
2016-12-11 15:30:00,0,0,0,0,0
2016-12-11 15:40:00,0,0,0,0,0
2016-12-11 15:50:00,0,0,0,0,0
2016-12-12 07:50:00,0,0,0,0,0
2016-12-12 08:00:00,0,0,0,0,0
2016-12-12 08:10:00,0,0,0,0,0
2016-12-12 08:20:00,0,0,0,0,0
2016-12-12 08:30:00,1,2,1,4,24
2016-12-12 08:40:00,6,16,9,31,186
2016-12-12 08:50:00,18,39,19,76,456
2016-12-12 09:00:00,36,53,37,126,756
2016-12-12 09:10:00,16,46,17,79,474
2016-12-12 09:20:00,27,60,25,112,672
2016-12-12 09:30:00,103,180,82,365,2190
2016-12-12 09:40:00,218,250,217,685,4110
2016-12-12 09:50:00,364,383,377,1124,6744
2016-12-12 10:00:00,429,445,440,1314,7884
2016-12-12 10:10:00,423,438,430,1291,7746
2016-12-12 10:20:00,361,377,371,1109,6654
2016-12-12 10:30:00,317,335,330,982,5892
2016-12-12 10:40:00,270,288,283,841,5046
2016-12-12 10:50:00,249,268,262,779,4674
2016-12-12 11:00:00,198,217,213,628,3768
2016-12-12 11:10:00,176,194,188,558,3348
2016-12-12 11:20:00,177,193,192,562,3372
2016-12-12 11:30:00,175,192,191,558,3348
2016-12-12 11:40:00,189,207,203,599,3594
2016-12-12 11:50:00,164,184,179,527,3162
2016-12-12 12:00:00,107,122,121,350,2100
2016-12-12 12:10:00,93,108,108,309,1854
2016-12-12 12:20:00,72,84,86,242,1452
2016-12-12 12:30:00,66,83,75,224,1344
2016-12-12 12:40:00,56,79,73,208,1248
2016-12-12 12:50:00,36,76,60,172,1032
2016-12-12 13:00:00,44,58,54,156,936
2016-12-12 13:10:00,40,67,53,160,960
2016-12-12 13:20:00,33,73,38,144,864
2016-12-12 13:30:00,34,77,35,146,876
2016-12-12 13:40:00,24,66,22,112,672
2016-12-12 13:50:00,28,64,23,115,690
2016-12-12 14:00:00,43,70,38,151,906
2016-12-12 14:10:00,25,58,33,116,696
2016-12-12 14:20:00,25,70,20,115,690
2016-12-12 14:30:00,29,57,24,110,660
2016-12-12 14:40:00,22,30,3,55,330
2016-12-12 14:50:00,12,16,4,32,192
2016-12-12 15:00:00,3,5,1,9,54
2016-12-12 15:10:00,0,1,0,1,6
2016-12-12 15:20:00,0,0,0,0,0
2016-12-12 15:30:00,0,0,0,0,0
2016-12-12 15:40:00,0,0,0,0,0
2016-12-13 08:00:00,0,0,0,0,0
2016-12-13 08:10:00,0,0,0,0,0
2016-12-13 08:20:00,0,0,0,0,0
2016-12-13 08:30:00,0,0,0,0,0
2016-12-13 08:40:00,0,0,0,0,0
2016-12-13 08:50:00,0,0,0,0,0
2016-12-13 09:00:00,0,0,0,0,0
2016-12-13 09:10:00,0,0,0,0,0
2016-12-13 09:20:00,0,0,0,0,0
2016-12-13 09:30:00,2,6,0,8,48
2016-12-13 09:40:00,5,8,3,16,96
2016-12-13 09:50:00,3,11,3,17,102
2016-12-13 10:00:00,12,22,9,43,258
2016-12-13 10:10:00,22,38,12,72,432
2016-12-13 10:20:00,22,40,20,82,492
2016-12-13 10:30:00,13,34,24,71,426
2016-12-13 10:40:00,12,42,21,75,450
2016-12-13 10:50:00,12,37,22,71,426
2016-12-13 11:00:00,16,44,20,80,480
2016-12-13 11:10:00,23,45,25,93,558
2016-12-13 11:20:00,12,24,13,49,294
2016-12-13 11:30:00,16,27,10,53,318
2016-12-13 11:40:00,18,62,36,116,696
2016-12-13 11:50:00,23,70,57,150,900
2016-12-13 12:00:00,13,92,17,122,732
2016-12-13 12:10:00,18,37,15,70,420
2016-12-13 12:20:00,13,25,13,51,306
2016-12-13 12:30:00,14,21,16,51,306
2016-12-13 12:40:00,32,60,35,127,762
2016-12-13 12:50:00,62,96,82,240,1440
2016-12-13 13:00:00,71,93,83,247,1482
2016-12-13 13:10:00,50,76,63,189,1134
2016-12-13 13:20:00,38,75,62,175,1050
2016-12-13 13:30:00,25,55,30,110,660
2016-12-13 13:40:00,8,28,13,49,294
2016-12-13 13:50:00,10,24,8,42,252
2016-12-13 14:00:00,8,15,3,26,156
2016-12-13 14:10:00,12,37,17,66,396
2016-12-13 14:20:00,40,86,51,177,1062
2016-12-13 14:30:00,19,50,24,93,558
2016-12-13 14:40:00,10,15,3,28,168
2016-12-13 14:50:00,2,2,0,4,24
2016-12-13 15:00:00,0,0,0,0,0
2016-12-13 15:10:00,0,0,0,0,0
2016-12-13 15:20:00,0,0,0,0,0
2016-12-13 15:30:00,0,0,0,0,0
2016-12-13 15:40:00,0,0,0,0,0
2016-12-13 15:50:00,0,0,0,0,0
2016-12-14 07:50:00,0,0,0,0,0
2016-12-14 08:00:00,0,0,0,0,0
2016-12-14 08:10:00,0,0,0,0,0
2016-12-14 08:20:00,0,0,0,0,0
2016-12-14 08:30:00,0,0,0,0,0
2016-12-14 08:40:00,0,0,0,0,0
2016-12-14 08:50:00,2,3,2,7,42
2016-12-14 09:00:00,6,5,7,18,108
2016-12-14 09:10:00,9,18,14,41,246
2016-12-14 09:20:00,18,33,26,77,462
2016-12-14 09:30:00,32,58,40,130,780
2016-12-14 09:40:00,64,65,87,216,1296
2016-12-14 09:50:00,79,74,100,253,1518
2016-12-14 10:00:00,148,147,160,455,2730
2016-12-14 10:10:00,102,162,159,423,2538
2016-12-14 10:20:00,222,262,249,733,4398
2016-12-14 10:30:00,263,285,281,829,4974
2016-12-14 10:40:00,264,287,283,834,5004
2016-12-14 10:50:00,244,267,261,772,4632
2016-12-14 11:00:00,200,221,214,635,3810
2016-12-14 11:10:00,167,189,183,539,3234
2016-12-14 11:20:00,167,189,183,539,3234
2016-12-14 11:30:00,166,187,183,536,3216
2016-12-14 11:40:00,175,197,193,565,3390
2016-12-14 11:50:00,190,209,206,605,3630
2016-12-14 12:00:00,206,225,223,654,3924
2016-12-14 12:10:00,327,345,339,1011,6066
2016-12-14 12:20:00,420,440,431,1291,7746
2016-12-14 12:30:00,495,517,508,1520,9120
2016-12-14 12:40:00,503,525,518,1546,9276
2016-12-14 12:50:00,451,469,466,1386,8316
2016-12-14 13:00:00,392,408,408,1208,7248
2016-12-14 13:10:00,341,356,357,1054,6324
2016-12-14 13:20:00,287,303,301,891,5346
2016-12-14 13:30:00,232,249,247,728,4368
2016-12-14 13:40:00,175,191,190,556,3336
2016-12-14 13:50:00,120,136,133,389,2334
2016-12-14 14:00:00,76,93,89,258,1548
2016-12-14 14:10:00,42,65,27,134,804
2016-12-14 14:20:00,19,37,10,66,396
2016-12-14 14:30:00,13,34,11,58,348
2016-12-14 14:40:00,11,24,8,43,258
2016-12-14 14:50:00,10,15,4,29,174
2016-12-14 15:00:00,4,14,0,18,108
2016-12-14 15:10:00,3,5,0,8,48
2016-12-14 15:20:00,0,0,0,0,0
2016-12-14 15:30:00,0,0,0,0,0
2016-12-14 15:40:00,0,0,0,0,0
2016-12-14 15:50:00,0,0,0,0,0
2016-12-15 08:00:00,0,0,0,0,0
2016-12-15 08:10:00,0,0,0,0,0
2016-12-15 08:20:00,0,0,0,0,0
2016-12-15 08:30:00,0,0,0,0,0
2016-12-15 08:40:00,0,0,0,0,0
2016-12-15 08:50:00,1,2,0,3,18
2016-12-15 09:00:00,6,8,2,16,96
2016-12-15 09:10:00,9,16,5,30,180
2016-12-15 09:20:00,10,16,5,31,186
2016-12-15 09:30:00,12,21,5,38,228
2016-12-15 09:40:00,16,25,7,48,288
2016-12-15 09:50:00,18,27,4,49,294
2016-12-15 10:00:00,22,31,5,58,348
2016-12-15 10:10:00,29,35,3,67,402
2016-12-15 10:20:00,33,43,10,86,516
2016-12-15 10:30:00,20,48,21,89,534
2016-12-15 10:40:00,35,52,15,102,612
2016-12-15 10:50:00,31,45,12,88,528
2016-12-15 11:00:00,30,51,19,100,600
2016-12-15 11:10:00,33,68,29,130,780
2016-12-15 11:20:00,25,62,32,119,714
2016-12-15 11:30:00,28,69,22,119,714
2016-12-15 11:40:00,36,83,50,169,1014
2016-12-15 11:50:00,37,79,53,169,1014
2016-12-15 12:00:00,16,77,20,113,678
2016-12-15 12:10:00,25,59,34,118,708
2016-12-15 12:20:00,28,53,33,114,684
2016-12-15 12:30:00,24,54,30,108,648
2016-12-15 12:40:00,30,66,34,130,780
2016-12-15 12:50:00,18,70,25,113,678
2016-12-15 13:00:00,20,51,27,98,588
2016-12-15 13:10:00,23,39,10,72,432
2016-12-15 13:20:00,27,50,15,92,552
2016-12-15 13:30:00,23,32,5,60,360
2016-12-15 13:40:00,19,31,9,59,354
2016-12-15 13:50:00,13,18,2,33,198
2016-12-15 14:00:00,13,20,3,36,216
2016-12-15 14:10:00,9,16,2,27,162
2016-12-15 14:20:00,7,11,1,19,114
2016-12-15 14:30:00,3,5,0,8,48
2016-12-15 14:40:00,1,3,0,4,24
2016-12-15 14:50:00,0,0,0,0,0
2016-12-15 15:00:00,0,0,0,0,0
2016-12-15 15:10:00,0,0,0,0,0
2016-12-15 15:20:00,0,0,0,0,0
2016-12-15 15:30:00,0,0,0,0,0
2016-12-15 15:40:00,0,0,0,0,0
2016-12-16 08:00:00,0,0,0,0,0
2016-12-16 08:10:00,0,0,0,0,0
2016-12-16 08:20:00,0,0,0,0,0
2016-12-16 08:30:00,0,0,0,0,0
2016-12-16 08:40:00,0,0,0,0,0
2016-12-16 08:50:00,0,0,0,0,0
2016-12-16 09:00:00,0,0,0,0,0
2016-12-16 09:10:00,3,5,2,10,60
2016-12-16 09:20:00,3,6,3,12,72
2016-12-16 09:30:00,4,8,4,16,96
2016-12-16 09:40:00,7,20,12,39,234
2016-12-16 09:50:00,13,18,17,48,288
2016-12-16 10:00:00,19,31,26,76,456
2016-12-16 10:10:00,63,51,77,191,1146
2016-12-16 10:20:00,50,83,79,212,1272
2016-12-16 10:30:00,24,72,39,135,810
2016-12-16 10:40:00,15,86,40,141,846
2016-12-16 10:50:00,11,81,79,171,1026
2016-12-16 11:00:00,14,79,71,164,984
2016-12-16 11:10:00,28,63,42,133,798
2016-12-16 11:20:00,23,63,34,120,720
2016-12-16 11:30:00,24,73,39,136,816
2016-12-16 11:40:00,19,53,53,125,750
2016-12-16 11:50:00,25,58,24,107,642
2016-12-16 12:00:00,34,79,40,153,918
2016-12-16 12:10:00,22,70,34,126,756
2016-12-16 12:20:00,64,65,62,191,1146
2016-12-16 12:30:00,57,58,66,181,1086
2016-12-16 12:40:00,21,79,41,141,846
2016-12-16 12:50:00,36,68,57,161,966
2016-12-16 13:00:00,33,83,64,180,1080
2016-12-16 13:10:00,24,65,42,131,786
2016-12-16 13:20:00,20,49,18,87,522
2016-12-16 13:30:00,24,71,52,147,882
2016-12-16 13:40:00,18,55,38,111,666
2016-12-16 13:50:00,11,54,34,99,594
2016-12-16 14:00:00,13,44,21,78,468
2016-12-16 14:10:00,19,50,22,91,546
2016-12-16 14:20:00,12,35,13,60,360
2016-12-16 14:30:00,11,27,9,47,282
2016-12-16 14:40:00,9,15,3,27,162
2016-12-16 14:50:00,3,6,0,9,54
2016-12-16 15:00:00,0,0,0,0,0
2016-12-16 15:10:00,0,0,0,0,0
2016-12-16 15:20:00,0,0,0,0,0
2016-12-16 15:30:00,0,0,0,0,0
2016-12-16 15:40:00,0,0,0,0,0
2016-12-17 08:00:00,0,0,0,0,0
2016-12-17 08:10:00,0,0,0,0,0
2016-12-17 08:20:00,0,0,0,0,0
2016-12-17 08:30:00,0,0,0,0,0
2016-12-17 08:40:00,0,0,0,0,0
2016-12-17 08:50:00,0,0,0,0,0
2016-12-17 09:00:00,0,0,0,0,0
2016-12-17 09:10:00,0,0,0,0,0
2016-12-17 09:20:00,0,1,0,1,6
2016-12-17 09:30:00,0,1,0,1,6
2016-12-17 09:40:00,2,5,0,7,42
2016-12-17 09:50:00,6,8,0,14,84
2016-12-17 10:00:00,4,6,0,10,60
2016-12-17 10:10:00,5,7,0,12,72
2016-12-17 10:20:00,5,8,1,14,84
2016-12-17 10:30:00,3,6,0,9,54
2016-12-17 10:40:00,3,7,0,10,60
2016-12-17 10:50:00,2,9,1,12,72
2016-12-17 11:00:00,5,15,4,24,144
2016-12-17 11:10:00,6,18,12,36,216
2016-12-17 11:20:00,22,47,31,100,600
2016-12-17 11:30:00,18,82,37,137,822
2016-12-17 11:40:00,25,62,38,125,750
2016-12-17 11:50:00,29,63,45,137,822
2016-12-17 12:00:00,26,71,42,139,834
2016-12-17 12:10:00,5,90,83,178,1068
2016-12-17 12:20:00,26,63,33,122,732
2016-12-17 12:30:00,23,71,35,129,774
2016-12-17 12:40:00,17,86,43,146,876
2016-12-17 12:50:00,15,121,118,254,1524
2016-12-17 13:00:00,37,67,57,161,966
2016-12-17 13:10:00,23,63,41,127,762
2016-12-17 13:20:00,13,45,24,82,492
2016-12-17 13:30:00,9,27,20,56,336
2016-12-17 13:40:00,7,30,15,52,312
2016-12-17 13:50:00,10,36,18,64,384
2016-12-17 14:00:00,10,24,7,41,246
2016-12-17 14:10:00,9,15,3,27,162
2016-12-17 14:20:00,3,5,1,9,54
2016-12-17 14:30:00,0,1,0,1,6
2016-12-17 14:40:00,0,0,0,0,0
2016-12-17 14:50:00,0,0,0,0,0
2016-12-17 15:00:00,0,0,0,0,0
2016-12-17 15:10:00,0,0,0,0,0
2016-12-17 15:20:00,0,0,0,0,0
2016-12-17 15:30:00,0,0,0,0,0
2016-12-18 08:00:00,0,0,0,0,0
2016-12-18 08:10:00,0,0,0,0,0
2016-12-18 08:20:00,0,0,0,0,0
2016-12-18 08:30:00,0,0,0,0,0
2016-12-18 08:40:00,0,0,0,0,0
2016-12-18 08:50:00,0,0,0,0,0
2016-12-18 09:00:00,6,11,2,19,114
2016-12-18 09:10:00,12,29,10,51,306
2016-12-18 09:20:00,16,33,10,59,354
2016-12-18 09:30:00,20,38,10,68,408
2016-12-18 09:40:00,28,49,16,93,558
2016-12-18 09:50:00,24,49,18,91,546
2016-12-18 10:00:00,10,34,15,59,354
2016-12-18 10:10:00,11,41,22,74,444
2016-12-18 10:20:00,6,55,32,93,558
2016-12-18 10:30:00,10,52,25,87,522
2016-12-18 10:40:00,14,30,10,54,324
2016-12-18 10:50:00,8,21,8,37,222
2016-12-18 11:00:00,10,37,15,62,372
2016-12-18 11:10:00,18,40,13,71,426
2016-12-18 11:20:00,16,49,26,91,546
2016-12-18 11:30:00,19,55,24,98,588
2016-12-18 11:40:00,22,62,43,127,762
2016-12-18 11:50:00,23,51,25,99,594
2016-12-18 12:00:00,24,63,36,123,738
2016-12-18 12:10:00,25,65,37,127,762
2016-12-18 12:20:00,17,73,19,109,654
2016-12-18 12:30:00,25,53,22,100,600
2016-12-18 12:40:00,25,47,19,91,546
2016-12-18 12:50:00,18,64,22,104,624
2016-12-18 13:00:00,14,49,27,90,540
2016-12-18 13:10:00,15,51,27,93,558
2016-12-18 13:20:00,12,45,16,73,438
2016-12-18 13:30:00,10,49,25,84,504
2016-12-18 13:40:00,9,49,19,77,462
2016-12-18 13:50:00,8,36,15,59,354
2016-12-18 14:00:00,8,27,9,44,264
2016-12-18 14:10:00,8,18,3,29,174
2016-12-18 14:20:00,9,20,5,34,204
2016-12-18 14:30:00,7,12,1,20,120
2016-12-18 14:40:00,4,8,0,12,72
2016-12-18 14:50:00,2,3,0,5,30
2016-12-18 15:00:00,0,1,0,1,6
2016-12-18 15:10:00,0,0,0,0,0
2016-12-18 15:20:00,0,0,0,0,0
2016-12-18 15:30:00,0,0,0,0,0
2016-12-18 15:40:00,0,0,0,0,0
2016-12-19 08:00:00,0,0,0,0,0
2016-12-19 08:10:00,0,0,0,0,0
2016-12-19 08:20:00,0,0,0,0,0
2016-12-19 08:30:00,0,0,0,0,0
2016-12-19 08:40:00,0,0,0,0,0
2016-12-19 08:50:00,1,2,1,4,24
2016-12-19 09:00:00,5,8,7,20,120
2016-12-19 09:10:00,6,11,6,23,138
2016-12-19 09:20:00,12,20,12,44,264
2016-12-19 09:30:00,15,31,15,61,366
2016-12-19 09:40:00,16,40,13,69,414
2016-12-19 09:50:00,16,29,12,57,342
2016-12-19 10:00:00,14,26,16,56,336
2016-12-19 10:10:00,18,33,10,61,366
2016-12-19 10:20:00,19,37,11,67,402
2016-12-19 10:30:00,26,48,15,89,534
2016-12-19 10:40:00,17,82,17,116,696
2016-12-19 10:50:00,35,60,42,137,822
2016-12-19 11:00:00,32,68,48,148,888
2016-12-19 11:10:00,32,63,61,156,936
2016-12-19 11:20:00,27,76,41,144,864
2016-12-19 11:30:00,37,61,46,144,864
2016-12-19 11:40:00,30,70,32,132,792
2016-12-19 11:50:00,35,63,33,131,786
2016-12-19 12:00:00,32,68,36,136,816
2016-12-19 12:10:00,32,70,35,137,822
2016-12-19 12:20:00,31,82,55,168,1008
2016-12-19 12:30:00,50,85,57,192,1152
2016-12-19 12:40:00,36,65,63,164,984
2016-12-19 12:50:00,31,70,60,161,966
2016-12-19 13:00:00,33,60,43,136,816
2016-12-19 13:10:00,20,77,27,124,744
2016-12-19 13:20:00,20,61,25,106,636
2016-12-19 13:30:00,28,51,18,97,582
2016-12-19 13:40:00,18,46,19,83,498
2016-12-19 13:50:00,22,47,19,88,528
2016-12-19 14:00:00,19,42,16,77,462
2016-12-19 14:10:00,13,32,11,56,336
2016-12-19 14:20:00,12,25,8,45,270
2016-12-19 14:30:00,12,17,5,34,204
2016-12-19 14:40:00,6,10,0,16,96
2016-12-19 14:50:00,3,4,0,7,42
2016-12-19 15:00:00,0,0,0,0,0
2016-12-19 15:10:00,0,0,0,0,0
2016-12-19 15:20:00,0,0,0,0,0
2016-12-19 15:30:00,0,0,0,0,0
2016-12-19 15:40:00,0,0,0,0,0
2016-12-19 15:50:00,0,0,0,0,0
2016-12-20 08:00:00,0,0,0,0,0
2016-12-20 08:10:00,0,0,0,0,0
2016-12-20 08:20:00,0,0,0,0,0
2016-12-20 08:30:00,0,0,0,0,0
2016-12-20 08:40:00,0,0,0,0,0
2016-12-20 08:50:00,0,0,0,0,0
2016-12-20 09:00:00,0,0,0,0,0
2016-12-20 09:10:00,0,0,0,0,0
2016-12-20 09:20:00,0,0,0,0,0
2016-12-20 09:30:00,3,3,3,9,54
2016-12-20 09:40:00,3,3,4,10,60
2016-12-20 09:50:00,3,5,6,14,84
2016-12-20 10:00:00,6,7,11,24,144
2016-12-20 10:10:00,3,8,14,25,150
2016-12-20 10:20:00,7,13,9,29,174
2016-12-20 10:30:00,9,18,9,36,216
2016-12-20 10:40:00,8,25,8,41,246
2016-12-20 10:50:00,11,24,17,52,312
2016-12-20 11:00:00,16,34,14,64,384
2016-12-20 11:10:00,10,35,14,59,354
2016-12-20 11:20:00,17,37,12,66,396
2016-12-20 11:30:00,22,32,24,78,468
2016-12-20 11:40:00,21,35,18,74,444
2016-12-20 11:50:00,20,44,23,87,522
2016-12-20 12:00:00,19,43,21,83,498
2016-12-20 12:10:00,20,46,11,77,462
2016-12-20 12:20:00,24,49,19,92,552
2016-12-20 12:30:00,27,45,16,88,528
2016-12-20 12:40:00,17,47,24,88,528
2016-12-20 12:50:00,20,45,14,79,474
2016-12-20 13:00:00,20,42,17,79,474
2016-12-20 13:10:00,22,31,15,68,408
2016-12-20 13:20:00,13,29,10,52,312
2016-12-20 13:30:00,17,18,16,51,306
2016-12-20 13:40:00,8,16,6,30,180
2016-12-20 13:50:00,9,17,5,31,186
2016-12-20 14:00:00,8,12,1,21,126
2016-12-20 14:10:00,5,8,0,13,78
2016-12-20 14:20:00,5,8,1,14,84
2016-12-20 14:30:00,2,4,0,6,36
2016-12-20 14:40:00,1,2,0,3,18
2016-12-20 14:50:00,0,0,0,0,0
2016-12-20 15:00:00,0,0,0,0,0
2016-12-20 15:10:00,0,0,0,0,0
2016-12-20 15:20:00,0,0,0,0,0
2016-12-20 15:30:00,0,0,0,0,0
2016-12-20 15:40:00,0,0,0,0,0
2016-12-21 08:00:00,0,0,0,0,0
2016-12-21 08:10:00,0,0,0,0,0
2016-12-21 08:20:00,0,0,0,0,0
2016-12-21 08:30:00,0,0,0,0,0
2016-12-21 08:40:00,0,0,0,0,0
2016-12-21 08:50:00,0,0,0,0,0
2016-12-21 09:00:00,0,0,0,0,0
2016-12-21 09:10:00,0,0,0,0,0
2016-12-21 09:20:00,0,0,0,0,0
2016-12-21 09:30:00,0,0,0,0,0
2016-12-21 09:40:00,0,0,0,0,0
2016-12-21 09:50:00,1,1,2,4,24
2016-12-21 10:00:00,8,11,10,29,174
2016-12-21 10:10:00,16,24,10,50,300
2016-12-21 10:20:00,13,19,15,47,282
2016-12-21 10:30:00,6,12,6,24,144
2016-12-21 10:40:00,3,4,3,10,60
2016-12-21 10:50:00,0,1,1,2,12
2016-12-21 11:00:00,5,7,3,15,90
2016-12-21 11:10:00,9,6,6,21,126
2016-12-21 11:20:00,4,8,4,16,96
2016-12-21 11:30:00,8,14,5,27,162
2016-12-21 11:40:00,13,21,6,40,240
2016-12-21 11:50:00,9,14,5,28,168
2016-12-21 12:00:00,12,18,6,36,216
2016-12-21 12:10:00,16,30,11,57,342
2016-12-21 12:20:00,22,45,11,78,468
2016-12-21 12:30:00,24,53,21,98,588
2016-12-21 12:40:00,26,43,24,93,558
2016-12-21 12:50:00,13,23,9,45,270
2016-12-21 13:00:00,13,18,12,43,258
2016-12-21 13:10:00,7,8,6,21,126
2016-12-21 13:20:00,11,14,14,39,234
2016-12-21 13:30:00,18,24,21,63,378
2016-12-21 13:40:00,15,27,10,52,312
2016-12-21 13:50:00,16,21,5,42,252
2016-12-21 14:00:00,5,8,1,14,84
2016-12-21 14:10:00,0,1,0,1,6
2016-12-21 14:20:00,2,3,0,5,30
2016-12-21 14:30:00,1,2,0,3,18
2016-12-21 14:40:00,0,0,0,0,0
2016-12-21 14:50:00,0,0,0,0,0
2016-12-21 15:00:00,0,0,0,0,0
2016-12-21 15:10:00,0,0,0,0,0
2016-12-21 15:20:00,0,0,0,0,0
2016-12-21 15:30:00,0,0,0,0,0
2016-12-21 15:40:00,0,0,0,0,0
2016-12-22 08:10:00,0,0,0,0,0
2016-12-22 08:20:00,0,0,0,0,0
2016-12-22 08:30:00,0,0,0,0,0
2016-12-22 08:40:00,0,0,0,0,0
2016-12-22 08:50:00,0,0,0,0,0
2016-12-22 09:00:00,0,0,0,0,0
2016-12-22 09:10:00,0,0,0,0,0
2016-12-22 09:20:00,4,4,1,9,54
2016-12-22 09:30:00,21,40,27,88,528
2016-12-22 09:40:00,29,44,36,109,654
2016-12-22 09:50:00,11,11,13,35,210
2016-12-22 10:00:00,21,20,27,68,408
2016-12-22 10:10:00,22,33,25,80,480
2016-12-22 10:20:00,29,83,43,155,930
2016-12-22 10:30:00,53,112,129,294,1764
2016-12-22 10:40:00,56,96,87,239,1434
2016-12-22 10:50:00,47,70,56,173,1038
2016-12-22 11:00:00,61,70,71,202,1212
2016-12-22 11:10:00,87,83,70,240,1440
2016-12-22 11:20:00,69,73,81,223,1338
2016-12-22 11:30:00,49,72,59,180,1080
2016-12-22 11:40:00,49,70,40,159,954
2016-12-22 11:50:00,76,73,78,227,1362
2016-12-22 12:00:00,92,98,98,288,1728
2016-12-22 12:10:00,97,116,126,339,2034
2016-12-22 12:20:00,77,107,105,289,1734
2016-12-22 12:30:00,200,213,217,630,3780
2016-12-22 12:40:00,112,150,144,406,2436
2016-12-22 12:50:00,127,180,175,482,2892
2016-12-22 13:00:00,301,324,314,939,5634
2016-12-22 13:10:00,274,296,290,860,5160
2016-12-22 13:20:00,232,254,248,734,4404
2016-12-22 13:30:00,182,203,199,584,3504
2016-12-22 13:40:00,72,156,215,443,2658
2016-12-22 13:50:00,22,158,143,323,1938
2016-12-22 14:00:00,21,109,99,229,1374
2016-12-22 14:10:00,23,80,52,155,930
2016-12-22 14:20:00,23,61,34,118,708
2016-12-22 14:30:00,27,50,19,96,576
2016-12-22 14:40:00,12,40,18,70,420
2016-12-22 14:50:00,11,23,9,43,258
2016-12-22 15:00:00,11,17,5,33,198
2016-12-22 15:10:00,1,2,0,3,18
2016-12-22 15:20:00,0,0,0,0,0
2016-12-22 15:30:00,0,0,0,0,0
2016-12-22 15:40:00,0,0,0,0,0
2016-12-22 15:50:00,0,0,0,0,0
2016-12-22 16:00:00,0,0,0,0,0
2016-12-23 07:50:00,0,0,0,0,0
2016-12-23 08:00:00,0,0,0,0,0
2016-12-23 08:10:00,0,0,0,0,0
2016-12-23 08:20:00,0,0,0,0,0
2016-12-23 08:30:00,0,0,0,0,0
2016-12-23 08:40:00,2,3,2,7,42
2016-12-23 08:50:00,6,10,8,24,144
2016-12-23 09:00:00,15,27,15,57,342
2016-12-23 09:10:00,29,43,14,86,516
2016-12-23 09:20:00,27,62,28,117,702
2016-12-23 09:30:00,25,73,57,155,930
2016-12-23 09:40:00,58,102,113,273,1638
2016-12-23 09:50:00,180,260,156,596,3576
2016-12-23 10:00:00,285,309,302,896,5376
2016-12-23 10:10:00,322,355,345,1022,6132
2016-12-23 10:20:00,259,288,279,826,4956
2016-12-23 10:30:00,278,306,297,881,5286
2016-12-23 10:40:00,251,280,272,803,4818
2016-12-23 10:50:00,235,263,255,753,4518
2016-12-23 11:00:00,218,248,237,703,4218
2016-12-23 11:10:00,191,217,204,612,3672
2016-12-23 11:20:00,188,212,205,605,3630
2016-12-23 11:30:00,198,221,214,633,3798
2016-12-23 11:40:00,198,221,213,632,3792
2016-12-23 11:50:00,204,232,224,660,3960
2016-12-23 12:00:00,145,174,169,488,2928
2016-12-23 12:10:00,70,137,147,354,2124
2016-12-23 12:20:00,115,128,118,361,2166
2016-12-23 12:30:00,313,337,331,981,5886
2016-12-23 12:40:00,126,148,63,337,2022
2016-12-23 12:50:00,49,97,105,251,1506
2016-12-23 13:00:00,44,70,61,175,1050
2016-12-23 13:10:00,54,87,61,202,1212
2016-12-23 13:20:00,12,83,71,166,996
2016-12-23 13:30:00,21,80,45,146,876
2016-12-23 13:40:00,14,59,26,99,594
2016-12-23 13:50:00,20,54,33,107,642
2016-12-23 14:00:00,13,70,55,138,828
2016-12-23 14:10:00,24,90,72,186,1116
2016-12-23 14:20:00,27,66,25,118,708
2016-12-23 14:30:00,13,39,18,70,420
2016-12-23 14:40:00,9,23,8,40,240
2016-12-23 14:50:00,13,30,9,52,312
2016-12-23 15:00:00,6,20,4,30,180
2016-12-23 15:10:00,1,3,0,4,24
2016-12-23 15:20:00,0,0,0,0,0
2016-12-23 15:30:00,0,0,0,0,0
2016-12-23 15:40:00,0,0,0,0,0
2016-12-24 08:00:00,0,0,0,0,0
2016-12-24 08:10:00,0,0,0,0,0
2016-12-24 08:20:00,0,0,0,0,0
2016-12-24 08:30:00,0,0,0,0,0
2016-12-24 08:40:00,0,0,0,0,0
2016-12-24 08:50:00,3,5,0,8,48
2016-12-24 09:00:00,9,17,4,30,180
2016-12-24 09:10:00,15,43,17,75,450
2016-12-24 09:20:00,35,59,25,119,714
2016-12-24 09:30:00,51,78,39,168,1008
2016-12-24 09:40:00,32,114,96,242,1452
2016-12-24 09:50:00,104,221,104,429,2574
2016-12-24 10:00:00,274,201,217,692,4152
2016-12-24 10:10:00,238,258,246,742,4452
2016-12-24 10:20:00,237,257,247,741,4446
2016-12-24 10:30:00,263,284,274,821,4926
2016-12-24 10:40:00,255,274,267,796,4776
2016-12-24 10:50:00,172,209,187,568,3408
2016-12-24 11:00:00,64,87,52,203,1218
2016-12-24 11:10:00,105,126,115,346,2076
2016-12-24 11:20:00,53,77,57,187,1122
2016-12-24 11:30:00,203,189,173,565,3390
2016-12-24 11:40:00,226,247,242,715,4290
2016-12-24 11:50:00,253,275,270,798,4788
2016-12-24 12:00:00,100,125,116,341,2046
2016-12-24 12:10:00,18,24,8,50,300
2016-12-24 12:20:00,39,80,47,166,996
2016-12-24 12:30:00,48,144,134,326,1956
2016-12-24 12:40:00,205,222,217,644,3864
2016-12-24 12:50:00,101,124,110,335,2010
2016-12-24 13:00:00,140,182,158,480,2880
2016-12-24 13:10:00,76,152,155,383,2298
2016-12-24 13:20:00,85,130,128,343,2058
2016-12-24 13:30:00,28,53,31,112,672
2016-12-24 13:40:00,50,75,43,168,1008
2016-12-24 13:50:00,28,121,106,255,1530
2016-12-24 14:00:00,35,133,119,287,1722
2016-12-24 14:10:00,14,95,82,191,1146
2016-12-24 14:20:00,23,67,44,134,804
2016-12-24 14:30:00,31,49,30,110,660
2016-12-24 14:40:00,15,45,20,80,480
2016-12-24 14:50:00,17,29,7,53,318
2016-12-24 15:00:00,11,15,3,29,174
2016-12-24 15:10:00,2,3,0,5,30
2016-12-24 15:20:00,0,0,0,0,0
2016-12-24 15:30:00,0,0,0,0,0
2016-12-24 15:40:00,0,0,0,0,0
2016-12-25 08:10:00,0,0,0,0,0
2016-12-25 08:20:00,0,0,0,0,0
2016-12-25 08:30:00,0,0,0,0,0
2016-12-25 08:40:00,0,0,0,0,0
2016-12-25 08:50:00,0,0,0,0,0
2016-12-25 09:00:00,0,0,0,0,0
2016-12-25 09:10:00,0,0,0,0,0
2016-12-25 09:20:00,1,3,0,4,24
2016-12-25 09:30:00,0,2,0,2,12
2016-12-25 09:40:00,1,3,0,4,24
2016-12-25 09:50:00,5,7,0,12,72
2016-12-25 10:00:00,7,12,2,21,126
2016-12-25 10:10:00,10,23,8,41,246
2016-12-25 10:20:00,8,35,15,58,348
2016-12-25 10:30:00,17,41,19,77,462
2016-12-25 10:40:00,20,49,23,92,552
2016-12-25 10:50:00,24,57,24,105,630
2016-12-25 11:00:00,34,58,20,112,672
2016-12-25 11:10:00,42,50,8,100,600
2016-12-25 11:20:00,31,49,15,95,570
2016-12-25 11:30:00,23,64,24,111,666
2016-12-25 11:40:00,27,57,26,110,660
2016-12-25 11:50:00,39,76,51,166,996
2016-12-25 12:00:00,38,73,45,156,936
2016-12-25 12:10:00,38,75,29,142,852
2016-12-25 12:20:00,48,75,30,153,918
2016-12-25 12:30:00,57,85,63,205,1230
2016-12-25 12:40:00,19,84,66,169,1014
2016-12-25 12:50:00,31,73,46,150,900
2016-12-25 13:00:00,24,72,31,127,762
2016-12-25 13:10:00,47,82,39,168,1008
2016-12-25 13:20:00,25,69,33,127,762
2016-12-25 13:30:00,29,60,33,122,732
2016-12-25 13:40:00,29,49,19,97,582
2016-12-25 13:50:00,28,40,8,76,456
2016-12-25 14:00:00,12,19,4,35,210
2016-12-25 14:10:00,6,11,2,19,114
2016-12-25 14:20:00,7,13,3,23,138
2016-12-25 14:30:00,7,10,2,19,114
2016-12-25 14:40:00,1,1,0,2,12
2016-12-25 14:50:00,0,0,0,0,0
2016-12-25 15:00:00,0,0,0,0,0
2016-12-25 15:10:00,0,0,0,0,0
2016-12-25 15:20:00,0,0,0,0,0
2016-12-25 15:30:00,0,0,0,0,0
2016-12-25 15:40:00,0,0,0,0,0
2016-12-26 08:00:00,0,0,0,0,0
2016-12-26 08:10:00,0,0,0,0,0
2016-12-26 08:20:00,0,0,0,0,0
2016-12-26 08:30:00,0,0,0,0,0
2016-12-26 08:40:00,0,0,0,0,0
2016-12-26 08:50:00,5,7,2,14,84
2016-12-26 09:00:00,5,6,5,16,96
2016-12-26 09:10:00,7,8,7,22,132
2016-12-26 09:20:00,16,22,16,54,324
2016-12-26 09:30:00,41,63,51,155,930
2016-12-26 09:40:00,79,78,88,245,1470
2016-12-26 09:50:00,163,171,145,479,2874
2016-12-26 10:00:00,244,265,260,769,4614
2016-12-26 10:10:00,288,309,306,903,5418
2016-12-26 10:20:00,329,350,348,1027,6162
2016-12-26 10:30:00,45,50,50,145,870
2016-12-26 10:40:00,83,107,88,278,1668
2016-12-26 10:50:00,131,143,132,406,2436
2016-12-26 11:00:00,216,240,237,693,4158
2016-12-26 11:10:00,192,215,212,619,3714
2016-12-26 11:20:00,205,231,223,659,3954
2016-12-26 11:30:00,232,252,247,731,4386
2016-12-26 11:40:00,38,59,32,129,774
2016-12-26 11:50:00,71,111,18,200,1200
2016-12-26 12:00:00,157,185,153,495,2970
2016-12-26 12:10:00,87,97,36,220,1320
2016-12-26 12:20:00,47,74,55,176,1056
2016-12-26 12:30:00,368,385,382,1135,6810
2016-12-26 12:40:00,361,382,374,1117,6702
2016-12-26 12:50:00,44,71,44,159,954
2016-12-26 13:00:00,86,113,98,297,1782
2016-12-26 13:10:00,147,165,149,461,2766
2016-12-26 13:20:00,137,128,83,348,2088
2016-12-26 13:30:00,124,133,102,359,2154
2016-12-26 13:40:00,46,50,50,146,876
2016-12-26 13:50:00,5,9,3,17,102
2016-12-26 14:00:00,6,11,2,19,114
2016-12-26 14:10:00,18,45,17,80,480
2016-12-26 14:20:00,16,70,35,121,726
2016-12-26 14:30:00,31,64,31,126,756
2016-12-26 14:40:00,22,41,11,74,444
2016-12-26 14:50:00,7,12,3,22,132
2016-12-26 15:00:00,0,0,0,0,0
2016-12-26 15:10:00,0,0,0,0,0
2016-12-26 15:20:00,0,0,0,0,0
2016-12-26 15:30:00,0,0,0,0,0
2016-12-26 15:40:00,0,0,0,0,0
2016-12-27 08:00:00,0,0,0,0,0
2016-12-27 08:10:00,0,0,0,0,0
2016-12-27 08:20:00,0,0,0,0,0
2016-12-27 08:30:00,0,0,0,0,0
2016-12-27 08:40:00,4,7,3,14,84
2016-12-27 08:50:00,15,19,7,41,246
2016-12-27 09:00:00,25,40,11,76,456
2016-12-27 09:10:00,31,73,26,130,780
2016-12-27 09:20:00,72,88,25,185,1110
2016-12-27 09:30:00,82,109,62,253,1518
2016-12-27 09:40:00,95,125,107,327,1962
2016-12-27 09:50:00,134,150,135,419,2514
2016-12-27 10:00:00,227,255,257,739,4434
2016-12-27 10:10:00,299,316,312,927,5562
2016-12-27 10:20:00,285,302,297,884,5304
2016-12-27 10:30:00,139,159,156,454,2724
2016-12-27 10:40:00,196,190,199,585,3510
2016-12-27 10:50:00,225,245,239,709,4254
2016-12-27 11:00:00,227,245,241,713,4278
2016-12-27 11:10:00,193,213,208,614,3684
2016-12-27 11:20:00,192,213,210,615,3690
2016-12-27 11:30:00,200,219,215,634,3804
2016-12-27 11:40:00,203,217,212,632,3792
2016-12-27 11:50:00,207,225,222,654,3924
2016-12-27 12:00:00,219,236,233,688,4128
2016-12-27 12:10:00,245,266,262,773,4638
2016-12-27 12:20:00,333,357,353,1043,6258
2016-12-27 12:30:00,406,428,425,1259,7554
2016-12-27 12:40:00,464,481,481,1426,8556
2016-12-27 12:50:00,492,507,505,1504,9024
2016-12-27 13:00:00,439,462,459,1360,8160
2016-12-27 13:10:00,147,166,165,478,2868
2016-12-27 13:20:00,75,93,91,259,1554
2016-12-27 13:30:00,75,81,46,202,1212
2016-12-27 13:40:00,67,82,12,161,966
2016-12-27 13:50:00,42,75,27,144,864
2016-12-27 14:00:00,31,72,43,146,876
2016-12-27 14:10:00,15,72,35,122,732
2016-12-27 14:20:00,38,47,6,91,546
2016-12-27 14:30:00,18,36,10,64,384
2016-12-27 14:40:00,10,14,2,26,156
2016-12-27 14:50:00,7,12,2,21,126
2016-12-27 15:00:00,7,10,2,19,114
2016-12-27 15:10:00,1,2,0,3,18
2016-12-27 15:20:00,0,0,0,0,0
2016-12-27 15:30:00,0,0,0,0,0
2016-12-27 15:40:00,0,0,0,0,0
2016-12-27 15:50:00,0,0,0,0,0
2016-12-27 16:00:00,0,0,0,0,0
2016-12-28 08:00:00,0,0,0,0,0
2016-12-28 08:10:00,0,0,0,0,0
2016-12-28 08:20:00,0,0,0,0,0
2016-12-28 08:30:00,0,0,0,0,0
2016-12-28 08:40:00,2,4,2,8,48
2016-12-28 08:50:00,9,19,9,37,222
2016-12-28 09:00:00,13,43,26,82,492
2016-12-28 09:10:00,28,64,38,130,780
2016-12-28 09:20:00,33,60,25,118,708
2016-12-28 09:30:00,43,70,57,170,1020
2016-12-28 09:40:00,74,97,95,266,1596
2016-12-28 09:50:00,63,83,67,213,1278
2016-12-28 10:00:00,55,89,73,217,1302
2016-12-28 10:10:00,67,82,85,234,1404
2016-12-28 10:20:00,51,77,45,173,1038
2016-12-28 10:30:00,59,80,60,199,1194
2016-12-28 10:40:00,55,84,86,225,1350
2016-12-28 10:50:00,88,142,103,333,1998
2016-12-28 11:00:00,47,157,125,329,1974
2016-12-28 11:10:00,46,99,85,230,1380
2016-12-28 11:20:00,61,84,81,226,1356
2016-12-28 11:30:00,61,84,72,217,1302
2016-12-28 11:40:00,48,82,63,193,1158
2016-12-28 11:50:00,68,88,67,223,1338
2016-12-28 12:00:00,89,114,100,303,1818
2016-12-28 12:10:00,111,156,108,375,2250
2016-12-28 12:20:00,138,141,117,396,2376
2016-12-28 12:30:00,101,132,126,359,2154
2016-12-28 12:40:00,86,104,103,293,1758
2016-12-28 12:50:00,86,105,88,279,1674
2016-12-28 13:00:00,51,76,43,170,1020
2016-12-28 13:10:00,55,77,47,179,1074
2016-12-28 13:20:00,47,78,41,166,996
2016-12-28 13:30:00,25,60,25,110,660
2016-12-28 13:40:00,17,76,23,116,696
2016-12-28 13:50:00,21,88,60,169,1014
2016-12-28 14:00:00,35,152,140,327,1962
2016-12-28 14:10:00,44,82,56,182,1092
2016-12-28 14:20:00,34,72,52,158,948
2016-12-28 14:30:00,13,31,11,55,330
2016-12-28 14:40:00,11,22,3,36,216
2016-12-28 14:50:00,8,18,4,30,180
2016-12-28 15:00:00,4,7,2,13,78
2016-12-28 15:10:00,1,2,0,3,18
2016-12-28 15:20:00,0,0,0,0,0
2016-12-28 15:30:00,0,0,0,0,0
2016-12-28 15:40:00,0,0,0,0,0
2016-12-28 15:50:00,0,0,0,0,0
2016-12-28 16:00:00,0,0,0,0,0
2016-12-29 08:00:00,0,0,0,0,0
2016-12-29 08:10:00,0,0,0,0,0
2016-12-29 08:20:00,0,0,0,0,0
2016-12-29 08:30:00,0,0,0,0,0
2016-12-29 08:40:00,0,0,0,0,0
2016-12-29 08:50:00,0,0,0,0,0
2016-12-29 09:00:00,0,1,0,1,6
2016-12-29 09:10:00,2,2,3,7,42
2016-12-29 09:20:00,7,9,8,24,144
2016-12-29 09:30:00,13,19,12,44,264
2016-12-29 09:40:00,17,21,10,48,288
2016-12-29 09:50:00,19,31,9,59,354
2016-12-29 10:00:00,27,39,10,76,456
2016-12-29 10:10:00,25,63,26,114,684
2016-12-29 10:20:00,39,63,31,133,798
2016-12-29 10:30:00,20,79,23,122,732
2016-12-29 10:40:00,38,51,40,129,774
2016-12-29 10:50:00,75,92,80,247,1482
2016-12-29 11:00:00,79,101,72,252,1512
2016-12-29 11:10:00,64,80,55,199,1194
2016-12-29 11:20:00,67,81,45,193,1158
2016-12-29 11:30:00,56,83,59,198,1188
2016-12-29 11:40:00,51,75,55,181,1086
2016-12-29 11:50:00,57,69,55,181,1086
2016-12-29 12:00:00,50,70,44,164,984
2016-12-29 12:10:00,68,86,65,219,1314
2016-12-29 12:20:00,49,58,41,148,888
2016-12-29 12:30:00,50,56,45,151,906
2016-12-29 12:40:00,48,52,54,154,924
2016-12-29 12:50:00,32,58,34,124,744
2016-12-29 13:00:00,31,58,26,115,690
2016-12-29 13:10:00,33,51,15,99,594
2016-12-29 13:20:00,27,43,10,80,480
2016-12-29 13:30:00,44,78,43,165,990
2016-12-29 13:40:00,31,59,48,138,828
2016-12-29 13:50:00,29,48,15,92,552
2016-12-29 14:00:00,32,43,8,83,498
2016-12-29 14:10:00,31,40,5,76,456
2016-12-29 14:20:00,24,31,1,56,336
2016-12-29 14:30:00,23,25,5,53,318
2016-12-29 14:40:00,11,16,5,32,192
2016-12-29 14:50:00,7,10,2,19,114
2016-12-29 15:00:00,4,7,0,11,66
2016-12-29 15:10:00,1,2,0,3,18
2016-12-29 15:20:00,0,0,0,0,0
2016-12-29 15:30:00,0,0,0,0,0
2016-12-29 15:40:00,0,0,0,0,0
2016-12-29 15:50:00,0,0,0,0,0
2016-12-29 16:00:00,0,0,0,0,0
2016-12-30 08:00:00,0,0,0,0,0
2016-12-30 08:10:00,0,0,0,0,0
2016-12-30 08:20:00,0,0,0,0,0
2016-12-30 08:30:00,0,0,0,0,0
2016-12-30 08:40:00,0,0,0,0,0
2016-12-30 08:50:00,2,3,1,6,36
2016-12-30 09:00:00,7,7,10,24,144
2016-12-30 09:10:00,11,16,10,37,222
2016-12-30 09:20:00,15,22,10,47,282
2016-12-30 09:30:00,17,30,9,56,336
2016-12-30 09:40:00,18,26,17,61,366
2016-12-30 09:50:00,26,20,31,77,462
2016-12-30 10:00:00,30,39,34,103,618
2016-12-30 10:10:00,33,52,44,129,774
2016-12-30 10:20:00,33,56,48,137,822
2016-12-30 10:30:00,40,58,60,158,948
2016-12-30 10:40:00,33,60,38,131,786
2016-12-30 10:50:00,40,61,47,148,888
2016-12-30 11:00:00,33,61,34,128,768
2016-12-30 11:10:00,39,49,56,144,864
2016-12-30 11:20:00,37,54,44,135,810
2016-12-30 11:30:00,42,67,48,157,942
2016-12-30 11:40:00,27,70,31,128,768
2016-12-30 11:50:00,16,82,16,114,684
2016-12-30 12:00:00,32,50,31,113,678
2016-12-30 12:10:00,25,60,22,107,642
2016-12-30 12:20:00,21,45,19,85,510
2016-12-30 12:30:00,20,34,27,81,486
2016-12-30 12:40:00,29,41,13,83,498
2016-12-30 12:50:00,29,37,2,68,408
2016-12-30 13:00:00,28,37,7,72,432
2016-12-30 13:10:00,23,44,16,83,498
2016-12-30 13:20:00,20,48,22,90,540
2016-12-30 13:30:00,26,59,27,112,672
2016-12-30 13:40:00,23,53,23,99,594
2016-12-30 13:50:00,39,52,13,104,624
2016-12-30 14:00:00,36,52,20,108,648
2016-12-30 14:10:00,22,42,12,76,456
2016-12-30 14:20:00,13,29,11,53,318
2016-12-30 14:30:00,10,20,8,38,228
2016-12-30 14:40:00,7,9,2,18,108
2016-12-30 14:50:00,1,2,0,3,18
2016-12-30 15:00:00,0,0,0,0,0
2016-12-30 15:10:00,0,0,0,0,0
2016-12-30 15:20:00,0,0,0,0,0
2016-12-30 15:30:00,0,0,0,0,0
2016-12-30 15:40:00,0,0,0,0,0
2016-12-30 15:50:00,0,0,0,0,0
2016-12-30 16:00:00,0,0,0,0,0
2016-12-31 08:10:00,0,0,0,0,0
2016-12-31 08:20:00,0,0,0,0,0
2016-12-31 08:30:00,0,0,0,0,0
2016-12-31 08:40:00,0,0,0,0,0
2016-12-31 08:50:00,0,0,0,0,0
2016-12-31 09:00:00,0,0,0,0,0
2016-12-31 09:10:00,0,0,0,0,0
2016-12-31 09:20:00,1,3,0,4,24
2016-12-31 09:30:00,4,6,0,10,60
2016-12-31 09:40:00,8,12,1,21,126
2016-12-31 09:50:00,7,14,1,22,132
2016-12-31 10:00:00,11,16,2,29,174
2016-12-31 10:10:00,13,25,8,46,276
2016-12-31 10:20:00,25,35,5,65,390
2016-12-31 10:30:00,37,45,6,88,528
2016-12-31 10:40:00,38,58,17,113,678
2016-12-31 10:50:00,32,75,33,140,840
2016-12-31 11:00:00,28,61,27,116,696
2016-12-31 11:10:00,23,64,25,112,672
2016-12-31 11:20:00,29,113,98,240,1440
2016-12-31 11:30:00,40,89,63,192,1152
2016-12-31 11:40:00,54,81,45,180,1080
2016-12-31 11:50:00,49,75,24,148,888
2016-12-31 12:00:00,47,77,23,147,882
2016-12-31 12:10:00,31,53,20,104,624
2016-12-31 12:20:00,32,44,14,90,540
2016-12-31 12:30:00,24,44,14,82,492
2016-12-31 12:40:00,21,40,9,70,420
2016-12-31 12:50:00,30,52,17,99,594
2016-12-31 13:00:00,28,68,32,128,768
2016-12-31 13:10:00,41,73,23,137,822
2016-12-31 13:20:00,36,66,31,133,798
2016-12-31 13:30:00,33,73,39,145,870
2016-12-31 13:40:00,44,50,23,117,702
2016-12-31 13:50:00,29,48,15,92,552
2016-12-31 14:00:00,33,45,9,87,522
2016-12-31 14:10:00,67,82,16,165,990
2016-12-31 14:20:00,50,63,13,126,756
2016-12-31 14:30:00,40,46,3,89,534
2016-12-31 14:40:00,30,36,1,67,402
2016-12-31 14:50:00,26,29,0,55,330
2016-12-31 15:00:00,19,24,1,44,264
2016-12-31 15:10:00,10,14,0,24,144
2016-12-31 15:20:00,3,5,0,8,48
2016-12-31 15:30:00,0,0,0,0,0
2016-12-31 15:40:00,0,0,0,0,0
2016-12-31 15:50:00,0,0,0,0,0
2016-12-31 16:00:00,0,0,0,0,0
